id_num,Term,Tuition,Fee,Room,Meal,All_Charges,Gordon_Gift,Gordon_Unfunded_Gift,Gordon_Funded_Gift,Loans,Total_Gift,TR,Tot_aid,TF_Net_price,Tot_Net_price,Remain_All_Aid_Applied,Current_Balance
50217201,FA2021 ,12625,500,4580,2110,19815,6275,6275,0,15250,7775,0,23025,5350,12040,-3210,0
50217201,FA2022 ,13005,515,4810,2220,20550,6275,6275,0,14750,6275,0,21025,7245,14275,-475,0
50217201,SP2021 ,12625,500,4580,2110,19815,6275,6275,0,15250,6275,0,21525,6850,13540,-1710,0
50118129,FA2021 ,12625,500,4050,2550,19725,6825,5325,1500,3750,8325,0,12075,4800,11400,7650,0
50118129,FA2022 ,13005,515,5080,1140,19740,8325,5825,2500,3750,10752,0,14502,2768,8988,5238,0
50118129,SP2021 ,12625,6350,6350,NULL,18975,6825,5325,1500,3750,6825,0,10575,12150,12150,8400,0
50118129,SP2022 ,13005,515,5080,1140,19740,8325,5825,2500,3750,10753,0,14503,2767,8987,5237,0
50233705,FA2024 ,14750,600,4200,2450,22000,5500,5500,0,2750,5500,0,8250,9850,16500,13750,679
50233705,SP2024 ,14750,600,4200,2450,22000,5500,5500,0,2750,5500,0,8250,9850,16500,13750,679
50226246,FA2022 ,13005,515,3855,2220,19595,5550,5550,0,10000,8998,0,18998,4522,10597,597,0
50226703,FA2022 ,13005,515,3855,2220,19595,6500,6500,0,2750,6500,0,9250,7020,13095,10345,0
50226703,FA2023 ,13500,550,5150,2325,21525,6500,6500,0,3250,6500,0,9750,7550,15025,11775,0
50226703,FA2024 ,14750,600,5410,2450,23210,6500,6500,0,13691,6500,0,20191,8850,16710,3019,0
50226703,SP2022 ,13005,515,3855,2220,19595,6500,6500,0,2750,6500,0,9250,7020,13095,10345,0
50226703,SP2023 ,13500,550,5150,2325,21525,6500,6500,0,3250,6500,0,9750,7550,15025,11775,0
50226703,SP2024 ,14750,600,5410,2450,23210,6500,6500,0,13692,6500,0,20192,8850,16710,3018,0
50228940,FA2023 ,13500,550,4000,2325,20375,13500,8000,5500,NULL,13500,0,13500,550,6875,6875,13793.6
50228940,FA2024 ,14750,600,4200,2450,22000,14000,8000,6000,NULL,14000,0,14000,1350,8000,8000,13793.6
50228940,SP2023 ,13500,550,4000,2325,20375,12500,8000,4500,NULL,12500,0,12500,1550,7875,7875,13793.6
50228940,SP2024 ,14750,600,4200,2450,22000,14000,8000,6000,NULL,14000,0,14000,1350,8000,8000,13793.6
50230319,FA2023 ,12500,4300,4300,NULL,16800,0,0,0,NULL,0,0,0,16800,16800,16800,0
50224392,FA2022 ,13005,515,4260,2220,20000,5750,5750,0,2750,5750,0,8500,7770,14250,11500,631.48
50224392,FA2023 ,13500,550,5150,2325,21525,5750,5750,0,13052,5750,0,18802,8300,15775,2723,631.48
50224392,FA2024 ,14750,600,NULL,NULL,15350,3967,3967,0,10537,5830,0,16367,9520,9520,-1017,631.48
50224392,SP2022 ,13005,515,4260,2220,20000,5750,5750,0,2750,5750,0,8500,7770,14250,11500,631.48
50224392,SP2023 ,13500,550,5150,2325,21525,5750,5750,0,13052,5750,0,18802,8300,15775,2723,631.48
50224392,SP2024 ,14750,600,NULL,NULL,15350,3968,3968,0,10537,5830,0,16367,9520,9520,-1017,631.48
50221424,FA2021 ,12625,500,4580,2110,19815,6750,6750,0,0,10500,0,10500,2625,9315,9315,0
50225770,FA2022 ,13005,515,4810,2220,20550,6500,6500,0,NULL,6500,0,6500,7020,14050,14050,0
50225770,FA2023 ,13500,550,4000,2325,20375,7500,6500,1000,NULL,7500,0,7500,6550,12875,12875,0
50225770,FA2024 ,14750,600,4200,2450,22000,6500,6500,0,NULL,6500,0,6500,8850,15500,15500,0
50225770,SP2022 ,13005,515,4810,2220,20550,6500,6500,0,NULL,6500,0,6500,7020,14050,14050,0
50225770,SP2023 ,13500,550,4000,2325,20375,7500,6500,1000,NULL,7500,0,7500,6550,12875,12875,0
50225770,SP2024 ,14750,600,4200,2450,22000,6500,6500,0,NULL,6500,0,6500,8850,15500,15500,0
50215514,FA2021 ,12625,500,4580,2110,19815,4875,4875,0,15617,6375,0,21992,6750,13440,-2177,0
50215514,FA2022 ,13005,515,4610,1140,19270,4375,4375,0,13389,4375,0,17764,9145,14895,1506,0
50215514,FA2023 ,13500,550,4550,2325,20925,4375,4375,0,18126,4375,0,22501,9675,16550,-1576,0
50215514,SP2021 ,12625,500,4580,2110,19815,4875,4875,0,15189,4875,0,20064,8250,14940,-249,0
50215514,SP2022 ,13005,515,4610,1140,19270,4375,4375,0,16725,4375,0,21100,9145,14895,-1830,0
50215514,SP2023 ,13500,550,5440,1200,20690,4375,4375,0,15251,4375,0,19626,9675,16315,1064,0
50217311,FA2021 ,12625,500,4580,2110,19815,3975,3975,0,16467,5475,0,21942,7650,14340,-2127,0
50217311,FA2022 ,13005,515,4610,1140,19270,3975,3975,0,15650,3975,0,19625,9545,15295,-355,0
50217311,FA2023 ,13500,550,4550,2325,20925,3975,3975,0,16915,3975,0,20890,10075,16950,35,0
50217311,SP2021 ,12625,500,4580,2110,19815,3975,3975,0,15682,3975,0,19657,9150,15840,158,0
50217311,SP2022 ,3580,NULL,NULL,NULL,3580,0,0,0,3995,0,0,3995,3580,3580,-415,0
50228466,FA2023 ,13500,550,4560,2325,20935,8200,8200,0,13791,8200,0,21991,5850,12735,-1056,0
50228466,FA2024 ,14750,600,4200,2450,22000,8200,6500,1700,13863,8200,0,22063,7150,13800,-63,0
50228466,SP2023 ,13500,550,4560,2325,20935,8200,8200,0,13171,8200,0,21371,5850,12735,-436,0
50228466,SP2024 ,14750,600,4200,2450,22000,8200,6500,1700,13963,8200,0,22163,7150,13800,-163,0
50230471,FA2023 ,1940,NULL,NULL,NULL,1940,0,0,0,NULL,0,0,0,1940,1940,1940,0
50212170,FA2021 ,12625,500,3740,2110,18975,8925,5425,3500,NULL,10425,0,10425,2700,8550,8550,4139.16
50212170,FA2022 ,13850,515,4260,2220,20845,10425,5425,5000,NULL,10425,0,10425,3940,10420,10420,4139.16
50212170,SP2021 ,12625,500,3740,2110,18975,8925,5425,3500,NULL,8925,0,8925,4200,10050,10050,4139.16
50212170,SP2022 ,13850,515,4260,1140,19765,6925,5425,1500,NULL,6925,0,6925,7440,12840,12840,4139.16
50231776,FA2024 ,14750,600,4200,2680,22230,8500,8000,500,2750,8500,0,11250,6850,13730,10980,0
50231776,SP2024 ,14750,600,4200,2450,22000,8500,8000,500,2750,8500,0,11250,6850,13500,10750,0
50216345,FA2021 ,12625,500,3740,2110,18975,4425,4425,0,2750,5925,0,8675,7200,13050,10300,120
50216345,FA2022 ,13005,515,4380,2220,20120,4425,4425,0,3250,4425,0,7675,9095,15695,12445,120
50216345,FA2023 ,13500,550,5150,2325,21525,4425,4425,0,NULL,4425,0,4425,9625,17100,17100,120
50216345,FA2024 ,14750,600,4780,2450,22580,4425,1800,2625,3750,4425,0,8175,10925,18155,14405,120
50216345,SP2021 ,12625,500,3740,2110,18975,4425,4425,0,2750,4425,0,7175,8700,14550,11800,120
50216345,SP2022 ,13005,515,4380,2220,20120,4425,4425,0,3250,4425,0,7675,9095,15695,12445,120
50216345,SP2023 ,13500,550,5150,2325,21525,4425,4425,0,NULL,4425,0,4425,9625,17100,17100,120
50216345,SP2024 ,14750,600,4780,2450,22580,4425,1800,2625,0,4425,0,4425,10925,18155,18155,120
50233711,FA2024 ,14750,600,NULL,NULL,15350,5520,5520,0,2750,5520,0,8270,9830,9830,7080,15
50233711,SP2024 ,14750,600,NULL,NULL,15350,5520,5520,0,2750,5520,0,8270,9830,9830,7080,15
50209390,FA2021 ,12625,500,3740,1080,17945,1925,1925,0,3750,2925,0,6675,10200,15020,11270,0
50209390,FA2022 ,13005,6590,6590,NULL,19595,1000,1000,0,3750,1000,0,4750,18595,18595,14845,0
50209390,SP2021 ,12625,500,3740,1080,17945,1925,1925,0,3750,1925,0,5675,11200,16020,12270,0
50209390,SP2022 ,13005,515,4610,1140,19270,1925,1925,0,3750,1925,0,5675,11595,17345,13595,0
50231793,FA2024 ,14750,600,4790,2450,22590,9450,9450,0,15017,9450,0,24467,5900,13140,-1877,-1
50231793,SP2024 ,14750,600,4790,2450,22590,9450,9450,0,14089,9450,0,23539,5900,13140,-949,-1
50221401,FA2021 ,12625,500,3740,2550,19415,7500,7500,0,2750,7500,0,10250,5625,11915,9165,0
50221401,FA2022 ,13005,515,3855,2690,20065,7000,7000,0,NULL,10855,0,10855,2665,9210,9210,0
50221401,FA2023 ,13500,550,4560,1200,19810,7000,7000,0,NULL,9000,0,9000,5050,10810,10810,0
50221401,FA2024 ,14750,600,5030,1270,21650,9000,7000,2000,NULL,9000,0,9000,6350,12650,12650,0
50221401,SP2021 ,12625,500,3740,2550,19415,7500,7500,0,2750,7500,0,10250,5625,11915,9165,0
50221401,SP2022 ,13005,515,3855,2690,20065,7000,7000,0,NULL,10855,0,10855,2665,9210,9210,0
50221401,SP2023 ,13500,550,4560,1200,19810,7000,7000,0,NULL,9000,0,9000,5050,10810,10810,0
50212599,FA2021 ,12625,500,4270,1080,18475,11175,5450,5725,NULL,14545,0,14545,-1420,3930,3930,150
50212599,SP2021 ,12625,500,4270,NULL,17395,9175,5450,3725,NULL,11045,0,11045,2080,6350,6350,150
50218465,FA2021 ,12625,500,3740,2110,18975,7925,7925,0,2750,13448,0,16198,-323,5527,2777,0
50218465,FA2022 ,13005,515,3855,2220,19595,7925,7925,0,3750,12273,0,16023,1247,7322,3572,0
50218465,FA2023 ,13500,550,4790,1200,20040,8825,8825,0,3750,12523,0,16273,1527,7517,3767,0
50218465,SP2021 ,12625,500,3740,2110,18975,7925,7925,0,2750,11447,0,14197,1678,7528,4778,0
50218465,SP2022 ,13005,515,3855,2220,19595,7925,7925,0,3750,12272,0,16022,1248,7323,3573,0
50218465,SP2023 ,13500,550,4790,1200,20040,8825,8825,0,3750,12522,0,16272,1528,7518,3768,0
50221221,FA2021 ,12625,500,4580,2110,19815,7150,7150,0,14575,8150,0,22725,4975,11665,-2910,0
50221221,FA2022 ,13005,515,4810,2220,20550,6650,6650,0,18779,6650,0,25429,6870,13900,-4879,0
50221221,FA2023 ,13500,550,4790,NULL,18840,6650,5000,1650,12750,7822,0,20572,6228,11018,-1732,0
50221221,SP2021 ,12625,500,4580,2110,19815,7150,7150,0,13282,7150,0,20432,5975,12665,-617,0
50221221,SP2022 ,13005,515,4810,2220,20550,6650,6650,0,15721,6650,0,22371,6870,13900,-1821,0
50221221,SP2023 ,13500,550,4790,NULL,18840,6650,5000,1650,12750,7822,0,20572,6228,11018,-1732,0
50228443,FA2023 ,13500,550,5150,2325,21525,5000,5000,0,16171,6573,0,22744,7477,14952,-1219,0
50228443,FA2024 ,14750,600,5410,2450,23210,5973,5973,0,17550,5973,0,23523,9377,17237,-313,0
50228443,SP2023 ,13500,550,5150,2325,21525,5000,5000,0,15329,6572,0,21901,7478,14953,-376,0
50228443,SP2024 ,14750,600,5410,2450,23210,5972,5972,0,17550,5972,0,23522,9378,17238,-312,0
50219157,FA2021 ,12625,500,NULL,NULL,13125,1425,0,1425,3750,2925,0,6675,10200,10200,6450,0
50219157,SP2021 ,3470,NULL,NULL,NULL,3470,0,0,0,3750,0,0,3750,3470,3470,-280,0
50226532,FA2023 ,1940,NULL,NULL,NULL,1940,0,0,0,NULL,0,0,0,1940,1940,1940,0
50228791,FA2023 ,13500,550,4560,2325,20935,5000,5000,0,6000,5000,0,11000,9050,15935,9935,6225.66
50228791,FA2024 ,14750,600,4790,2450,22590,5000,5000,0,3250,5370,0,8620,9980,17220,13970,6225.66
50228791,SP2023 ,13500,550,4560,2325,20935,5000,5000,0,6000,5000,0,11000,9050,15935,9935,6225.66
50228791,SP2024 ,14750,600,4790,2450,22590,5000,5000,0,3250,5370,0,8620,9980,17220,13970,6225.66
50231885,FA2024 ,14750,600,4200,2450,22000,8750,8750,0,2750,12448,0,15198,2902,9552,6802,315.5
50205799,FA2021 ,12625,6350,6350,NULL,18975,5000,0,5000,3750,11348,0,15098,7627,7627,3877,0
50205799,SP2021 ,12625,500,4270,1080,18475,1125,1125,0,9750,6932,0,16682,6193,11543,1793,0
50226179,FA2022 ,13005,515,4810,2690,21020,5500,5500,0,2750,5500,0,8250,8020,15520,12770,5960.66
50226179,FA2023 ,13500,550,4000,2325,20375,5500,5500,0,0,5500,0,5500,8550,14875,14875,5960.66
50226179,FA2024 ,14750,600,5410,2450,23210,5500,5500,0,NULL,5500,0,5500,9850,17710,17710,5960.66
50226179,SP2022 ,13005,515,4810,2220,20550,5500,5500,0,2750,5500,0,8250,8020,15050,12300,5960.66
50226179,SP2024 ,14750,600,5410,2450,23210,5500,5500,0,NULL,5500,0,5500,9850,17710,17710,5960.66
50234186,FA2024 ,14750,600,4790,2450,22590,7500,7500,0,2750,7500,0,10250,7850,15090,12340,1214.75
50234186,SP2024 ,14750,600,4790,2450,22590,7500,7500,0,2750,9500,0,12250,5850,13090,10340,1214.75
60001249,FA2024 ,4070,NULL,NULL,NULL,4070,0,0,0,NULL,4070,4070,4070,0,0,0,0
50224547,SP2021 ,6960,250,NULL,NULL,7210,2747,2747,0,NULL,2747,0,2747,4463,4463,4463,0
50231359,FA2024 ,14750,600,4790,2450,22590,9000,9000,0,0,9000,0,9000,6350,13590,13590,0
50234488,FA2024 ,14750,600,4200,2450,22000,8950,6950,2000,11941,14453,0,26394,897,7547,-4394,-1603
50234488,SP2024 ,14750,600,4200,2450,22000,6950,6950,0,11941,12452,0,24393,2898,9548,-2393,-1603
50209667,FA2021 ,12625,500,5160,NULL,18285,1425,1425,0,16541,2925,0,19466,10200,15360,-1181,0
50209667,FA2022 ,13005,515,4610,NULL,18130,1425,0,1425,17805,1425,0,19230,12095,16705,-1100,0
50209667,SP2021 ,12625,500,5160,NULL,18285,1425,1425,0,16541,1425,0,17966,11700,16860,319,0
50209667,SP2022 ,13005,515,4610,NULL,18130,1425,0,1425,17806,1425,0,19231,12095,16705,-1101,0
50222540,FA2021 ,12625,500,3740,2110,18975,5750,5750,0,2750,11848,0,14598,1277,7127,4377,0
50222540,FA2022 ,13005,515,3855,2220,19595,5751,5751,0,0,10999,0,10999,2521,8596,8596,0
50222540,FA2023 ,13500,550,4000,2325,20375,6150,6150,0,3750,11348,0,15098,2702,9027,5277,0
50222540,SP2021 ,12625,500,3740,2110,18975,5750,5750,0,2750,11407,0,14157,1718,7568,4818,0
50222540,SP2023 ,13500,550,4000,2325,20375,6150,6150,0,3750,11347,0,15097,2703,9028,5278,0
50228228,FA2023 ,13500,550,5150,2325,21525,6500,6500,0,0,6500,0,6500,7550,15025,15025,0
50228228,FA2024 ,14750,600,5410,2450,23210,6500,6500,0,NULL,6500,0,6500,8850,16710,16710,0
50228228,SP2023 ,13500,550,5150,2325,21525,6500,6500,0,0,6500,0,6500,7550,15025,15025,0
50228228,SP2024 ,14750,600,5410,2450,23210,6500,6500,0,NULL,6500,0,6500,8850,16710,16710,0
50227343,FA2022 ,13005,515,4714,2220,20454,6000,6000,0,3750,7886,0,11636,5634,12568,8818,0
50227343,FA2023 ,13500,550,5150,2325,21525,6400,6400,0,3750,9984,0,13734,4066,11541,7791,0
50227343,SP2022 ,13005,515,4810,2220,20550,6000,6000,0,3750,9011,0,12761,4509,11539,7789,0
50227343,SP2023 ,13500,550,5150,2325,21525,6400,6400,0,3750,10358,0,14108,3692,11167,7417,0
50220402,FA2021 ,12625,500,4580,2110,19815,3675,0,3675,11085,9998,0,21083,3127,9817,-1268,0
50220402,FA2022 ,13005,515,4810,2220,20550,3675,0,3675,12451,8923,0,21374,4597,11627,-824,0
50220402,FA2023 ,13500,550,5150,2325,21525,4075,400,3675,13243,9273,0,22516,4777,12252,-991,0
50220402,SP2021 ,12625,500,4580,2110,19815,3675,0,3675,12115,7997,0,20112,5128,11818,-297,0
50220402,SP2022 ,13005,515,4810,2220,20550,3675,0,3675,11922,8922,0,20844,4598,11628,-294,0
50220402,SP2023 ,13500,550,5150,2325,21525,4075,400,3675,12476,9272,0,21748,4778,12253,-223,0
50226505,FA2022 ,13005,515,4810,2220,20550,6500,6500,0,2750,11348,0,14098,2172,9202,6452,0
50226505,FA2023 ,13500,550,4790,1200,20040,7400,7400,0,3750,12597,0,16347,1453,7443,3693,0
50226505,SP2022 ,13005,515,4810,2220,20550,6500,6500,0,2750,11347,0,14097,2173,9203,6453,0
50226505,SP2023 ,13500,550,4790,1200,20040,6900,6900,0,3750,12098,0,15848,1952,7942,4192,0
50209169,FA2021 ,19340,860,4910,2550,26800,10100,7500,2600,16144,13673,0,29817,6527,13127,-3017,-98
50209169,FA2022 ,19910,890,6310,1140,27360,10100,7500,2600,15836,11173,0,27009,9627,16187,351,-98
50209169,FA2023 ,20670,950,5740,NULL,26410,10100,2000,8100,18790,10100,0,28890,11520,16310,-2480,-98
50209169,FA2024 ,14750,600,5030,1270,21650,10100,2000,8100,13486,10808,0,24294,4542,10842,-2644,-98
50209169,SP2021 ,19340,860,4600,2550,26490,10100,7500,2600,16144,11672,0,27816,8528,14818,-1326,-98
50209169,SP2022 ,19910,890,6310,1140,27360,10100,7500,2600,15836,11172,0,27008,9628,16188,352,-98
50209169,SP2024 ,8140,600,5030,1270,15040,5574,1104,4470,10442,6161,0,16603,2579,8879,-1563,-98
50226704,FA2022 ,13005,515,3855,2220,19595,6400,6400,0,2750,12248,0,14998,1272,7347,4597,1875.32
50226704,FA2023 ,13500,550,4000,2325,20375,6400,500,5900,3250,12997,0,16247,1053,7378,4128,1875.32
50226704,FA2024 ,14750,600,4200,2450,22000,7400,5500,1900,3750,12998,0,16748,2352,9002,5252,1875.32
50226704,SP2022 ,13005,515,3855,2220,19595,6400,6400,0,2750,12247,0,14997,1273,7348,4598,1875.32
50226704,SP2023 ,13500,550,4000,2325,20375,6400,500,5900,3250,12998,0,16248,1052,7377,4127,1875.32
50226704,SP2024 ,14750,600,4200,2450,22000,7400,5500,1900,3750,12998,0,16748,2352,9002,5252,1875.32
50225838,FA2022 ,13005,515,4810,2220,20550,9000,9000,0,13633,9000,0,22633,4520,11550,-2083,0
50225838,FA2023 ,13500,550,5150,2325,21525,9000,9000,0,8993,14150,0,23143,-100,7375,-1618,0
50225838,FA2024 ,14750,600,6090,1270,22710,11500,0,11500,9493,14200,0,23693,1150,8510,-983,0
50225838,SP2022 ,13005,515,4810,2220,20550,9000,9000,0,13633,9000,0,22633,4520,11550,-2083,0
50225838,SP2023 ,13500,550,5150,2325,21525,9000,9000,0,8993,14150,0,23143,-100,7375,-1618,0
50225838,SP2024 ,14750,600,6090,1270,22710,9500,0,9500,9493,12200,0,21693,3150,10510,1017,0
50119393,FA2023 ,13500,550,5150,2325,21525,7500,7500,0,2750,7500,0,10250,6550,14025,11275,0
50119393,FA2024 ,14750,600,5410,2450,23210,7500,7500,0,3250,7500,0,10750,7850,15710,12460,0
50119393,SP2023 ,13500,550,5150,2325,21525,7500,7500,0,2750,7500,0,10250,6550,14025,11275,0
50119393,SP2024 ,14750,600,5410,2450,23210,7500,7500,0,3250,7500,0,10750,7850,15710,12460,0
50224967,FA2022 ,13005,515,4810,2220,20550,8500,8500,0,10250,9000,0,19250,4520,11550,1300,-1070
50224967,FA2023 ,13500,550,4000,2325,20375,9000,8500,500,3250,9500,0,12750,4550,10875,7625,-1070
50224967,FA2024 ,14750,600,5030,1270,21650,8500,8500,0,3750,8750,0,12500,6600,12900,9150,-1070
50224967,SP2022 ,13005,515,4810,2220,20550,8500,8500,0,10250,9000,0,19250,4520,11550,1300,-1070
50224967,SP2023 ,13500,550,4000,2325,20375,9000,8500,500,3250,9500,0,12750,4550,10875,7625,-1070
50224967,SP2024 ,14750,600,5030,NULL,20380,8500,8500,0,3750,8750,0,12500,6600,11630,7880,-1070
50228793,FA2023 ,13500,550,5150,2325,21525,7700,6700,1000,12147,11398,0,23545,2652,10127,-2020,143
50228793,FA2024 ,14750,600,4200,2450,22000,7700,6000,1700,10250,11398,0,21648,3952,10602,352,143
50228793,SP2023 ,13500,550,5150,2325,21525,7700,6700,1000,12148,11397,0,23545,2653,10128,-2020,143
50228793,SP2024 ,14750,600,4200,2450,22000,7700,6000,1700,10582,11397,0,21979,3953,10603,21,143
50226906,FA2023 ,13500,550,4000,2325,20375,9000,8000,1000,2750,12423,0,15173,1627,7952,5202,1365.33
50226906,FA2024 ,14750,600,4200,2450,22000,9650,7500,2150,3250,14848,0,18098,502,7152,3902,1365.33
50226906,SP2023 ,13500,550,4000,2325,20375,8000,8000,0,2750,10422,0,13172,3628,9953,7203,1365.33
50226906,SP2024 ,14750,600,4200,2450,22000,9650,7500,2150,3250,14847,0,18097,503,7153,3903,1365.33
50231958,SP2023 ,14500,2600,2600,NULL,17100,0,0,0,NULL,0,0,0,17100,17100,17100,0
50216970,FA2021 ,12625,500,4580,2110,19815,9125,6175,2950,2750,10625,0,13375,2500,9190,6440,-50
50216970,FA2022 ,13005,515,4260,2220,20000,9125,6175,2950,3750,13385,0,17135,135,6615,2865,-50
50216970,FA2023 ,13500,550,4790,1200,20040,9125,5775,3350,3750,9125,0,12875,4925,10915,7165,-50
50216970,SP2021 ,12625,500,4580,2110,19815,9125,6175,2950,2750,9125,0,11875,4000,10690,7940,-50
50216970,SP2022 ,13005,515,4260,2220,20000,9125,6175,2950,3750,13385,0,17135,135,6615,2865,-50
50216970,SP2023 ,13500,550,4790,1200,20040,9125,5775,3350,3750,9125,0,12875,4925,10915,7165,-50
50225992,FA2022 ,13005,515,4260,2220,20000,5500,5500,0,12750,9073,0,21823,4447,10927,-1823,0
50225992,FA2023 ,13500,550,4560,2325,20935,7100,5900,1200,11250,10173,0,21423,3877,10762,-488,0
50225992,SP2022 ,13005,515,4260,2220,20000,5500,5500,0,12750,9072,0,21822,4448,10928,-1822,0
50221402,FA2021 ,12625,500,3740,2110,18975,7250,7250,0,2750,12250,0,15000,875,6725,3975,100
50221402,FA2022 ,13005,515,4810,2220,20550,6750,6750,0,NULL,9250,0,9250,4270,11300,11300,100
50221402,FA2023 ,13500,550,4790,2325,21165,6750,6750,0,NULL,9250,0,9250,4800,11915,11915,100
50221402,FA2024 ,14750,600,5030,2450,22830,6750,6750,0,NULL,9250,0,9250,6100,13580,13580,100
50221402,SP2021 ,12625,500,3740,2110,18975,7250,7250,0,2750,9750,0,12500,3375,9225,6475,100
50221402,SP2022 ,13005,515,4810,2220,20550,6750,6750,0,NULL,6750,0,6750,6770,13800,13800,100
50221402,SP2023 ,13500,550,4790,2325,21165,6750,6750,0,NULL,6750,0,6750,7300,14415,14415,100
50221402,SP2024 ,14750,600,5030,2450,22830,6750,6750,0,NULL,9250,0,9250,6100,13580,13580,100
50230427,FA2024 ,14750,600,5410,2450,23210,9000,9000,0,NULL,10675,0,10675,4675,12535,12535,0
50230427,SP2024 ,14750,600,5410,2450,23210,9000,9000,0,NULL,9000,0,9000,6350,14210,14210,0
50119395,FA2022 ,5360,257,NULL,NULL,5617,2204,2204,0,2750,2454,0,5204,3163,3163,413,0
50119395,FA2023 ,3720,NULL,NULL,NULL,3720,2204,2204,0,NULL,2204,0,2204,1516,1516,1516,0
50119395,SP2022 ,5360,257,NULL,NULL,5617,2204,2204,0,2750,2454,0,5204,3163,3163,413,0
50204539,FA2021 ,12625,500,4270,NULL,17395,4025,4025,0,3750,9598,0,13348,3527,7797,4047,0
50204539,SP2021 ,12625,500,4270,NULL,17395,4025,4025,0,3750,7597,0,11347,5528,9798,6048,0
50213008,FA2021 ,12625,500,4830,1080,19035,2925,2925,0,3750,3925,0,7675,9200,15110,11360,0
50213008,FA2022 ,13005,515,5080,1140,19740,2925,2925,0,NULL,2925,0,2925,10595,16815,16815,0
50213008,SP2021 ,12625,500,4830,NULL,17955,2925,2925,0,3750,2925,0,6675,10200,15030,11280,0
50213008,SP2022 ,3580,NULL,5080,1140,9800,0,0,0,NULL,0,0,0,3580,9800,9800,0
50225238,FA2022 ,13005,515,4810,2690,21020,5000,5000,0,2750,5000,0,7750,8520,16020,13270,0
50225238,SP2022 ,13005,515,4810,2220,20550,5000,5000,0,2750,5000,0,7750,8520,15550,12800,0
50228377,SP2022 ,14269,7231,7231,NULL,21500,0,0,0,NULL,0,0,0,21500,21500,21500,0
50232640,SP2023 ,13500,550,4000,2745,20795,7000,7000,0,NULL,7000,0,7000,7050,13795,13795,0
50229847,FA2023 ,1940,NULL,NULL,NULL,1940,0,0,0,NULL,0,0,0,1940,1940,1940,0
50234727,FA2024 ,14750,600,NULL,NULL,15350,4830,4830,0,NULL,4830,0,4830,10520,10520,10520,5407.5
50234727,SP2024 ,14750,600,NULL,NULL,15350,4830,4830,0,NULL,4830,0,4830,10520,10520,10520,5407.5
50218488,FA2021 ,12625,500,3740,2110,18975,8125,0,8125,3250,13248,0,16498,-123,5727,2477,0
50218488,FA2022 ,13005,515,3855,2220,19595,8125,0,8125,3750,8125,0,11875,5395,11470,7720,0
50218488,FA2023 ,13500,550,5800,1200,21050,8125,500,7625,3750,8125,0,11875,5925,12925,9175,0
50218488,SP2021 ,12625,500,3740,2110,18975,8125,0,8125,3250,11247,0,14497,1878,7728,4478,0
50218488,SP2022 ,13005,515,3855,2220,19595,8125,0,8125,3750,8125,0,11875,5395,11470,7720,0
50218488,SP2023 ,13500,550,5800,1200,21050,8125,500,7625,3750,8125,0,11875,5925,12925,9175,0
50221622,FA2021 ,12625,500,4580,2110,19815,7450,7450,0,2750,13198,0,15948,-73,6617,3867,0
50221622,FA2022 ,13005,515,4810,2220,20550,6700,5500,1200,3250,10798,0,14048,2722,9752,6502,0
50221622,FA2023 ,13500,550,5150,2325,21525,7350,5900,1450,12671,11048,0,23719,3002,10477,-2194,0
50221622,FA2024 ,14750,600,5410,2450,23210,6950,5500,1450,11618,11048,0,22666,4302,12162,544,0
50221622,SP2021 ,12625,500,4580,2110,19815,7450,7450,0,2750,11757,0,14507,1368,8058,5308,0
50221622,SP2022 ,13005,515,4810,2220,20550,6700,5500,1200,3250,10797,0,14047,2723,9753,6503,0
50221622,SP2023 ,13500,550,5150,2325,21525,7350,5900,1450,12670,11047,0,23717,3003,10478,-2192,0
50230589,FA2023 ,13500,550,4000,2325,20375,7000,7000,0,14191,7000,0,21191,7050,13375,-816,0
50230589,SP2023 ,13500,550,4000,2325,20375,7000,7000,0,14191,7000,0,21191,7050,13375,-816,0
50209138,FA2021 ,12625,500,3740,2110,18975,10425,0,10425,3750,12425,0,16175,700,6550,2800,0
50209138,FA2022 ,7170,515,4610,1140,13435,6645,0,6645,3750,6645,0,10395,1040,6790,3040,0
50209138,SP2021 ,12625,500,3740,1080,17945,8425,0,8425,3750,8425,0,12175,4700,9520,5770,0
50221020,FA2021 ,12625,500,3740,2110,18975,11500,0,11500,2750,15100,0,17850,-1975,3875,1125,642.67
50221020,FA2022 ,13005,515,3855,2220,19595,11500,0,11500,3250,11500,0,14750,2020,8095,4845,642.67
50221020,FA2023 ,13500,550,4790,1200,20040,12000,500,11500,3750,12600,0,16350,1450,7440,3690,642.67
50221020,FA2024 ,14750,600,5030,NULL,20380,11500,0,11500,2750,12000,0,14750,3350,8380,5630,642.67
50221020,SP2021 ,12625,500,3740,2110,18975,9500,0,9500,2750,9500,0,12250,3625,9475,6725,642.67
50221020,SP2022 ,13005,515,4610,1140,19270,9500,0,9500,3250,9500,0,12750,4020,9770,6520,642.67
50221020,SP2023 ,13500,550,4790,NULL,18840,10000,500,9500,3750,10000,0,13750,4050,8840,5090,642.67
50217706,FA2021 ,12625,500,4580,2110,19815,27625,6925,20700,NULL,29125,0,29125,-16000,-9310,-9310,7263.58
50217706,FA2022 ,13005,515,4810,2220,20550,22425,2500,19925,NULL,22425,0,22425,-8905,-1875,-1875,7263.58
50217706,FA2023 ,13500,550,4790,1200,20040,19925,0,19925,NULL,19925,0,19925,-5875,115,115,7263.58
50217706,SP2021 ,12625,500,4580,2110,19815,19925,6925,13000,NULL,19925,0,19925,-6800,-110,-110,7263.58
50217706,SP2022 ,13005,515,4810,2220,20550,22425,2500,19925,NULL,22425,0,22425,-8905,-1875,-1875,7263.58
50217706,SP2023 ,13500,550,4790,1200,20040,19925,0,19925,NULL,19925,0,19925,-5875,115,115,7263.58
50220873,FA2021 ,12625,500,4580,2110,19815,23700,6000,17700,NULL,24700,0,24700,-11575,-4885,-4885,9884.88
50220873,FA2022 ,13005,515,4810,2220,20550,22650,8150,14500,NULL,22650,0,22650,-9130,-2100,-2100,9884.88
50220873,FA2023 ,13500,550,4790,1200,20040,20000,10000,10000,NULL,20000,0,20000,-5950,40,40,9884.88
50220873,FA2024 ,14750,600,5030,53.48,20433.48,22670,5500,17170,NULL,22670,0,22670,-7320,-2236.52,-2236.52,9884.88
50220873,SP2021 ,12625,500,4580,2110,19815,20300,6000,14300,NULL,20300,0,20300,-7175,-485,-485,9884.88
50220873,SP2022 ,13005,515,4810,2220,20550,22650,8150,14500,NULL,22650,0,22650,-9130,-2100,-2100,9884.88
50220873,SP2023 ,13500,550,4790,1200,20040,20000,10000,10000,NULL,20000,0,20000,-5950,40,40,9884.88
50220873,SP2024 ,14750,600,5030,NULL,20380,22670,5500,17170,NULL,22670,0,22670,-7320,-2290,-2290,9884.88
50232805,FA2024 ,14750,600,5410,2680,23440,9000,0,9000,2750,13438,0,16188,1912,10002,7252,0
50232805,SP2024 ,14750,600,5410,2450,23210,9000,0,9000,2750,12297,0,15047,3053,10913,8163,0
50221454,FA2021 ,12625,500,3740,2110,18975,9350,9350,0,10250,10350,0,20600,2775,8625,-1625,0
50221454,SP2021 ,12625,500,3740,2110,18975,9350,9350,0,10250,9350,0,19600,3775,9625,-625,0
50224860,FA2022 ,13005,515,3855,1140,18515,13520,13520,0,NULL,13520,0,13520,0,4995,4995,2169.91
50224860,FA2023 ,13500,550,4000,1200,19250,9000,6000,3000,NULL,9000,0,9000,5050,10250,10250,2169.91
50224860,SP2021 ,12625,500,3740,1080,17945,13293,13293,0,NULL,13293,0,13293,-168,4652,4652,2169.91
50224860,SP2022 ,13005,515,3855,1140,18515,9000,3500,5500,NULL,9000,0,9000,4520,9515,9515,2169.91
50219282,FA2021 ,12625,500,NULL,NULL,13125,925,925,0,10665,2425,0,13090,10700,10700,35,0
50219282,SP2021 ,12625,500,NULL,NULL,13125,925,925,0,14842,925,0,15767,12200,12200,-2642,0
50142126,FA2021 ,12625,500,4830,1080,19035,0,0,0,0,1000,0,1000,12125,18035,18035,0
50142126,SP2021 ,12625,500,4830,NULL,17955,0,0,0,0,0,0,0,13125,17955,17955,0
50209881,FA2021 ,12625,500,4830,NULL,17955,3425,0,3425,3750,4925,0,8675,8200,13030,9280,0
50209881,FA2022 ,13005,515,4610,NULL,18130,3425,1725,1700,3750,3425,0,7175,10095,14705,10955,0
50209881,SP2021 ,12625,6350,6350,NULL,18975,1500,1500,0,3750,1500,0,5250,17475,17475,13725,0
50209881,SP2022 ,13005,515,4610,NULL,18130,3425,1725,1700,3750,3425,0,7175,10095,14705,10955,0
50228229,FA2023 ,13500,550,4000,2325,20375,9000,9000,0,1750,9000,0,10750,5050,11375,9625,0
50228229,SP2023 ,13500,550,4000,2325,20375,9000,9000,0,2750,9000,0,11750,5050,11375,8625,0
50215282,FA2022 ,13005,515,4810,2220,20550,6000,6000,0,NULL,6000,0,6000,7520,14550,14550,0
50215282,SP2022 ,13005,515,4810,2220,20550,6000,6000,0,NULL,6000,0,6000,7520,14550,14550,0
50235051,FA2024 ,14750,600,4200,1270,20820,11328,11328,0,NULL,11328,0,11328,4022,9492,9492,390
50235051,SP2024 ,14750,600,4200,1270,20820,11328,11328,0,NULL,11328,0,11328,4022,9492,9492,390
50120970,FA2022 ,13005,515,4260,2220,20000,6000,6000,0,2750,6000,0,8750,7520,14000,11250,0
50120970,FA2023 ,13500,550,4560,2325,20935,6000,6000,0,0,6000,0,6000,8050,14935,14935,0
50120970,FA2024 ,14750,600,5720,1270,22340,6000,6000,0,3750,6000,0,9750,9350,16340,12590,0
50120970,SP2022 ,13005,515,4260,2220,20000,6000,6000,0,2750,6000,0,8750,7520,14000,11250,0
50120970,SP2023 ,13500,550,4560,2325,20935,6000,6000,0,0,6000,0,6000,8050,14935,14935,0
50120970,SP2024 ,14750,600,5720,1270,22340,6000,6000,0,3750,6000,0,9750,9350,16340,12590,0
50221001,FA2021 ,12625,500,3740,2550,19415,9250,7250,2000,2750,10250,0,13000,2875,9165,6415,0
50221001,FA2022 ,13005,515,3855,2690,20065,9000,7000,2000,3250,9000,0,12250,4520,11065,7815,0
50221001,FA2023 ,13500,550,4790,1200,20040,9050,300,8750,3750,9050,0,12800,5000,10990,7240,0
50221001,FA2024 ,14750,600,4200,2450,22000,9100,6600,2500,0,9100,0,9100,6250,12900,12900,0
50221001,SP2021 ,12625,500,3740,2550,19415,7274,7274,0,2750,7274,0,10024,5851,12141,9391,0
50221001,SP2022 ,13005,515,3855,2690,20065,6750,6750,0,3250,6750,0,10000,6770,13315,10065,0
50221001,SP2023 ,13500,550,4790,1200,20040,6750,0,6750,3750,6750,0,10500,7300,13290,9540,0
50229347,FA2023 ,13500,550,4000,2325,20375,14000,0,14000,NULL,14000,0,14000,50,6375,6375,9994.4
50229347,FA2024 ,14750,600,4200,2450,22000,15500,0,15500,NULL,19700,0,19700,-4350,2300,2300,9994.4
50229347,SP2023 ,13500,550,4000,2325,20375,14000,0,14000,NULL,14000,0,14000,50,6375,6375,9994.4
50229347,SP2024 ,14750,600,4200,2450,22000,15500,0,15500,NULL,19700,0,19700,-4350,2300,2300,9994.4
50222884,FA2021 ,12625,500,4580,2110,19815,5000,5000,0,2750,5000,0,7750,8125,14815,12065,0
50222884,FA2022 ,13005,515,3855,2220,19595,4500,4500,0,NULL,4500,0,4500,9020,15095,15095,0
50222884,FA2023 ,13500,550,NULL,NULL,14050,3105,3105,0,NULL,3105,0,3105,10945,10945,10945,0
50222884,FA2024 ,14750,600,NULL,NULL,15350,3105,2605,500,NULL,3105,0,3105,12245,12245,12245,0
50222884,SP2021 ,12625,500,4580,2110,19815,5000,5000,0,2750,5000,0,7750,8125,14815,12065,0
50222884,SP2022 ,13005,515,3855,2220,19595,4500,4500,0,NULL,4500,0,4500,9020,15095,15095,0
50222884,SP2023 ,13500,550,NULL,NULL,14050,3105,3105,0,NULL,3105,0,3105,10945,10945,10945,0
50222884,SP2024 ,14750,600,NULL,NULL,15350,3105,2605,500,NULL,3105,0,3105,12245,12245,12245,0
50211634,FA2021 ,12625,500,3740,NULL,16865,10050,8050,2000,3750,11550,0,15300,1575,5315,1565,3494.99
50211634,FA2022 ,13005,515,5080,NULL,18600,7800,7800,0,11425,7800,0,19225,5720,10800,-625,3494.99
50211634,FA2023 ,13500,550,5150,2325,21525,10200,8200,2000,3750,11772,0,15522,2278,9753,6003,3494.99
50211634,FA2024 ,4070,NULL,NULL,NULL,4070,2000,0,2000,NULL,2000,0,2000,2070,2070,2070,3494.99
50211634,SP2021 ,12625,500,3740,NULL,16865,8100,8100,0,3750,8100,0,11850,5025,8765,5015,3494.99
50211634,SP2023 ,13500,550,5150,2325,21525,8200,8200,0,3750,9773,0,13523,4277,11752,8002,3494.99
50234374,FA2024 ,15000,7500,7500,NULL,22500,0,0,0,NULL,0,0,0,22500,22500,22500,0
50204495,FA2021 ,12625,500,4830,1080,19035,3875,0,3875,3750,7748,0,11498,5377,11287,7537,0
50204495,SP2021 ,5200,500,4830,1080,11610,1596,0,1596,3750,2597,0,6347,3103,9013,5263,0
40001039,FA2021 ,12625,500,4580,2110,19815,4175,4175,0,3750,5675,0,9425,7450,14140,10390,0
40001039,FA2022 ,13005,515,4610,NULL,18130,4175,4175,0,3750,4175,0,7925,9345,13955,10205,0
40001039,SP2021 ,12625,500,4580,2110,19815,4175,4175,0,3750,4175,0,7925,8950,15640,11890,0
50205233,FA2021 ,12625,500,4830,NULL,17955,2175,0,2175,10015,3975,0,13990,9150,13980,3965,0
50205233,SP2021 ,12625,500,4830,NULL,17955,2175,0,2175,10015,2475,0,12490,10650,15480,5465,0
50227706,FA2023 ,13500,550,5150,2745,21945,9500,7500,2000,2750,9500,0,12250,4550,12445,9695,0
50227706,FA2024 ,14750,600,5410,2450,23210,9500,7500,2000,0,9500,0,9500,5850,13710,13710,0
50227706,SP2023 ,13500,550,5150,2745,21945,7500,7500,0,2750,7500,0,10250,6550,14445,11695,0
50227706,SP2024 ,14750,600,5410,2450,23210,7500,7500,0,0,7500,0,7500,7850,15710,15710,0
50221950,FA2021 ,12625,500,3740,2110,18975,8200,8200,0,2750,9200,0,11950,3925,9775,7025,249
50221950,FA2022 ,13005,515,3855,2220,19595,7700,7700,0,3250,7700,0,10950,5820,11895,8645,249
50221950,FA2023 ,13500,550,5440,NULL,19490,7700,5000,2700,3750,7700,0,11450,6350,11790,8040,249
50221950,FA2024 ,14750,600,6090,NULL,21440,7700,5000,2700,13750,7700,0,21450,7650,13740,-10,249
50221950,SP2021 ,12625,500,3740,2110,18975,8200,8200,0,2750,8200,0,10950,4925,10775,8025,249
50221950,SP2022 ,13005,515,3855,2220,19595,7700,7700,0,3250,7700,0,10950,5820,11895,8645,249
50221950,SP2023 ,13500,550,5440,NULL,19490,7700,5000,2700,3750,7700,0,11450,6350,11790,8040,249
50221950,SP2024 ,14750,600,6090,NULL,21440,7700,5000,2700,13750,7700,0,21450,7650,13740,-10,249
50212624,FA2021 ,12625,500,3740,2110,18975,8425,7425,1000,NULL,9925,0,9925,3200,9050,9050,0
50212624,FA2022 ,13005,515,3855,2220,19595,7425,7425,0,NULL,7425,0,7425,6095,12170,12170,0
50212624,SP2021 ,12625,500,3740,2110,18975,9425,7425,2000,NULL,9425,0,9425,3700,9550,9550,0
50212624,SP2022 ,13005,515,3855,2220,19595,7425,7425,0,NULL,7425,0,7425,6095,12170,12170,0
50221426,FA2021 ,12625,500,3740,2110,18975,5250,5250,0,2750,9850,0,12600,3275,9125,6375,5812.16
50221426,FA2022 ,13005,515,3855,2220,19595,4500,4500,0,3250,4500,0,7750,9020,15095,11845,5812.16
50221426,FA2023 ,13500,550,4790,1200,20040,4500,4500,0,3750,4500,0,8250,9550,15540,11790,5812.16
50221426,FA2024 ,14750,600,5030,1270,21650,4500,4500,0,NULL,4500,0,4500,10850,17150,17150,5812.16
50221426,SP2021 ,12625,500,3740,2110,18975,5000,5000,0,2750,5000,0,7750,8125,13975,11225,5812.16
50221426,SP2022 ,13005,515,4610,1140,19270,4500,4500,0,3250,4500,0,7750,9020,14770,11520,5812.16
50221426,SP2023 ,13500,550,4790,1200,20040,4500,4500,0,3750,4500,0,8250,9550,15540,11790,5812.16
50221426,SP2024 ,14750,600,5030,NULL,20380,4500,4500,0,NULL,4500,0,4500,10850,15880,15880,5812.16
50233249,FA2024 ,14750,600,5410,2680,23440,7000,7000,0,2750,7000,0,9750,8350,16440,13690,0
50233249,SP2024 ,14750,600,5410,2680,23440,7000,7000,0,2750,7000,0,9750,8350,16440,13690,0
50230521,FA2023 ,6750,275,NULL,NULL,7025,3088,2338,750,1414,3249,0,4663,3776,3776,2362,1771.66
50209793,FA2021 ,12625,500,4470,NULL,17595,2000,0,2000,3750,17995,12625,21745,-4870,-400,-4150,0
50209793,FA2022 ,13005,515,NULL,NULL,13520,500,0,500,NULL,13505,13005,13505,15,15,15,0
50209793,SP2021 ,12625,500,4470,NULL,17595,0,0,0,3750,14495,12625,18245,-1370,3100,-650,0
50117818,FA2021 ,12625,500,4650,2110,19885,2675,2675,0,NULL,2675,0,2675,10450,17210,17210,0
50117818,SP2021 ,12625,500,4650,2110,19885,2675,2675,0,NULL,2675,0,2675,10450,17210,17210,0
50210684,FA2021 ,19340,860,4600,2110,26050,11150,11150,0,0,17390,0,17390,2810,8660,8660,0
50210684,FA2022 ,13005,515,3855,2220,19595,11150,11150,0,3750,15555,0,19305,-2035,4040,290,0
50210684,SP2021 ,12625,500,3740,2110,18975,11150,11150,0,0,15890,0,15890,-2765,3085,3085,0
50210684,SP2022 ,13005,515,3855,2220,19595,11150,11150,0,3750,15555,0,19305,-2035,4040,290,0
50203483,FA2021 ,12625,500,NULL,NULL,13125,6275,0,6275,3750,16300,0,20050,-3175,-3175,-6925,0
50231294,FA2024 ,14750,600,4200,2450,22000,8500,8500,0,2750,8500,0,11250,6850,13500,10750,0
50231294,SP2024 ,14750,600,4200,2450,22000,8500,8500,0,2750,8500,0,11250,6850,13500,10750,0
50226539,FA2022 ,13005,515,NULL,NULL,13520,8000,7000,1000,NULL,8000,0,8000,5520,5520,5520,0
50226539,FA2023 ,13500,550,NULL,NULL,14050,8000,7000,1000,NULL,8000,0,8000,6050,6050,6050,0
50226539,SP2022 ,13005,515,NULL,NULL,13520,8000,7000,1000,NULL,8000,0,8000,5520,5520,5520,0
50223327,FA2021 ,12625,500,4050,2110,19285,5550,5550,0,4750,11198,0,15948,1927,8087,3337,2684
50223327,FA2022 ,13005,515,NULL,NULL,13520,3829,3029,800,5250,9076,0,14326,4444,4444,-806,2684
50223327,FA2023 ,13500,550,4000,NULL,18050,5950,5150,800,6250,11022,0,17272,3028,7028,778,2684
50223327,SP2021 ,12625,500,4050,2110,19285,10493,5550,4943,4750,15700,0,20450,-2575,3585,-1165,2684
50223327,SP2022 ,13005,515,3855,1140,18515,7550,4750,2800,5250,12797,0,18047,723,5718,468,2684
50223327,SP2023 ,13500,550,4000,NULL,18050,5950,5150,800,6250,11023,0,17273,3027,7027,777,2684
50220531,FA2021 ,12625,500,4580,2550,20255,7000,7000,0,2750,7000,0,9750,6125,13255,10505,0
50220531,SP2021 ,12625,500,4240,2110,19475,7000,7000,0,2750,7000,0,9750,6125,12475,9725,0
50219058,FA2021 ,6960,250,NULL,NULL,7210,3722,3722,0,NULL,4722,0,4722,2488,2488,2488,0
50219058,SP2021 ,6960,250,NULL,NULL,7210,6998,3998,3000,NULL,6998,0,6998,212,212,212,0
50215475,FA2021 ,12625,500,4050,2550,19725,7575,7575,0,3250,9075,0,12325,4050,10650,7400,0
50215475,FA2022 ,13005,515,5080,2690,21290,7575,7575,0,NULL,7575,0,7575,5945,13715,13715,0
50215475,FA2023 ,13500,6825,6825,NULL,20325,7575,0,7575,NULL,7575,0,7575,12750,12750,12750,0
50215475,SP2021 ,12625,500,4050,2550,19725,7575,7575,0,3250,7575,0,10825,5550,12150,8900,0
50215475,SP2022 ,13005,515,5080,2690,21290,7575,7575,0,NULL,7575,0,7575,5945,13715,13715,0
50215475,SP2023 ,13500,550,5150,2745,21945,7575,0,7575,NULL,7575,0,7575,6475,14370,14370,0
50216635,FA2021 ,12625,500,3740,2110,18975,9925,7775,2150,5250,17073,0,22323,-3948,1902,-3348,0
50216635,FA2022 ,13005,515,4260,1140,18920,7775,7775,0,6250,17623,0,23873,-4103,1297,-4953,0
50216635,FA2023 ,13500,550,5440,1200,20690,8275,6625,1650,6250,17548,0,23798,-3498,3142,-3108,0
50216635,SP2021 ,12625,500,3740,2110,18975,7775,7775,0,5250,12982,0,18232,143,5993,743,0
50216635,SP2022 ,13005,515,4260,1140,18920,7775,7775,0,2750,19122,0,21872,-5602,-202,-2952,0
50218860,FA2021 ,12625,500,3740,NULL,16865,8375,0,8375,NULL,9875,0,9875,3250,6990,6990,0
50218860,FA2022 ,13005,515,5420,NULL,18940,6375,0,6375,NULL,6375,0,6375,7145,12565,12565,0
50218860,FA2023 ,13500,550,5800,NULL,19850,6375,0,6375,NULL,6375,0,6375,7675,13475,13475,0
50218860,SP2021 ,12625,500,3740,NULL,16865,6375,0,6375,NULL,6375,0,6375,6750,10490,10490,0
50218860,SP2022 ,13005,515,5420,NULL,18940,6375,0,6375,NULL,6375,0,6375,7145,12565,12565,0
50218860,SP2023 ,13500,550,5800,NULL,19850,6375,0,6375,NULL,6375,0,6375,7675,13475,13475,0
50228188,FA2023 ,13500,550,5150,2745,21945,9000,7500,1500,14750,9000,0,23750,5050,12945,-1805,0
50228188,FA2024 ,14750,600,4790,2450,22590,9000,7500,1500,15810,9000,0,24810,6350,13590,-2220,0
50228188,SP2023 ,13500,550,5150,2745,21945,9000,7500,1500,13750,9000,0,22750,5050,12945,-805,0
50228188,SP2024 ,14750,600,4790,2450,22590,9000,7500,1500,14690,9000,0,23690,6350,13590,-1100,0
50226540,FA2023 ,1940,NULL,NULL,NULL,1940,0,0,0,NULL,0,0,0,1940,1940,1940,0
50203519,FA2021 ,12625,500,4830,1080,19035,2425,2425,0,3750,3425,0,7175,9700,15610,11860,0
50203519,SP2021 ,12625,500,4830,2110,20065,2425,2425,0,3750,2425,0,6175,10700,17640,13890,0
50215810,FA2021 ,12625,500,4050,2110,19285,11575,9575,2000,3250,13075,0,16325,50,6210,2960,0
50215810,FA2022 ,13005,515,5080,1140,19740,11825,250,11575,3750,11825,0,15575,1695,7915,4165,0
50215810,SP2021 ,12625,500,4050,2110,19285,9575,9575,0,3250,9575,0,12825,3550,9710,6460,0
50215810,SP2022 ,13005,515,5080,1140,19740,9575,0,9575,3750,9575,0,13325,3945,10165,6415,0
50224723,FA2022 ,13005,515,4260,2220,20000,8250,8250,0,2750,8250,0,11000,5270,11750,9000,0
50224723,FA2023 ,13500,550,5150,2325,21525,7000,7000,0,NULL,7000,0,7000,7050,14525,14525,0
50224723,SP2022 ,13005,515,4260,2220,20000,8250,8250,0,2750,8250,0,11000,5270,11750,9000,0
50224723,SP2023 ,13500,550,5150,2325,21525,7000,7000,0,NULL,7000,0,7000,7050,14525,14525,0
50232461,FA2024 ,14750,600,4790,2450,22590,6000,6000,0,2750,6000,0,8750,9350,16590,13840,0
50232461,SP2024 ,14750,600,4790,2450,22590,6000,6000,0,2750,6000,0,8750,9350,16590,13840,0
50231961,SP2023 ,14500,7000,7000,NULL,21500,0,0,0,NULL,0,0,0,21500,21500,21500,0
50217058,FA2021 ,12625,500,3740,2110,18975,8375,8375,0,3250,14448,0,17698,-1323,4527,1277,0
50217058,SP2021 ,12625,500,3740,2110,18975,8375,8375,0,3250,12447,0,15697,678,6528,3278,0
50224530,FA2022 ,13005,515,3855,2220,19595,6250,6250,0,14454,6250,0,20704,7270,13345,-1109,0
50224530,FA2023 ,13500,550,5150,2325,21525,6250,6250,0,16750,6550,0,23300,7500,14975,-1775,0
50224530,FA2024 ,14750,600,5030,1270,21650,6750,6250,500,16950,7250,0,24200,8100,14400,-2550,0
50224530,SP2022 ,13005,515,3855,2220,19595,6250,6250,0,14750,6250,0,21000,7270,13345,-1405,0
50224530,SP2023 ,13500,550,5150,2325,21525,6250,6250,0,12936,6550,0,19486,7500,14975,2039,0
50224530,SP2024 ,14750,600,5030,1270,21650,6750,6250,500,12800,6750,0,19550,8600,14900,2100,0
50222615,FA2021 ,12625,500,3740,2110,18975,4500,4500,0,13653,9523,0,23176,3602,9452,-4201,-1
50222615,FA2022 ,13005,515,NULL,2220,15740,2760,2760,0,14318,8007,0,22325,5513,7733,-6585,-1
50222615,FA2023 ,13500,550,NULL,1200,15250,4400,4400,0,11630,8122,0,19752,5928,7128,-4502,-1
50222615,FA2024 ,14750,600,4790,2450,22590,4000,4000,0,14884,8098,0,22982,7252,14492,-392,-1
50222615,SP2021 ,12625,500,NULL,NULL,13125,3260,3260,0,5729,6782,0,12511,6343,6343,614,-1
50222615,SP2022 ,13005,515,NULL,1140,14660,2760,2760,0,14318,8008,0,22326,5512,6652,-7666,-1
50222615,SP2023 ,13500,550,NULL,1200,15250,3160,3160,0,8971,6883,0,15854,7167,8367,-604,-1
50222615,SP2024 ,14750,600,4790,2450,22590,4000,4000,0,15521,8097,0,23618,7253,14493,-1028,-1
50228045,FA2023 ,13500,550,5150,2325,21525,8700,7150,1550,2750,8700,0,11450,5350,12825,10075,-4009
50228045,FA2024 ,14750,600,5410,2450,23210,8550,6550,2000,3250,9263,0,12513,6087,13947,10697,-4009
50228045,SP2023 ,13500,550,5150,2325,21525,8700,7150,1550,2750,8700,0,11450,5350,12825,10075,-4009
50228045,SP2024 ,14750,600,5410,2450,23210,8550,6550,2000,15250,9262,0,24512,6088,13948,-1302,-4009
50160396,FA2021 ,12625,500,3740,2110,18975,6000,6000,0,NULL,6000,0,6000,7125,12975,12975,0
50160396,FA2022 ,13005,515,5080,NULL,18600,6000,6000,0,NULL,6000,0,6000,7520,12600,12600,0
50160396,SP2021 ,12625,500,3740,2110,18975,6000,6000,0,NULL,6000,0,6000,7125,12975,12975,0
50225713,FA2022 ,13005,515,4260,2220,20000,9150,9150,0,2750,12598,0,15348,922,7402,4652,4164
50225713,FA2023 ,13500,550,4560,2325,20935,9250,9250,0,3250,13248,0,16498,802,7687,4437,4164
50225713,FA2024 ,14750,600,4790,2450,22590,8850,7500,1350,3750,13748,0,17498,1602,8842,5092,4164
50225713,SP2022 ,13005,515,4260,2220,20000,9150,9150,0,2750,12597,0,15347,923,7403,4653,4164
50225713,SP2023 ,13500,550,4560,2325,20935,9250,9250,0,3250,13247,0,16497,803,7688,4438,4164
50225713,SP2024 ,14750,600,4790,2450,22590,8850,7500,1350,3750,13747,0,17497,1603,8843,5093,4164
50228005,FA2023 ,13500,550,4000,2325,20375,10000,7500,2500,2750,10000,0,12750,4050,10375,7625,1978.33
50228005,FA2024 ,14750,600,4790,2450,22590,7500,7500,0,3250,15198,0,18448,152,7392,4142,1978.33
50228005,SP2023 ,13500,550,4560,2325,20935,7500,7500,0,2750,7500,0,10250,6550,13435,10685,1978.33
50228005,SP2024 ,14750,600,4790,1270,21410,7500,7500,0,3250,12697,0,15947,2653,8713,5463,1978.33
40001117,FA2021 ,12625,500,4580,2110,19815,5625,5625,0,3250,14123,0,17373,-998,5692,2442,0
40001117,FA2022 ,13005,515,5080,1140,19740,5625,5625,0,5750,12598,0,18348,922,7142,1392,0
40001117,FA2023 ,13500,550,5150,2325,21525,6525,6525,0,5750,12973,0,18723,1077,8552,2802,0
40001117,SP2021 ,12625,500,4580,2110,19815,5625,5625,0,3250,13182,0,16432,-57,6633,3383,0
40001117,SP2022 ,13005,515,5080,1140,19740,5625,5625,0,5750,12597,0,18347,923,7143,1393,0
40001117,SP2023 ,13500,550,5150,2325,21525,6525,6525,0,5750,12972,0,18722,1078,8553,2803,0
50235137,FA2024 ,14750,600,4200,2450,22000,7553,7553,0,6750,7553,0,14303,7797,14447,7697,1050
50222038,FA2021 ,12625,500,3740,2550,19415,8400,8400,0,2750,9400,0,12150,3725,10015,7265,0
50222038,FA2022 ,13005,515,3855,2220,19595,8400,8400,0,3250,12255,0,15505,1265,7340,4090,0
50222038,FA2023 ,13500,550,4000,2325,20375,7900,7200,700,3750,11900,0,15650,2150,8475,4725,0
50222038,FA2024 ,14750,7250,7250,NULL,22000,9350,7900,1450,3750,11408,0,15158,10592,10592,6842,0
50222038,SP2021 ,12625,500,3740,2110,18975,8400,8400,0,2750,8400,0,11150,4725,10575,7825,0
50222038,SP2022 ,13005,515,3855,2220,19595,8400,8400,0,3250,12255,0,15505,1265,7340,4090,0
50222038,SP2023 ,13500,550,4000,2325,20375,7900,7200,700,3750,11900,0,15650,2150,8475,4725,0
50222038,SP2024 ,14750,600,4200,2450,22000,7450,6000,1450,3750,9507,0,13257,5843,12493,8743,0
50227111,FA2022 ,13005,515,4260,2220,20000,6250,6250,0,3750,9698,0,13448,3822,10302,6552,0
50227111,FA2023 ,13500,550,5150,2325,21525,6400,6400,0,3750,9523,0,13273,4527,12002,8252,0
50227111,SP2022 ,13005,515,4810,2220,20550,6250,6250,0,3750,9697,0,13447,3823,10853,7103,0
50227111,SP2023 ,13500,550,5150,1200,20400,6400,6400,0,3750,9522,0,13272,4528,10878,7128,0
50204533,FA2021 ,12625,500,NULL,NULL,13125,5350,0,5350,3750,15347,0,19097,-2222,-2222,-5972,0
50204533,SP2021 ,6960,250,NULL,NULL,7210,3161,0,3161,3750,5845,0,9595,1365,1365,-2385,0
50214749,FA2021 ,12625,500,4050,2110,19285,6175,6175,0,3250,7675,0,10925,5450,11610,8360,0
50214749,FA2022 ,13005,515,4610,NULL,18130,6175,6175,0,3250,8398,0,11648,5122,9732,6482,0
50214749,SP2021 ,12625,500,4050,2110,19285,6175,6175,0,3250,6175,0,9425,6950,13110,9860,0
50214749,SP2022 ,13005,515,4610,NULL,18130,6175,6175,0,3250,8397,0,11647,5123,9733,6483,0
50214749,SP2023 ,13500,550,NULL,NULL,14050,8675,4475,4200,3750,8675,0,12425,5375,5375,1625,0
50231607,FA2024 ,14750,600,4790,2450,22590,5500,5500,0,16471,5500,0,21971,9850,17090,619,0
50231607,SP2024 ,14750,600,4790,2450,22590,5500,5500,0,16471,5500,0,21971,9850,17090,619,0
50226194,FA2022 ,13005,515,3855,2220,19595,6750,6750,0,14430,6750,0,21180,6770,12845,-1585,100
50226194,FA2023 ,13500,550,4000,2325,20375,6750,6750,0,13650,6750,0,20400,7300,13625,-25,100
50226194,FA2024 ,14750,600,6090,1270,22710,6750,5750,1000,16724,6750,0,23474,8600,15960,-764,100
50226194,SP2022 ,13005,515,3855,2220,19595,6750,6750,0,14374,6750,0,21124,6770,12845,-1529,100
50226194,SP2023 ,13500,550,4000,2325,20375,6750,6750,0,14453,6750,0,21203,7300,13625,-828,100
50226194,SP2024 ,14750,600,6090,1270,22710,6750,5750,1000,17050,6750,0,23800,8600,15960,-1090,100
50212315,FA2021 ,12625,500,4270,1080,18475,3675,0,3675,17597,5175,0,22772,7950,13300,-4297,7771.25
50212315,FA2022 ,13005,515,342,13.95,13875.95,1425,1425,0,22451,1425,0,23876,12095,12450.95,-10000.05,7771.25
50212315,SP2021 ,12625,500,4270,1080,18475,3675,0,3675,17597,3675,0,21272,9450,14800,-2797,7771.25
50212315,SP2022 ,13005,515,5080,1140,19740,2925,2925,0,22452,2925,0,25377,10595,16815,-5637,7771.25
50229151,FA2023 ,13500,550,5150,2325,21525,4500,4500,0,2750,4500,0,7250,9550,17025,14275,0
50229151,FA2024 ,14750,600,5030,NULL,20380,5000,4500,500,3750,5000,0,8750,10350,15380,11630,0
50229151,SP2022 ,13005,515,4380,2220,20120,4500,4500,0,2750,4500,0,7250,9020,15620,12870,0
50229151,SP2023 ,13500,550,5150,2325,21525,4500,4500,0,2750,4500,0,7250,9550,17025,14275,0
50229151,SP2024 ,14750,600,NULL,NULL,15350,3605,3105,500,3750,3605,0,7355,11745,11745,7995,0
50221749,FA2021 ,12625,500,3740,2550,19415,6500,6500,0,2750,10000,0,12750,3125,9415,6665,35
50221749,FA2022 ,7170,515,3855,2220,13760,3308,3308,0,3250,3308,0,6558,4377,10452,7202,35
50221749,FA2023 ,13500,550,4790,2325,21165,6000,6000,0,3750,6000,0,9750,8050,15165,11415,35
50221749,FA2024 ,14750,600,5030,2450,22830,6000,6000,0,NULL,6000,0,6000,9350,16830,16830,35
50221749,SP2021 ,12625,500,3740,2110,18975,6500,6500,0,2750,6500,0,9250,6625,12475,9725,35
50221749,SP2022 ,13005,515,3855,2220,19595,6000,6000,0,3250,6000,0,9250,7520,13595,10345,35
50221749,SP2023 ,13500,550,4790,2325,21165,6000,6000,0,3750,6000,0,9750,8050,15165,11415,35
50221749,SP2024 ,14750,600,5030,2450,22830,6000,6000,0,NULL,6000,0,6000,9350,16830,16830,35
50222013,FA2021 ,12625,500,3740,2110,18975,5500,5500,0,2750,6500,0,9250,6625,12475,9725,15
50222013,FA2022 ,13005,515,3855,2220,19595,5000,5000,0,NULL,5000,0,5000,8520,14595,14595,15
50222013,FA2023 ,13500,550,5150,2325,21525,5000,5000,0,NULL,5000,0,5000,9050,16525,16525,15
50222013,FA2024 ,14750,600,5410,2450,23210,5000,5000,0,NULL,5000,0,5000,10350,18210,18210,15
50222013,SP2021 ,12625,500,3740,2110,18975,5500,5500,0,2750,5500,0,8250,7625,13475,10725,15
50222013,SP2022 ,13005,515,3855,2220,19595,5000,5000,0,NULL,5000,0,5000,8520,14595,14595,15
50222013,SP2023 ,13500,550,5150,2325,21525,5000,5000,0,NULL,5000,0,5000,9050,16525,16525,15
50222013,SP2024 ,14750,600,5410,2450,23210,5000,5000,0,NULL,5000,0,5000,10350,18210,18210,15
50212447,FA2021 ,12625,500,NULL,NULL,13125,0,0,0,3750,1000,0,4750,12125,12125,8375,0
50212447,FA2022 ,13005,515,NULL,NULL,13520,0,0,0,3750,0,0,3750,13520,13520,9770,0
50212447,SP2021 ,12625,500,NULL,NULL,13125,0,0,0,3750,0,0,3750,13125,13125,9375,0
50212447,SP2022 ,13005,515,NULL,NULL,13520,0,0,0,3750,0,0,3750,13520,13520,9770,0
50228950,FA2023 ,13500,550,4560,2325,20935,6500,6500,0,2750,6500,0,9250,7550,14435,11685,6435.48
50228950,FA2024 ,14750,600,4200,2450,22000,6500,6500,0,3250,6500,0,9750,8850,15500,12250,6435.48
50228950,SP2023 ,13500,550,4560,2325,20935,6500,6500,0,2750,6500,0,9250,7550,14435,11685,6435.48
50228950,SP2024 ,14750,600,4200,2450,22000,6500,6500,0,3250,6500,0,9750,8850,15500,12250,6435.48
50209337,FA2021 ,12625,500,4050,1080,18255,7025,7025,0,3750,8525,0,12275,4600,9730,5980,0
50209337,FA2022 ,13005,515,5080,NULL,18600,7025,7025,0,3750,7025,0,10775,6495,11575,7825,0
50209337,SP2021 ,12625,500,4270,1080,18475,7025,7025,0,3750,7025,0,10775,6100,11450,7700,0
50209337,SP2022 ,13005,515,5080,NULL,18600,7025,7025,0,3750,7025,0,10775,6495,11575,7825,0
50214438,FA2021 ,12625,500,3740,2110,18975,7425,0,7425,3750,7925,0,11675,5200,11050,7300,0
50214438,FA2022 ,13005,515,4610,NULL,18130,7425,0,7425,3750,7925,0,11675,5595,10205,6455,0
50214438,SP2021 ,12625,500,3740,2110,18975,7425,0,7425,3750,7925,0,11675,5200,11050,7300,0
50214438,SP2022 ,13005,6590,6590,NULL,19595,3600,3600,0,3750,4100,0,7850,15495,15495,11745,0
50231009,FA2023 ,13500,550,5150,2325,21525,5750,5750,0,3750,10948,0,14698,3102,10577,6827,-50
50231009,SP2023 ,13500,550,5150,1200,20400,5500,5500,0,3750,10697,0,14447,3353,9703,5953,-50
50210794,FA2021 ,12625,500,4470,NULL,17595,5425,5425,0,3750,9548,0,13298,3577,8047,4297,0
50227422,FA2023 ,13500,550,4000,2325,20375,10500,5000,5500,NULL,10500,0,10500,3550,9875,9875,-3330
50227422,FA2024 ,14750,600,5240,2450,23040,10500,1000,9500,NULL,10500,0,10500,4850,12540,12540,-3330
50227422,SP2022 ,13005,515,4810,2220,20550,9000,9000,0,NULL,9000,0,9000,4520,11550,11550,-3330
50227422,SP2023 ,13500,550,4000,1200,19250,9500,5000,4500,NULL,11900,0,11900,2150,7350,7350,-3330
50227422,SP2024 ,14750,600,5240,2450,23040,13900,1000,12900,NULL,13900,0,13900,1450,9140,9140,-3330
50229703,FA2023 ,13500,550,5150,2325,21525,6000,6000,0,0,6000,0,6000,8050,15525,15525,7519.5
50229703,FA2024 ,14750,600,5030,NULL,20380,6000,6000,0,NULL,6000,0,6000,9350,14380,14380,7519.5
50229703,SP2023 ,13500,550,5150,2325,21525,6000,6000,0,0,6750,0,6750,7300,14775,14775,7519.5
50229703,SP2024 ,14750,600,5030,NULL,20380,6000,6000,0,NULL,6000,0,6000,9350,14380,14380,7519.5
40001141,FA2021 ,12625,500,4580,2110,19815,4925,4925,0,NULL,5425,0,5425,7700,14390,14390,0
40001141,FA2022 ,13005,515,5080,1140,19740,4925,4925,0,NULL,4925,0,4925,8595,14815,14815,0
40001141,FA2023 ,13500,550,5800,2325,22175,4925,4925,0,NULL,4925,0,4925,9125,17250,17250,0
40001141,SP2021 ,12625,500,4580,2110,19815,4925,4925,0,NULL,4925,0,4925,8200,14890,14890,0
40001141,SP2022 ,13005,515,5080,1140,19740,4925,4925,0,NULL,4925,0,4925,8595,14815,14815,0
40001141,SP2023 ,7450,550,5800,1200,15000,2718,2718,0,NULL,2718,0,2718,5282,12282,12282,0
50222617,FA2021 ,12625,500,4580,2110,19815,4500,4500,0,2750,4500,0,7250,8625,15315,12565,0
50222617,FA2022 ,13005,515,4610,1140,19270,4000,4000,0,NULL,4000,0,4000,9520,15270,15270,0
50222617,SP2021 ,12625,500,4580,2110,19815,4500,4500,0,2750,4500,0,7250,8625,15315,12565,0
50222617,SP2022 ,13005,515,3855,1140,18515,4000,4000,0,NULL,4000,0,4000,9520,14515,14515,0
50231962,SP2023 ,14500,7000,7000,NULL,21500,0,0,0,NULL,0,0,0,21500,21500,21500,0
50213309,FA2021 ,12625,500,3740,2550,19415,12413,7888,4525,NULL,13913,0,13913,-788,5502,5502,928.52
50213309,FA2022 ,13005,515,3855,1140,18515,17913,11913,6000,NULL,17913,0,17913,-4393,602,602,928.52
50213309,FA2023 ,13500,6825,6825,NULL,20325,12700,5400,7300,NULL,12700,0,12700,7625,7625,7625,928.52
50213309,SP2021 ,12625,500,3740,2550,19415,17412,12412,5000,NULL,17412,0,17412,-4287,2003,2003,928.52
50213309,SP2022 ,13005,515,3855,1140,18515,18912,11912,7000,NULL,18912,0,18912,-5392,-397,-397,928.52
50213309,SP2023 ,13500,550,5440,1200,20690,20413,0,20413,NULL,20413,0,20413,-6363,277,277,928.52
50227948,FA2023 ,13500,550,4560,2325,20935,7000,7000,0,2750,8000,0,10750,6050,12935,10185,-186.06
50227948,FA2024 ,14750,600,4790,2450,22590,7000,7000,0,3250,7000,0,10250,8350,15590,12340,-186.06
50227948,SP2023 ,13500,550,4560,2325,20935,7000,7000,0,2750,7000,0,9750,7050,13935,11185,-186.06
50227948,SP2024 ,14750,600,4790,2450,22590,7000,7000,0,3250,7000,0,10250,8350,15590,12340,-186.06
50221697,FA2021 ,12625,500,4580,2110,19815,5000,5000,0,2750,6000,0,8750,7125,13815,11065,1540
50221697,FA2022 ,13005,515,3855,2220,19595,4500,4500,0,3250,9348,0,12598,4172,10247,6997,1540
50221697,FA2023 ,13500,6825,6825,NULL,20325,4500,4500,0,3750,7573,0,11323,12752,12752,9002,1540
50221697,FA2024 ,14750,600,5030,1270,21650,4500,4500,0,6250,8598,0,14848,6752,13052,6802,1540
50221697,SP2021 ,12625,500,4580,2110,19815,5000,5000,0,2750,5000,0,7750,8125,14815,12065,1540
50221697,SP2022 ,13005,515,3855,2220,19595,4500,4500,0,3250,8347,0,11597,5173,11248,7998,1540
50221697,SP2023 ,13500,550,4000,2325,20375,4500,4500,0,3750,7572,0,11322,6478,12803,9053,1540
50221697,SP2024 ,14750,600,5030,1270,21650,4500,4500,0,6250,8597,0,14847,6753,13053,6803,1540
50225240,FA2022 ,13005,515,3855,2220,19595,6050,6050,0,2750,9498,0,12248,4022,10097,7347,2788
50225240,FA2023 ,13500,550,4000,2325,20375,6050,5000,1050,3250,10123,0,13373,3927,10252,7002,2788
50225240,FA2024 ,14750,600,4200,2450,22000,6050,5000,1050,3750,10055,0,13805,5295,11945,8195,2788
50225240,SP2022 ,13005,515,3855,2220,19595,6050,6050,0,2750,9497,0,12247,4023,10098,7348,2788
50225240,SP2023 ,13500,550,4000,2325,20375,6050,5000,1050,3250,10122,0,13372,3928,10253,7003,2788
50225240,SP2024 ,14750,600,4200,2450,22000,6050,5000,1050,3750,10055,0,13805,5295,11945,8195,2788
50222457,FA2021 ,12625,500,4580,2110,19815,6300,6300,0,16750,7300,0,24050,5825,12515,-4235,0
50222457,FA2022 ,13005,515,4260,2220,20000,5800,5800,0,15450,5800,0,21250,7720,14200,-1250,0
50222457,SP2021 ,12625,500,4580,2110,19815,6300,6300,0,12450,6300,0,18750,6825,13515,1065,0
50222457,SP2022 ,13005,515,4260,2220,20000,5800,5800,0,15250,5800,0,21050,7720,14200,-1050,0
50210120,FA2022 ,13005,515,4810,2220,20550,6500,6500,0,2750,6500,0,9250,7020,14050,11300,0
50210120,FA2023 ,13500,550,4560,1200,19810,7500,7500,0,3750,7500,0,11250,6550,12310,8560,0
50210120,SP2022 ,13005,515,4810,2220,20550,6500,6500,0,2750,6500,0,9250,7020,14050,11300,0
50210120,SP2023 ,13500,550,4560,1200,19810,7500,7500,0,0,7500,0,7500,6550,12310,12310,0
50233577,FA2024 ,14750,600,5410,2450,23210,8800,8800,0,2750,12498,0,15248,2852,10712,7962,0
50233577,SP2024 ,14750,600,5410,2450,23210,8800,8800,0,2750,12497,0,15247,2853,10713,7963,0
50074752,FA2021 ,12625,500,4270,1080,18475,0,0,0,0,0,0,0,13125,18475,18475,0
50074752,SP2021 ,12625,500,4270,1080,18475,0,0,0,18900,0,0,18900,13125,18475,-425,0
50231963,SP2023 ,14500,7000,7000,NULL,21500,0,0,0,NULL,0,0,0,21500,21500,21500,0
50226584,FA2022 ,3580,NULL,NULL,NULL,3580,0,0,0,NULL,0,0,0,3580,3580,3580,0
50226584,FA2023 ,13500,550,4990,2325,21365,4500,4500,0,NULL,4500,0,4500,9550,16865,16865,0
50226584,FA2024 ,14750,600,5240,1270,21860,4500,4500,0,NULL,4500,0,4500,10850,17360,17360,0
50226584,SP2022 ,13005,515,4800,2220,20540,3000,3000,0,NULL,3000,0,3000,10520,17540,17540,0
50226584,SP2023 ,13500,550,4990,2325,21365,4500,4500,0,NULL,4500,0,4500,9550,16865,16865,0
50226584,SP2024 ,14750,600,5240,1270,21860,4500,4500,0,NULL,4500,0,4500,10850,17360,17360,0
50215186,FA2021 ,19340,860,4600,2110,26050,14500,14500,0,3250,19273,0,22523,927,6777,3527,0
50215186,FA2022 ,19910,890,5270,2220,27400,14500,14500,0,3750,17673,0,21423,3127,9727,5977,0
50215186,SP2021 ,19340,860,4600,2110,26050,14500,14500,0,3250,17272,0,20522,2928,8778,5528,0
50215186,SP2022 ,19910,890,5270,2220,27400,14500,14500,0,3750,17672,0,21422,3128,9728,5978,0
50215448,FA2021 ,19340,860,4910,2110,26360,16625,16625,0,3250,20823,0,24073,-623,5537,2287,0
50215448,FA2022 ,19910,890,4745,1140,25795,16250,16250,0,3750,21500,0,25250,-700,4295,545,0
50215448,FA2023 ,20670,950,5740,1200,27610,16750,9500,7250,3750,22722,0,26472,-1102,4888,1138,0
50215448,SP2021 ,19340,860,4910,2110,26360,16624,16624,0,3250,18822,0,22072,1378,7538,4288,0
50215448,SP2022 ,19910,890,4745,1140,25795,16250,16250,0,3750,21500,0,25250,-700,4295,545,0
50215448,SP2023 ,20670,950,5740,NULL,26410,16750,9500,7250,3750,22723,0,26473,-1103,3687,-63,0
50216212,FA2021 ,19340,860,4600,2110,26050,14500,14500,0,3250,19273,0,22523,927,6777,3527,0
50216212,FA2022 ,19910,890,4745,1140,25795,14500,14500,0,3750,17473,0,21223,3327,8322,4572,0
50216212,FA2023 ,20670,950,5740,1200,27610,15000,15000,0,3750,17873,0,21623,3747,9737,5987,0
50216212,SP2021 ,19340,860,4600,2110,26050,14500,14500,0,3250,17272,0,20522,2928,8778,5528,0
50216212,SP2022 ,19910,890,4745,1140,25795,14500,14500,0,3750,17472,0,21222,3328,8323,4573,0
50216212,SP2023 ,20670,950,5740,NULL,26410,15000,15000,0,3750,17872,0,21622,3748,8538,4788,0
50221551,FA2021 ,12625,500,4580,2110,19815,5500,5500,0,2750,6500,0,9250,6625,13315,10565,0
50221551,FA2022 ,13005,515,4810,2220,20550,5000,5000,0,3250,5000,0,8250,8520,15550,12300,0
50221551,SP2021 ,12625,500,4580,2110,19815,5500,5500,0,2750,5500,0,8250,7625,14315,11565,0
50221551,SP2022 ,13005,515,4810,2220,20550,5000,5000,0,3250,5000,0,8250,8520,15550,12300,0
50118639,FA2021 ,12625,500,4650,2110,19885,8925,8027,898,0,10425,0,10425,2700,9460,9460,0
50118639,FA2022 ,13005,515,5420,1140,20080,9425,6000,3425,3750,9425,0,13175,4095,10655,6905,0
50118639,FA2023 ,13500,550,4790,1200,20040,8925,0,8925,0,8925,0,8925,5125,11115,11115,0
50118639,FA2024 ,8140,300,NULL,NULL,8440,4097,0,4097,3750,4097,0,7847,4343,4343,593,0
50118639,SP2021 ,12625,500,4650,2110,19885,8925,8028,897,0,8925,0,8925,4200,10960,10960,0
50118639,SP2022 ,13005,515,5420,1140,20080,9425,6000,3425,3750,9425,0,13175,4095,10655,6905,0
50118639,SP2023 ,13500,550,4790,NULL,18840,8925,0,8925,0,8925,0,8925,5125,9915,9915,0
50209051,FA2021 ,12625,500,4650,2110,19885,5475,5125,350,12850,6975,0,19825,6150,12910,60,0
50209051,FA2022 ,13005,515,4800,2220,20540,5475,5125,350,14750,5475,0,20225,8045,15065,315,0
50209051,SP2021 ,12625,500,4650,2110,19885,5475,5125,350,13750,5475,0,19225,7650,14410,660,0
50209051,SP2022 ,13005,515,4800,2220,20540,5475,5125,350,14750,5475,0,20225,8045,15065,315,0
50231040,FA2024 ,14750,600,5410,2450,23210,8500,8500,0,2750,8500,0,11250,6850,14710,11960,4234
50231040,SP2024 ,14750,600,5410,2450,23210,8500,8500,0,2750,8500,0,11250,6850,14710,11960,4234
50218289,FA2021 ,12625,500,4580,2110,19815,1875,0,1875,18250,3375,0,21625,9750,16440,-1810,0
50218289,FA2022 ,13005,515,NULL,NULL,13520,375,375,0,13250,375,0,13625,13145,13145,-105,0
50218289,FA2023 ,13500,550,NULL,NULL,14050,375,375,0,11250,375,0,11625,13675,13675,2425,0
50218289,SP2021 ,12625,500,4580,2110,19815,1875,0,1875,3250,1875,0,5125,11250,17940,14690,0
50218289,SP2022 ,13005,515,NULL,NULL,13520,375,375,0,3750,375,0,4125,13145,13145,9395,0
50218289,SP2023 ,13500,550,NULL,NULL,14050,375,375,0,11250,375,0,11625,13675,13675,2425,0
50230397,FA2024 ,14750,600,5410,2450,23210,9000,9000,0,2750,15198,0,17948,152,8012,5262,2024
50230397,SP2024 ,14750,600,5410,2450,23210,9000,9000,0,2750,15197,0,17947,153,8013,5263,2024
50224882,FA2022 ,13005,515,3855,2220,19595,5500,5500,0,9837,11448,0,21285,2072,8147,-1690,198
50224882,FA2023 ,13500,550,4000,2325,20375,6600,5500,1100,8471,12198,0,20669,1852,8177,-294,198
50224882,FA2024 ,14750,600,5410,2450,23210,6600,5500,1100,17324,6600,0,23924,8750,16610,-714,198
50224882,SP2022 ,13005,515,3855,2220,19595,5500,5500,0,9836,11447,0,21283,2073,8148,-1688,198
50224882,SP2023 ,13500,550,4000,2325,20375,6600,5500,1100,8471,12197,0,20668,1853,8178,-293,198
50224882,SP2024 ,14750,600,5410,2450,23210,6600,5500,1100,17324,6600,0,23924,8750,16610,-714,198
50232493,FA2024 ,14750,600,4200,2450,22000,7750,7750,0,17368,7750,0,25118,7600,14250,-3118,477
50232493,SP2024 ,14750,600,4200,2450,22000,7750,7750,0,14236,7750,0,21986,7600,14250,14,477
50226049,FA2022 ,13005,515,3855,2220,19595,9000,9000,0,NULL,9000,0,9000,4520,10595,10595,15102
50225296,FA2022 ,13005,515,4380,2220,20120,6500,6500,0,2750,6500,0,9250,7020,13620,10870,-1165
50225296,FA2023 ,13500,550,5150,2325,21525,6500,6500,0,3250,6500,0,9750,7550,15025,11775,-1165
50225296,FA2024 ,14750,600,5720,1270,22340,6500,500,6000,3750,7750,0,11500,7600,14590,10840,-1165
50225296,SP2022 ,13005,515,4380,2220,20120,6500,6500,0,0,7750,0,7750,5770,12370,12370,-1165
50225296,SP2023 ,13500,550,5150,2325,21525,6500,6500,0,3250,6500,0,9750,7550,15025,11775,-1165
50225296,SP2024 ,14750,600,5720,1270,22340,6500,500,6000,3750,7750,0,11500,7600,14590,10840,-1165
50228659,FA2023 ,13500,550,4560,2325,20935,11000,9000,2000,2750,16198,0,18948,-2148,4737,1987,2514.86
50228659,FA2024 ,14750,600,4790,2450,22590,9000,0,9000,3250,14198,0,17448,1152,8392,5142,2514.86
50228659,SP2023 ,13500,550,4560,2325,20935,9000,9000,0,2750,14197,0,16947,-147,6738,3988,2514.86
50228659,SP2024 ,14750,600,4790,1270,21410,9000,0,9000,3250,14197,0,17447,1153,7213,3963,2514.86
50204747,FA2021 ,3470,NULL,NULL,NULL,3470,0,0,0,NULL,1500,0,1500,1970,1970,1970,0
40001030,FA2021 ,12625,500,4580,2110,19815,5675,5675,0,14713,7175,0,21888,5950,12640,-2073,0
40001030,FA2022 ,13005,515,5080,1140,19740,5675,0,5675,14955,5675,0,20630,7845,14065,-890,0
40001030,SP2021 ,12625,500,4580,2110,19815,5675,5675,0,14714,5675,0,20389,7450,14140,-574,0
40001030,SP2022 ,13005,515,5080,1140,19740,5675,0,5675,14956,5675,0,20631,7845,14065,-891,0
50206735,FA2021 ,12625,500,4830,NULL,17955,5275,5275,0,11750,5275,0,17025,7850,12680,930,0
50206735,SP2021 ,5200,500,4830,NULL,10530,2173,2173,0,3750,2173,0,5923,3527,8357,4607,0
50214435,FA2021 ,12625,500,4050,2110,19285,9775,9775,0,3250,11275,0,14525,1850,8010,4760,0
50214435,FA2022 ,13005,515,4810,2220,20550,9775,9775,0,3750,9775,0,13525,3745,10775,7025,0
50214435,FA2023 ,13500,550,5440,1200,20690,9775,0,9775,3750,9775,0,13525,4275,10915,7165,0
50214435,SP2021 ,12625,500,4050,2110,19285,9775,9775,0,3250,9775,0,13025,3350,9510,6260,0
50214435,SP2022 ,13005,515,4810,2220,20550,9775,9775,0,3750,9775,0,13525,3745,10775,7025,0
50214435,SP2023 ,13500,550,5440,1200,20690,9775,0,9775,3750,9775,0,13525,4275,10915,7165,0
50229857,FA2023 ,13500,550,4560,2535,21145,7450,7450,0,10000,11148,0,21148,2902,9997,-3,113.46
50212082,FA2021 ,12625,500,3740,1080,17945,325,0,325,17250,1325,0,18575,11800,16620,-630,0
50212082,FA2022 ,13005,515,4810,2220,20550,325,325,0,20250,325,0,20575,13195,20225,-25,0
50212082,SP2021 ,12625,500,3740,1080,17945,325,0,325,17250,325,0,17575,12800,17620,370,0
50212082,SP2022 ,13005,515,4610,1140,19270,325,325,0,20250,325,0,20575,13195,18945,-1305,0
50210620,FA2021 ,12625,500,4050,1080,18255,3625,3625,0,0,5125,0,5125,8000,13130,13130,0
50210620,FA2022 ,13005,515,566,NULL,14086,2125,2125,0,NULL,2125,0,2125,11395,11961,11961,0
50210620,FA2023 ,13500,550,NULL,NULL,14050,2125,2125,0,NULL,2125,0,2125,11925,11925,11925,0
50210620,SP2021 ,12625,500,NULL,NULL,13125,2125,2125,0,0,2125,0,2125,11000,11000,11000,0
50210620,SP2022 ,13005,515,NULL,NULL,13520,2125,2125,0,NULL,2125,0,2125,11395,11395,11395,0
50210620,SP2023 ,13500,550,NULL,NULL,14050,2125,2125,0,NULL,2125,0,2125,11925,11925,11925,0
50227768,FA2023 ,13500,550,5150,2535,21735,8000,8000,0,2750,8000,0,10750,6050,13735,10985,-200
50227768,SP2023 ,13500,550,5150,2325,21525,8000,8000,0,2750,8000,0,10750,6050,13525,10775,-200
50235128,FA2024 ,14750,600,5410,2450,23210,6500,6500,0,3750,6500,0,10250,8850,16710,12960,0
50235128,SP2024 ,14750,600,5410,2450,23210,6500,6500,0,3750,6500,0,10250,8850,16710,12960,0
50211693,FA2021 ,12625,500,3740,2110,18975,5925,5925,0,NULL,5925,0,5925,7200,13050,13050,0
50211693,FA2022 ,13005,515,3855,NULL,17375,5925,5925,0,NULL,5925,0,5925,7595,11450,11450,0
50211693,SP2021 ,12625,500,3740,2110,18975,5925,5925,0,NULL,5925,0,5925,7200,13050,13050,0
50211693,SP2022 ,13005,515,3855,NULL,17375,5925,5925,0,NULL,5925,0,5925,7595,11450,11450,0
50204557,FA2021 ,12625,500,4830,NULL,17955,2675,0,2675,3750,3675,0,7425,9450,14280,10530,0
50215091,FA2021 ,12625,500,4580,2110,19815,3925,3925,0,17449,5425,0,22874,7700,14390,-3059,80
50215091,FA2022 ,13005,515,4610,1140,19270,3925,0,3925,16750,3925,0,20675,9595,15345,-1405,80
50215091,FA2023 ,13500,550,5440,NULL,19490,3925,0,3925,16250,3925,0,20175,10125,15565,-685,80
50215091,SP2021 ,12625,500,4580,2110,19815,3925,3925,0,17450,3925,0,21375,9200,15890,-1560,80
50215091,SP2022 ,13005,515,4610,1140,19270,3925,0,3925,16750,3925,0,20675,9595,15345,-1405,80
50215091,SP2023 ,7450,550,5440,NULL,13440,2166,0,2166,16250,2166,0,18416,5834,11274,-4976,80
50204471,FA2021 ,12625,500,NULL,NULL,13125,3175,3175,0,7250,5911,0,13161,7214,7214,-36,0
50204471,SP2021 ,6960,250,NULL,NULL,7210,1750,1750,0,3750,1971,0,5721,5239,5239,1489,0
50232313,FA2024 ,14750,600,4200,2450,22000,10200,10200,0,1750,14398,0,16148,952,7602,5852,1780.66
50232313,SP2024 ,14750,600,4200,2450,22000,9700,9700,0,1750,13397,0,15147,1953,8603,6853,1780.66
50215982,FA2021 ,12625,500,3740,2110,18975,5175,5175,0,NULL,5175,0,5175,7950,13800,13800,0
50230590,FA2023 ,13500,550,5150,2325,21525,5500,5500,0,2750,8073,0,10823,5977,13452,10702,3947.59
50230590,FA2024 ,14750,600,5030,1270,21650,6650,6650,0,3250,10748,0,13998,4602,10902,7652,3947.59
50230590,SP2023 ,13500,550,5150,2325,21525,5500,5500,0,2750,8072,0,10822,5978,13453,10703,3947.59
50230590,SP2024 ,14750,600,5030,1270,21650,6650,6650,0,3250,10747,0,13997,4603,10903,7653,3947.59
50228844,FA2023 ,13500,550,4000,2325,20375,9000,9000,0,2750,16500,0,19250,-2450,3875,1125,-2000
50228844,FA2024 ,14750,600,4200,2450,22000,9250,9250,0,3250,19750,0,23000,-4400,2250,-1000,-2000
50228844,SP2023 ,13500,550,4000,2325,20375,9000,9000,0,2750,11000,0,13750,3050,9375,6625,-2000
50228844,SP2024 ,14750,600,4200,2450,22000,9000,9000,0,3250,11000,0,14250,4350,11000,7750,-2000
50216942,FA2021 ,12625,500,4270,1080,18475,11675,1175,10500,3250,12175,0,15425,950,6300,3050,0
50216942,FA2022 ,13005,515,3855,2220,19595,11675,7425,4250,3750,11675,0,15425,1845,7920,4170,0
50216942,FA2023 ,13500,550,NULL,NULL,14050,9425,5925,3500,6250,12898,0,19148,1152,1152,-5098,0
50216942,SP2021 ,12625,500,4270,1080,18475,11675,1175,10500,3250,11675,0,14925,1450,6800,3550,0
50216942,SP2022 ,13005,515,3855,2220,19595,11675,7425,4250,3750,11675,0,15425,1845,7920,4170,0
50216942,SP2023 ,13500,550,NULL,NULL,14050,9425,5925,3500,6250,12897,0,19147,1153,1153,-5097,0
50209461,FA2021 ,12625,500,4580,2110,19815,4025,4025,0,9550,12023,0,21573,1102,7792,-1758,0
50209461,FA2022 ,13005,515,5420,71.25,19011.25,3525,3525,0,9615,10522,0,20137,2998,8489.25,-1125.75,0
50209461,SP2021 ,12625,500,4580,2110,19815,4025,4025,0,10005,11082,0,21087,2043,8733,-1272,0
50209461,SP2022 ,13005,515,5420,NULL,18940,3525,3525,0,8586,10523,0,19109,2997,8417,-169,0
50204845,FA2021 ,12625,500,4050,2110,19285,0,0,0,NULL,0,0,0,13125,19285,19285,0
50204845,FA2022 ,13005,515,4260,2220,20000,0,0,0,NULL,0,0,0,13520,20000,20000,0
50204845,SP2021 ,12625,500,4050,2110,19285,0,0,0,NULL,0,0,0,13125,19285,19285,0
50204845,SP2022 ,13005,515,4260,2220,20000,0,0,0,NULL,0,0,0,13520,20000,20000,0
50235256,FA2024 ,14750,600,NULL,NULL,15350,4485,4485,0,0,4485,0,4485,10865,10865,10865,0
50235256,SP2024 ,14750,600,NULL,NULL,15350,4485,4485,0,2750,4485,0,7235,10865,10865,8115,0
50207271,FA2021 ,12625,500,3740,1080,17945,5500,5500,0,13958,6500,0,20458,6625,11445,-2513,2420
50207271,FA2022 ,13005,515,3855,1140,18515,5750,5750,0,15071,5750,0,20821,7770,12765,-2306,2420
50207271,FA2023 ,3720,NULL,NULL,NULL,3720,5500,5500,0,NULL,5500,0,5500,-1780,-1780,-1780,2420
50207271,SP2021 ,12625,500,3740,1080,17945,5500,5500,0,12220,5500,0,17720,7625,12445,225,2420
50207271,SP2022 ,13005,515,3855,1140,18515,5800,5800,0,15071,5800,0,20871,7720,12715,-2356,2420
50228148,FA2023 ,13500,550,4560,2325,20935,6500,6500,0,2750,10800,0,13550,3250,10135,7385,-389
50228148,FA2024 ,14750,600,5410,2450,23210,6500,6500,0,16250,6500,0,22750,8850,16710,460,-389
50228148,SP2023 ,13500,550,4560,2325,20935,6500,6500,0,2750,6500,0,9250,7550,14435,11685,-389
50228148,SP2024 ,14750,600,5410,1270,22030,6500,6500,0,16250,6500,0,22750,8850,15530,-720,-389
50231785,FA2024 ,14750,600,4200,2450,22000,7500,7500,0,11212,12698,0,23910,2652,9302,-1910,0
50231785,SP2024 ,14750,600,4200,2450,22000,7500,7500,0,10738,12697,0,23435,2653,9303,-1435,0
50205318,FA2021 ,12625,500,4830,NULL,17955,2925,145,2780,13750,10848,0,24598,2277,7107,-6643,0
50205318,FA2022 ,3580,NULL,NULL,NULL,3580,0,0,0,12000,856,0,12856,2724,2724,-9276,0
50205318,SP2021 ,12625,500,4830,NULL,17955,2925,145,2780,13750,8847,0,22597,4278,9108,-4642,0
50204556,FA2021 ,12625,500,4270,NULL,17395,2925,2925,0,3750,4425,0,8175,8700,12970,9220,0
50204556,FA2022 ,13005,515,5420,NULL,18940,2925,2925,0,3750,2925,0,6675,10595,16015,12265,0
50204556,SP2021 ,12625,500,4270,NULL,17395,2925,2925,0,3750,2925,0,6675,10200,14470,10720,0
50216453,FA2021 ,12625,500,4050,2110,19285,6275,6275,0,7250,7775,0,15025,5350,11510,4260,0
50216453,FA2022 ,13005,515,4260,2220,20000,6275,6275,0,9550,6275,0,15825,7245,13725,4175,0
50216453,SP2021 ,12625,500,4050,2110,19285,6275,6275,0,13160,6275,0,19435,6850,13010,-150,0
50216453,SP2022 ,13005,515,4260,2220,20000,6275,6275,0,13576,6275,0,19851,7245,13725,149,0
50122560,FA2023 ,13500,550,4000,2325,20375,10000,8000,2000,2750,13250,0,16000,800,7125,4375,0
50122560,FA2024 ,14750,600,4200,2450,22000,10000,8000,2000,0,13250,0,13250,2100,8750,8750,0
50122560,SP2023 ,13500,550,4000,2325,20375,8000,8000,0,2750,11250,0,14000,2800,9125,6375,0
50122560,SP2024 ,14750,600,4200,2450,22000,8000,8000,0,0,11250,0,11250,4100,10750,10750,0
50203394,FA2021 ,12625,500,3740,1080,17945,3175,100,3075,3750,4675,0,8425,8450,13270,9520,0
50203394,SP2021 ,12625,500,3740,1080,17945,3175,100,3075,9930,3175,0,13105,9950,14770,4840,0
50226180,FA2022 ,13005,515,3855,2220,19595,7800,7800,0,2750,7800,0,10550,5720,11795,9045,3670.4
50226180,FA2023 ,13500,550,4000,2325,20375,7800,7800,0,8650,11800,0,20450,2250,8575,-75,3670.4
50226180,FA2024 ,14750,7250,7250,NULL,22000,7800,6000,1800,3750,7800,0,11550,14200,14200,10450,3670.4
50226180,SP2022 ,13005,515,3855,2220,19595,7800,7800,0,14637,7800,0,22437,5720,11795,-2842,3670.4
50226180,SP2023 ,13500,550,4000,2325,20375,7800,7800,0,8650,11800,0,20450,2250,8575,-75,3670.4
50226180,SP2024 ,14750,600,4200,2450,22000,7800,6000,1800,3750,7800,0,11550,7550,14200,10450,3670.4
50222117,FA2021 ,12625,500,4050,2110,19285,7000,6000,1000,2750,8500,0,11250,4625,10785,8035,225
50222117,FA2022 ,13005,515,4260,2220,20000,8000,5500,2500,NULL,12260,0,12260,1260,7740,7740,225
50222117,FA2023 ,13500,550,5800,1200,21050,8000,5500,2500,NULL,10000,0,10000,4050,11050,11050,225
50222117,FA2024 ,14750,600,6090,NULL,21440,5500,5500,0,NULL,9600,0,9600,5750,11840,11840,225
50222117,SP2021 ,12625,500,4050,2110,19285,6000,6000,0,2750,6000,0,8750,7125,13285,10535,225
50222117,SP2022 ,13005,515,4260,2220,20000,5500,5500,0,NULL,9760,0,9760,3760,10240,10240,225
50222117,SP2023 ,13500,550,5800,1200,21050,5500,5500,0,NULL,7500,0,7500,6550,13550,13550,225
50222117,SP2024 ,14750,600,6090,1270,22710,5500,5500,0,NULL,7600,0,7600,7750,15110,15110,225
50227909,FA2023 ,13500,550,4000,2325,20375,9500,0,9500,2750,9500,0,12250,4550,10875,8125,3536
50227909,FA2024 ,14750,600,4200,2450,22000,9500,0,9500,2250,9500,0,11750,5850,12500,10250,3536
50227909,SP2023 ,13500,550,4000,2325,20375,9500,0,9500,2750,9500,0,12250,4550,10875,8125,3536
50227909,SP2024 ,14750,600,4200,2450,22000,9500,0,9500,2250,9500,0,11750,5850,12500,10250,3536
50216302,FA2021 ,12625,500,4580,2110,19815,9275,9275,0,9817,12548,0,22365,577,7267,-2550,0
50216302,FA2022 ,13005,515,4810,2220,20550,8775,8775,0,10123,11298,0,21421,2222,9252,-871,0
50216302,FA2023 ,13500,550,4790,1200,20040,9275,0,9275,11250,10348,0,21598,3702,9692,-1558,0
50216302,SP2021 ,12625,500,4580,2110,19815,9275,9275,0,9818,10547,0,20365,2578,9268,-550,0
50216302,SP2022 ,13005,515,4810,2220,20550,8775,8775,0,10124,11297,0,21421,2223,9253,-871,0
50216302,SP2023 ,13500,550,4790,1200,20040,9275,0,9275,11250,10347,0,21597,3703,9693,-1557,0
50225986,FA2022 ,13005,515,4810,2220,20550,8200,8200,0,2750,8200,0,10950,5320,12350,9600,0
50225986,FA2023 ,13500,550,4560,1200,19810,12000,12000,0,2750,12000,0,14750,2050,7810,5060,0
50225986,FA2024 ,14750,600,4200,2450,22000,6000,6000,0,NULL,6000,0,6000,9350,16000,16000,0
50225986,SP2023 ,13500,550,4560,1200,19810,8000,8000,0,0,8000,0,8000,6050,11810,11810,0
50225986,SP2024 ,14750,600,4200,1270,20820,6000,6000,0,NULL,6000,0,6000,9350,14820,14820,0
50217453,FA2021 ,12625,500,NULL,NULL,13125,1825,1825,0,16674,3325,0,19999,9800,9800,-6874,0
50222464,FA2021 ,12625,500,4580,2550,20255,4500,4500,0,14250,5500,0,19750,7625,14755,505,0
50222464,FA2022 ,13005,515,NULL,NULL,13520,2760,2760,0,10250,2760,0,13010,10760,10760,510,0
50222464,SP2021 ,12625,500,4580,2550,20255,4500,4500,0,14250,4500,0,18750,8625,15755,1505,0
50222464,SP2022 ,13005,515,NULL,NULL,13520,2760,2760,0,10250,2760,0,13010,10760,10760,510,0
50204900,FA2021 ,19340,860,860,NULL,20200,5750,5750,0,14750,6750,0,21500,13450,13450,-1300,0
50204900,SP2021 ,20570,860,860,NULL,21430,5750,5750,0,13650,5750,0,19400,15680,15680,2030,0
50223292,FA2021 ,12625,500,3740,2110,18975,6000,6000,0,NULL,6500,0,6500,6625,12475,12475,0
50223292,FA2022 ,13005,515,NULL,1140,14660,3795,3795,0,NULL,3795,0,3795,9725,10865,10865,0
50223292,FA2023 ,13500,550,NULL,1200,15250,3795,3795,0,NULL,3795,0,3795,10255,11455,11455,0
50223292,SP2021 ,12625,500,3740,2110,18975,6000,6000,0,NULL,6000,0,6000,7125,12975,12975,0
50223292,SP2022 ,13005,515,NULL,1140,14660,3795,3795,0,NULL,3795,0,3795,9725,10865,10865,0
50223292,SP2023 ,13500,550,NULL,NULL,14050,3795,3795,0,NULL,3795,0,3795,10255,10255,10255,0
50232090,FA2024 ,14750,600,5410,2450,23210,7000,7000,0,13484,12070,0,25554,3280,11140,-2344,-6860
50232090,SP2024 ,14750,600,5410,2450,23210,7000,7000,0,12316,12650,0,24966,2700,10560,-1756,-6860
50205432,FA2021 ,12625,500,3740,2110,18975,2025,0,2025,17794,3525,0,21319,9600,15450,-2344,0
50205432,FA2022 ,13005,515,5420,41.85,18981.85,2025,0,2025,31655,3898,0,35553,9622,15083.85,-16571.15,0
50205432,SP2021 ,12625,500,3740,2110,18975,2025,0,2025,17794,2025,0,19819,11100,16950,-844,0
50205432,SP2022 ,13005,515,5420,NULL,18940,2025,0,2025,18725,3897,0,22622,9623,15043,-3682,0
50226960,FA2022 ,13005,515,4810,2690,21020,13000,8000,5000,NULL,13000,0,13000,520,8020,8020,0
50226960,FA2023 ,13500,550,4000,2535,20585,13000,1000,12000,NULL,13000,0,13000,1050,7585,7585,0
50226960,FA2024 ,14750,600,5030,1270,21650,13000,1000,12000,NULL,13000,0,13000,2350,8650,8650,0
50226960,SP2022 ,13005,515,4810,2690,21020,13000,8000,5000,NULL,13000,0,13000,520,8020,8020,0
50226960,SP2023 ,13500,550,4000,2535,20585,13000,1000,12000,NULL,13000,0,13000,1050,7585,7585,0
50226960,SP2024 ,14750,600,5030,NULL,20380,13000,1000,12000,NULL,13000,0,13000,2350,7380,7380,0
50205178,FA2021 ,12625,500,3740,2110,18975,1925,1925,0,6250,6848,0,13098,6277,12127,5877,0
50205178,SP2021 ,12625,500,3740,2110,18975,1925,1925,0,6250,4847,0,11097,8278,14128,7878,0
50222458,FA2021 ,12625,500,3740,2110,18975,8000,8000,0,2750,9000,0,11750,4125,9975,7225,1856
50222458,FA2022 ,13005,515,3855,2220,19595,6750,6750,0,3250,10322,0,13572,3198,9273,6023,1856
50222458,FA2023 ,13500,550,4000,2325,20375,6750,5750,1000,3750,10872,0,14622,3178,9503,5753,1856
50222458,FA2024 ,14750,600,5030,0,20380,7250,5750,1500,3750,11348,0,15098,4002,9032,5282,1856
50222458,SP2021 ,12625,500,3740,2110,18975,7500,7500,0,2750,7500,0,10250,5625,11475,8725,1856
50222458,SP2022 ,13005,515,3855,2220,19595,6750,6750,0,3250,10323,0,13573,3197,9272,6022,1856
50222458,SP2023 ,13500,550,4000,2325,20375,6750,5750,1000,3750,10873,0,14623,3177,9502,5752,1856
50222458,SP2024 ,14750,600,5030,NULL,20380,7250,5750,1500,3750,11347,0,15097,4003,9033,5283,1856
50199603,FA2021 ,12625,500,NULL,NULL,13125,0,0,0,3750,1000,0,4750,12125,12125,8375,780
50199603,SP2021 ,12625,500,NULL,NULL,13125,0,0,0,3750,0,0,3750,13125,13125,9375,780
50221345,FA2021 ,12625,500,4580,2110,19815,7500,7500,0,2750,7500,0,10250,5625,12315,9565,0
50221345,FA2022 ,13005,515,4260,2220,20000,7000,7000,0,3250,7000,0,10250,6520,13000,9750,0
50221345,FA2023 ,15240,550,4560,2325,22675,8250,7250,1000,3750,8250,0,12000,7540,14425,10675,0
50221345,FA2024 ,14750,600,5720,1270,22340,7000,7000,0,3750,7000,0,10750,8350,15340,11590,0
50221345,SP2021 ,12625,500,4580,2110,19815,7500,7500,0,2750,7500,0,10250,5625,12315,9565,0
50221345,SP2022 ,13005,515,4260,2220,20000,7000,7000,0,3250,7000,0,10250,6520,13000,9750,0
50221345,SP2023 ,13500,6825,6825,NULL,20325,8000,7000,1000,3750,8000,0,11750,12325,12325,8575,0
50221345,SP2024 ,14750,600,5720,NULL,21070,7000,7000,0,3750,7000,0,10750,8350,14070,10320,0
50231865,FA2024 ,14750,600,4200,2450,22000,9000,9000,0,0,9000,0,9000,6350,13000,13000,-5250
50231865,SP2024 ,14750,600,4200,2450,22000,9000,9000,0,0,9000,0,9000,6350,13000,13000,-5250
50235006,FA2024 ,14750,600,5240,2450,23040,12327,12327,0,10985,14727,0,25712,623,8313,-2672,0
50232240,FA2024 ,14750,600,5410,2450,23210,9000,9000,0,NULL,9000,0,9000,6350,14210,14210,4913.66
50232240,SP2024 ,14750,600,5410,2450,23210,9000,9000,0,NULL,9000,0,9000,6350,14210,14210,4913.66
50221715,FA2021 ,12625,500,4580,2110,19815,7900,5900,2000,9860,13898,0,23758,-773,5917,-3943,0
50209180,FA2021 ,12625,500,NULL,NULL,13125,5800,5800,0,3250,6800,0,10050,6325,6325,3075,0
50209180,FA2022 ,13005,515,NULL,NULL,13520,6550,5800,750,3750,6550,0,10300,6970,6970,3220,0
50209180,SP2021 ,12625,500,NULL,NULL,13125,5800,5800,0,3250,5800,0,9050,7325,7325,4075,0
50209180,SP2022 ,13005,515,NULL,NULL,13520,6550,5800,750,3750,6550,0,10300,6970,6970,3220,0
50225567,FA2022 ,13005,515,3855,2220,19595,7950,7950,0,2750,7950,0,10700,5570,11645,8895,0
50225567,SP2022 ,7170,515,3855,2220,13760,4384,4384,0,2750,4384,0,7134,3301,9376,6626,0
50202877,FA2021 ,12625,500,4270,1080,18475,3425,3425,0,3750,4425,0,8175,8700,14050,10300,0
50202877,SP2021 ,12625,500,4270,NULL,17395,3425,3425,0,3750,3425,0,7175,9700,13970,10220,0
50225625,FA2023 ,13500,550,4000,2325,20375,9900,9900,0,5356,9900,0,15256,4150,10475,5119,0
50225625,FA2024 ,14750,600,4200,2450,22000,11400,8500,2900,3250,11770,0,15020,3580,10230,6980,0
50225625,SP2023 ,13500,550,4000,2325,20375,9900,9900,0,5355,9900,0,15255,4150,10475,5120,0
50225625,SP2024 ,14750,600,4200,2450,22000,11400,8500,2900,3250,11770,0,15020,3580,10230,6980,0
50232701,FA2024 ,14750,600,4790,2450,22590,9000,0,9000,2750,9000,0,11750,6350,13590,10840,5639.5
50232701,SP2024 ,14750,600,4790,2450,22590,9000,0,9000,2750,9000,0,11750,6350,13590,10840,5639.5
50212540,FA2021 ,12625,500,3740,2110,18975,6000,6000,0,3750,7000,0,10750,6125,11975,8225,0
50212540,FA2022 ,13005,515,3855,1140,18515,6000,6000,0,12000,6000,0,18000,7520,12515,515,0
50212540,SP2021 ,12625,500,3740,2110,18975,6000,6000,0,3750,6000,0,9750,7125,12975,9225,0
50212540,SP2022 ,13005,515,3855,1140,18515,6000,6000,0,12000,6000,0,18000,7520,12515,515,0
50230348,FA2024 ,14750,600,4200,2450,22000,6500,500,6000,NULL,6500,0,6500,8850,15500,15500,10
50230348,SP2024 ,14750,600,4200,2450,22000,6500,500,6000,NULL,6500,0,6500,8850,15500,15500,10
50204223,FA2021 ,6960,500,5160,1080,13700,1557,0,1557,12327,5295,0,17622,2165,8405,-3922,0
50204223,SP2021 ,6960,500,5160,1080,13700,1557,0,1557,12328,3295,0,15623,4165,10405,-1923,0
50225658,FA2022 ,13005,515,4800,2220,20540,7100,7100,0,2750,7100,0,9850,6420,13440,10690,0
50225658,FA2023 ,13500,550,4000,2325,20375,7100,7100,0,3250,7100,0,10350,6950,13275,10025,0
50225658,FA2024 ,14750,600,4200,2450,22000,7100,6250,850,3750,7100,0,10850,8250,14900,11150,0
50225658,SP2022 ,13005,515,4800,2220,20540,7100,7100,0,2750,7100,0,9850,6420,13440,10690,0
50225658,SP2023 ,13500,550,4000,2325,20375,7100,7100,0,3250,7100,0,10350,6950,13275,10025,0
50225658,SP2024 ,14750,7250,7250,NULL,22000,7100,6250,850,3750,7100,0,10850,14900,14900,11150,0
50226967,FA2022 ,13005,515,3855,2220,19595,5650,5650,0,2750,5650,0,8400,7870,13945,11195,0
50226967,SP2022 ,13005,515,3855,2220,19595,5650,5650,0,2750,5650,0,8400,7870,13945,11195,0
50226967,SP2023 ,13500,550,NULL,NULL,14050,2748,2748,0,13250,4498,0,17748,9552,9552,-3698,0
50232609,FA2024 ,14750,600,4790,2450,22590,11000,9000,2000,2750,11000,0,13750,4350,11590,8840,0
50232609,SP2024 ,14750,600,4790,2450,22590,9000,9000,0,2750,11000,0,13750,4350,11590,8840,0
50222014,FA2021 ,12625,500,4050,2110,19285,5500,5500,0,2750,6800,0,9550,6325,12485,9735,5018
50222014,FA2022 ,13005,515,4810,2220,20550,5000,5000,0,3250,5000,0,8250,8520,15550,12300,5018
50222014,FA2023 ,13500,550,5150,2325,21525,5000,5000,0,3750,5000,0,8750,9050,16525,12775,5018
50222014,FA2024 ,14750,600,4790,2450,22590,5000,5000,0,3750,5000,0,8750,10350,17590,13840,5018
50222014,SP2021 ,12625,500,4050,2110,19285,5500,5500,0,2750,5500,0,8250,7625,13785,11035,5018
50222014,SP2022 ,13005,515,4810,2220,20550,5000,5000,0,3250,5000,0,8250,8520,15550,12300,5018
50222014,SP2023 ,13500,550,5150,2325,21525,5000,5000,0,3750,5000,0,8750,9050,16525,12775,5018
50222014,SP2024 ,14750,600,4790,2450,22590,5000,5000,0,3750,5000,0,8750,10350,17590,13840,5018
50232241,FA2024 ,14750,600,4200,2450,22000,11900,10900,1000,1000,16398,0,17398,-1048,5602,4602,-77.49
50232241,SP2024 ,14750,600,4200,2450,22000,10900,10900,0,2750,15897,0,18647,-547,6103,3353,-77.49
50205142,FA2021 ,12625,500,4270,1080,18475,0,0,0,20690,1500,0,22190,11625,16975,-3715,0
50205142,SP2021 ,12625,500,4270,1080,18475,0,0,0,20690,0,0,20690,13125,18475,-2215,0
50220795,FA2021 ,12625,500,4050,2110,19285,7500,7500,0,2750,8500,0,11250,4625,10785,8035,0
50220795,FA2022 ,13005,515,4260,2220,20000,6750,6750,0,3250,6750,0,10000,6770,13250,10000,0
50220795,FA2023 ,13500,550,5150,2325,21525,7750,7750,0,3750,7750,0,11500,6300,13775,10025,0
50220795,FA2024 ,14750,600,5720,1270,22340,6500,6500,0,3750,12000,0,15750,3350,10340,6590,0
50220795,SP2021 ,12625,500,4050,2110,19285,7500,7500,0,2750,7500,0,10250,5625,11785,9035,0
50220795,SP2022 ,13005,515,4260,2220,20000,6750,6750,0,3250,6750,0,10000,6770,13250,10000,0
50220795,SP2023 ,13500,6825,6825,NULL,20325,7750,7750,0,3750,7750,0,11500,12575,12575,8825,0
50220795,SP2024 ,14750,600,5720,1270,22340,6500,6500,0,3750,12000,0,15750,3350,10340,6590,0
50228629,FA2023 ,13500,550,5150,2325,21525,5500,5500,0,NULL,5500,0,5500,8550,16025,16025,8929.33
50228629,FA2024 ,14750,600,5410,2450,23210,5500,5500,0,NULL,5500,0,5500,9850,17710,17710,8929.33
50228629,SP2023 ,13500,550,5150,2325,21525,5500,5500,0,NULL,5500,0,5500,8550,16025,16025,8929.33
50228629,SP2024 ,14750,600,5410,2450,23210,5500,5500,0,NULL,5500,0,5500,9850,17710,17710,8929.33
50230575,FA2024 ,14750,600,5410,2450,23210,9000,9000,0,2750,9000,0,11750,6350,14210,11460,3879
50230575,SP2024 ,14750,600,5410,2450,23210,9250,9250,0,2750,9250,0,12000,6100,13960,11210,3879
50070931,FA2021 ,12625,500,4580,2550,20255,6250,6250,0,NULL,7250,0,7250,5875,13005,13005,0
50070931,SP2021 ,12625,500,4580,2550,20255,6250,6250,0,NULL,7250,0,7250,5875,13005,13005,0
50218108,FA2021 ,12625,500,4050,2110,19285,1700,0,1700,0,17698,12625,17698,-4573,1587,1587,0
50218108,SP2021 ,12625,500,4050,2110,19285,0,0,0,0,15497,12625,15497,-2372,3788,3788,0
50221702,FA2021 ,12625,500,4580,2110,19815,5000,5000,0,0,5500,0,5500,7625,14315,14315,0
50229587,FA2023 ,13500,550,4000,2325,20375,10350,10350,0,2750,10350,0,13100,3700,10025,7275,2100
50229587,FA2024 ,14750,600,5030,2450,22830,10350,9000,1350,3250,12183,0,15433,3167,10647,7397,2100
50229587,SP2023 ,13500,550,4000,2325,20375,10350,10350,0,2750,11350,0,14100,2700,9025,6275,2100
50229587,SP2024 ,14750,600,5030,1270,21650,10350,9000,1350,3250,11182,0,14432,4168,10468,7218,2100
50203713,FA2021 ,12625,500,4830,1080,19035,7425,2425,5000,NULL,7425,0,7425,5700,11610,11610,0
50203713,SP2021 ,12625,500,4830,1080,19035,7425,2425,5000,NULL,7425,0,7425,5700,11610,11610,0
50232866,FA2024 ,14750,600,4200,2900,22450,6500,6500,0,18750,6500,0,25250,8850,15950,-2800,-2715
50232866,SP2024 ,14750,600,4200,2900,22450,6500,6500,0,17750,6500,0,24250,8850,15950,-1800,-2715
50227107,FA2022 ,12457,4343,4343,NULL,16800,0,0,0,NULL,0,0,0,16800,16800,16800,0
50207048,FA2021 ,12625,500,4270,1080,18475,510,510,0,3750,3380,0,7130,9745,15095,11345,0
50207048,SP2021 ,12625,500,4270,NULL,17395,925,925,0,3750,2795,0,6545,10330,14600,10850,0
50232083,SP2023 ,14500,7000,7000,NULL,21500,0,0,0,NULL,0,0,0,21500,21500,21500,0
50209470,FA2021 ,12625,500,4270,2110,19505,7732,4932,2800,0,23355,0,23355,-10230,-3850,-3850,0
50209470,FA2022 ,13005,515,5420,1140,20080,12800,7250,5550,2500,22800,0,25300,-9280,-2720,-5220,0
50209470,SP2021 ,12625,500,4270,1080,18475,12368,4568,7800,0,15990,0,15990,-2865,2485,2485,0
50209470,SP2022 ,13005,515,5420,1140,20080,12800,7250,5550,3750,12800,0,16550,720,7280,3530,0
50228518,FA2023 ,13500,550,4000,2325,20375,6500,6500,0,2750,6500,0,9250,7550,13875,11125,-75
50228518,FA2024 ,14750,600,4200,2450,22000,6500,6500,0,2750,10315,0,13065,5035,11685,8935,-75
50228518,SP2023 ,13500,550,4000,2325,20375,6500,6500,0,2750,6500,0,9250,7550,13875,11125,-75
50215273,FA2021 ,12625,500,3740,2110,18975,8750,8750,0,0,9250,0,9250,3875,9725,9725,0
50215273,SP2021 ,12625,500,3740,2110,18975,8750,8750,0,2750,8750,0,11500,4375,10225,7475,0
50216261,FA2021 ,12625,500,4050,2110,19285,4925,2925,2000,3250,5925,0,9175,7200,13360,10110,0
50216261,FA2022 ,13005,515,5080,1140,19740,2925,2925,0,3750,2925,0,6675,10595,16815,13065,0
50216261,FA2023 ,13500,550,5440,NULL,19490,2925,2925,0,NULL,2925,0,2925,11125,16565,16565,0
50216261,SP2021 ,12625,500,4050,2110,19285,2925,2925,0,3250,2925,0,6175,10200,16360,13110,0
50216261,SP2022 ,13005,515,5080,1140,19740,2925,2925,0,3750,2925,0,6675,10595,16815,13065,0
50216261,SP2023 ,13500,550,5440,NULL,19490,2925,2925,0,NULL,2925,0,2925,11125,16565,16565,0
50225370,FA2022 ,13005,515,3855,2220,19595,7550,7550,0,2750,9050,0,11800,4470,10545,7795,-2050
50225370,FA2023 ,13500,550,4000,2325,20375,7250,7250,0,3250,7250,0,10500,6800,13125,9875,-2050
50225370,FA2024 ,14750,600,5410,2450,23210,7000,7000,0,3750,12410,0,16160,2940,10800,7050,-2050
50225370,SP2022 ,13005,515,3855,2220,19595,7000,7000,0,2750,7000,0,9750,6520,12595,9845,-2050
50225370,SP2023 ,13500,550,4000,2325,20375,7000,7000,0,3250,7000,0,10250,7050,13375,10125,-2050
50225370,SP2024 ,14750,600,5410,2450,23210,7000,7000,0,3750,12410,0,16160,2940,10800,7050,-2050
50205404,FA2021 ,12625,500,NULL,2110,15235,0,0,0,9550,7873,0,17423,5252,7362,-2188,0
50205404,FA2022 ,13005,515,NULL,2220,15740,0,0,0,11000,4673,0,15673,8847,11067,67,0
50205404,SP2021 ,12625,500,NULL,2110,15235,0,0,0,7750,5872,0,13622,7253,9363,1613,0
50216648,FA2021 ,12625,500,3740,2110,18975,4675,4675,0,3250,6175,0,9425,6950,12800,9550,1420
50216648,FA2022 ,13005,515,5420,1140,20080,4675,4675,0,3750,4675,0,8425,8845,15405,11655,1420
50216648,FA2023 ,13500,550,5440,NULL,19490,4675,0,4675,3750,4675,0,8425,9375,14815,11065,1420
50216648,SP2021 ,12625,500,3740,2550,19415,4675,4675,0,3250,4675,0,7925,8450,14740,11490,1420
50216648,SP2022 ,13005,515,5420,NULL,18940,4675,4675,0,3750,4675,0,8425,8845,14265,10515,1420
50216648,SP2023 ,7450,550,5440,NULL,13440,2580,0,2580,3750,2580,0,6330,5420,10860,7110,1420
50205643,FA2021 ,12625,500,4270,1080,18475,4125,4125,0,9755,5625,0,15380,7500,12850,3095,0
50205643,SP2021 ,12625,500,4270,1080,18475,4125,4125,0,12181,4125,0,16306,9000,14350,2169,0
50230009,FA2023 ,13500,550,4000,2325,20375,5500,5500,0,2750,5500,0,8250,8550,14875,12125,0
50230009,FA2024 ,14750,600,4200,2450,22000,5500,5500,0,3250,9198,0,12448,6152,12802,9552,0
50230009,SP2023 ,13500,550,4000,2325,20375,5500,5500,0,2750,5500,0,8250,8550,14875,12125,0
50230009,SP2024 ,14750,600,4200,2450,22000,5500,5500,0,3250,9197,0,12447,6153,12803,9553,0
50232092,FA2024 ,14750,600,5410,2900,23660,8500,8500,0,15280,11000,0,26280,4350,12660,-2620,-250
50232092,SP2024 ,14750,600,5410,2450,23210,8750,8750,0,15280,8750,0,24030,6600,14460,-820,-250
50209514,FA2021 ,12625,500,3740,1080,17945,6000,6000,0,3750,7000,0,10750,6125,10945,7195,0
50209514,FA2022 ,13005,515,4610,NULL,18130,6000,6000,0,3750,6000,0,9750,7520,12130,8380,0
50209514,SP2021 ,12625,500,3740,NULL,16865,6000,6000,0,3750,6000,0,9750,7125,10865,7115,0
50209514,SP2022 ,13005,515,4610,NULL,18130,6000,6000,0,3750,6000,0,9750,7520,12130,8380,0
50225321,FA2022 ,13005,515,4810,2220,20550,5500,5500,0,0,5500,0,5500,8020,15050,15050,0
50233824,FA2024 ,14750,600,5410,2450,23210,9000,9000,0,2750,12698,0,15448,2652,10512,7762,2995.32
50233824,SP2024 ,14750,600,5410,2450,23210,9000,9000,0,2750,12697,0,15447,2653,10513,7763,2995.32
50228257,FA2023 ,13500,550,4000,2325,20375,9000,9000,0,NULL,9000,0,9000,5050,11375,11375,25
50228257,FA2024 ,14750,600,4200,2450,22000,9000,9000,0,NULL,9000,0,9000,6350,13000,13000,25
50228257,SP2023 ,13500,550,4000,2325,20375,9000,9000,0,NULL,9000,0,9000,5050,11375,11375,25
50228257,SP2024 ,14750,600,4200,2450,22000,9000,9000,0,NULL,9000,0,9000,6350,13000,13000,25
50229964,FA2023 ,13500,550,4000,2325,20375,7000,7000,0,NULL,7000,0,7000,7050,13375,13375,-5
50229964,FA2024 ,14750,600,5030,1270,21650,7000,7000,0,NULL,7000,0,7000,8350,14650,14650,-5
50229964,SP2023 ,13500,550,4000,2325,20375,7000,7000,0,NULL,7000,0,7000,7050,13375,13375,-5
50229964,SP2024 ,14750,600,5030,1270,21650,7000,7000,0,NULL,7000,0,7000,8350,14650,14650,-5
50228519,FA2023 ,13500,550,4560,2325,20935,7000,7000,0,2750,7000,0,9750,7050,13935,11185,0
50228519,FA2024 ,14750,600,5410,2450,23210,7000,7000,0,16750,7000,0,23750,8350,16210,-540,0
50228519,SP2023 ,13500,550,4560,2325,20935,7000,7000,0,2750,7000,0,9750,7050,13935,11185,0
50228519,SP2024 ,14750,600,5410,2450,23210,7000,7000,0,16750,7000,0,23750,8350,16210,-540,0
50119048,FA2021 ,12625,500,3740,2110,18975,4425,4425,0,NULL,4425,0,4425,8700,14550,14550,0
50119048,FA2022 ,13005,515,5080,1140,19740,4425,4425,0,NULL,4425,0,4425,9095,15315,15315,0
50119048,FA2023 ,13500,550,5440,1200,20690,4425,4425,0,NULL,4425,0,4425,9625,16265,16265,0
50119048,SP2021 ,12625,500,3740,2110,18975,4425,4425,0,NULL,4425,0,4425,8700,14550,14550,0
50119048,SP2022 ,13005,515,5080,1140,19740,4425,4425,0,NULL,4425,0,4425,9095,15315,15315,0
50119048,SP2023 ,13500,550,5440,1200,20690,4425,4425,0,NULL,4425,0,4425,9625,16265,16265,0
50234386,FA2024 ,14750,600,5410,2450,23210,7400,7400,0,2750,12598,0,15348,2752,10612,7862,0
50234386,SP2024 ,14750,600,5410,2450,23210,7400,7400,0,2750,12597,0,15347,2753,10613,7863,0
50206719,FA2021 ,12625,500,NULL,NULL,13125,925,925,0,3750,2425,0,6175,10700,10700,6950,0
50206719,SP2021 ,12625,500,NULL,NULL,13125,925,925,0,3750,925,0,4675,12200,12200,8450,0
50204570,FA2021 ,12625,500,3740,1080,17945,8175,7175,1000,9726,9675,0,19401,3450,8270,-1456,0
50204570,SP2021 ,12625,6350,6350,NULL,18975,3925,2925,1000,16750,3925,0,20675,15050,15050,-1700,0
50216298,SP2022 ,11150,5650,5650,NULL,16800,0,0,0,NULL,0,0,0,16800,16800,16800,0
50216455,FA2021 ,12625,500,3740,2110,18975,7925,7925,0,3250,9425,0,12675,3700,9550,6300,0
50216455,FA2022 ,13005,515,3855,1140,18515,7925,7925,0,3750,7925,0,11675,5595,10590,6840,0
50216455,FA2023 ,13500,550,4790,1200,20040,8425,500,7925,3750,8425,0,12175,5625,11615,7865,0
50216455,SP2021 ,12625,500,3740,2110,18975,7925,7925,0,3250,7925,0,11175,5200,11050,7800,0
50216455,SP2022 ,13005,515,3855,1140,18515,7925,7925,0,3750,7925,0,11675,5595,10590,6840,0
50216455,SP2023 ,13500,550,4790,1200,20040,10425,500,9925,3750,10425,0,14175,3625,9615,5865,0
50216693,FA2021 ,12625,500,4050,1080,18255,8025,7650,375,2750,13798,0,16548,-673,4457,1707,0
50216693,FA2022 ,13005,515,4260,1140,18920,7525,7150,375,3750,11448,0,15198,2072,7472,3722,0
50216693,FA2023 ,13500,550,4790,1200,20040,10025,7650,2375,3750,13198,0,16948,852,6842,3092,0
50216693,SP2021 ,12625,500,NULL,NULL,13125,6525,6150,375,2750,10297,0,13047,2828,2828,78,0
50216693,SP2022 ,13005,515,4260,1140,18920,9525,7150,2375,3750,13447,0,17197,73,5473,1723,0
50216693,SP2023 ,13500,550,NULL,1200,15250,6525,6150,375,3750,9697,0,13447,4353,5553,1803,0
50217323,FA2021 ,12625,500,3740,2110,18975,6475,6475,0,11288,7975,0,19263,5150,11000,-288,0
50220519,FA2023 ,13500,550,4000,2325,20375,6500,6500,0,0,13198,0,13198,852,7177,7177,547
50220519,FA2024 ,14750,600,4200,2450,22000,8500,7500,1000,3750,14198,0,17948,1152,7802,4052,547
50220519,SP2023 ,13500,550,4000,2325,20375,6500,6500,0,0,13197,0,13197,853,7178,7178,547
50220519,SP2024 ,14750,600,4200,2450,22000,8500,7500,1000,3750,14197,0,17947,1153,7803,4053,547
50228712,SP2022 ,11150,5650,5650,NULL,16800,0,0,0,NULL,0,0,0,16800,16800,16800,0
50230288,FA2023 ,13500,550,5150,2325,21525,6500,6500,0,3250,6500,0,9750,7550,15025,11775,4503.32
50230288,FA2024 ,14750,600,5410,2450,23210,6500,6500,0,3750,6500,0,10250,8850,16710,12960,4503.32
50230288,SP2023 ,13500,550,5150,2325,21525,6500,6500,0,3250,6500,0,9750,7550,15025,11775,4503.32
50230288,SP2024 ,14750,600,5410,2450,23210,6500,6500,0,3750,6500,0,10250,8850,16710,12960,4503.32
50232217,FA2024 ,14750,600,4790,2450,22590,11100,11100,0,11743,11893,0,23636,3457,10697,-1046,-92
50232217,SP2024 ,14750,600,4790,2450,22590,11100,11100,0,11743,11892,0,23635,3458,10698,-1045,-92
50234220,FA2024 ,14750,600,4200,2450,22000,5000,5000,0,2750,5000,0,7750,10350,17000,14250,8695
50234220,SP2024 ,14750,600,4200,2450,22000,5000,5000,0,2750,5000,0,7750,10350,17000,14250,8695
50235926,SP2024 ,15000,7500,7500,NULL,22500,0,0,0,NULL,0,0,0,22500,22500,22500,0
50228030,SP2022 ,13005,515,4810,2220,20550,5500,5500,0,2750,10273,0,13023,3247,10277,7527,0
50204127,FA2021 ,12625,500,3740,2110,18975,2425,2275,150,3750,3925,0,7675,9200,15050,11300,0
50204127,SP2021 ,12625,500,3740,2110,18975,2425,2275,150,3750,2425,0,6175,10700,16550,12800,0
50223805,FA2022 ,13005,515,4810,2220,20550,7000,7000,0,NULL,7000,0,7000,6520,13550,13550,0
50223805,FA2023 ,13500,550,5150,2745,21945,6500,6500,0,NULL,6500,0,6500,7550,15445,15445,0
50223805,FA2024 ,14750,600,5410,2450,23210,6500,6500,0,NULL,6500,0,6500,8850,16710,16710,0
50223805,SP2022 ,13005,515,4810,2220,20550,7000,7000,0,NULL,7000,0,7000,6520,13550,13550,0
50223805,SP2023 ,13500,550,5150,2745,21945,6500,6500,0,NULL,6500,0,6500,7550,15445,15445,0
50223805,SP2024 ,14750,600,5410,2450,23210,6500,6500,0,NULL,6500,0,6500,8850,16710,16710,0
50204354,FA2021 ,12625,6350,6350,NULL,18975,1838,1838,0,3750,3338,0,7088,15637,15637,11887,0
50204354,SP2021 ,3470,0,NULL,NULL,3470,0,0,0,3750,0,0,3750,3470,3470,-280,0
50231450,FA2024 ,14750,600,5410,2900,23660,9000,9000,0,2750,9000,0,11750,6350,14660,11910,14602
50231450,SP2024 ,14750,600,5410,2900,23660,9000,9000,0,2750,9000,0,11750,6350,14660,11910,14602
50204598,FA2021 ,12625,500,4830,NULL,17955,1425,0,1425,3750,6063,0,9813,7062,11892,8142,0
50226800,FA2024 ,14750,600,4200,2450,22000,10310,9150,1160,0,14065,0,14065,1285,7935,7935,8233.33
50226800,SP2024 ,14750,600,4200,2450,22000,9150,9150,0,0,12905,0,12905,2445,9095,9095,8233.33
50229250,FA2023 ,13500,550,4560,2325,20935,8000,8000,0,14235,8000,0,22235,6050,12935,-1300,0
50229250,SP2023 ,13500,550,4560,2325,20935,8000,8000,0,14236,8000,0,22236,6050,12935,-1301,0
50228123,FA2023 ,13500,550,4550,2325,20925,7550,7550,0,2750,7550,0,10300,6500,13375,10625,-2.5
50228123,FA2024 ,14750,600,5410,2450,23210,7350,7350,0,0,7350,0,7350,8000,15860,15860,-2.5
50228123,SP2023 ,13500,550,4550,2325,20925,7000,7000,0,2750,7000,0,9750,7050,13925,11175,-2.5
50228123,SP2024 ,14750,600,5410,2450,23210,7000,7000,0,16000,7000,0,23000,8350,16210,210,-2.5
50225314,FA2022 ,13005,515,3855,2220,19595,7250,7250,0,2750,7250,0,10000,6270,12345,9595,0
50225314,SP2022 ,13005,515,3855,2220,19595,7250,7250,0,2750,7250,0,10000,6270,12345,9595,0
50225314,SP2024 ,15000,7500,7500,NULL,22500,0,0,0,NULL,0,0,0,22500,22500,22500,0
50214654,FA2021 ,12625,500,4580,2110,19815,0,0,0,2250,14125,12625,16375,-1000,5690,3440,0
50214654,FA2022 ,13005,6590,6590,NULL,19595,7450,7450,0,2750,7450,0,10200,12145,12145,9395,0
50221488,FA2023 ,13500,550,4000,2325,20375,6500,6500,0,15591,6500,0,22091,7550,13875,-1716,924
50221488,FA2024 ,17620,600,NULL,NULL,18220,4485,4485,0,19157,4485,0,23642,13735,13735,-5422,924
50221488,SP2023 ,13500,550,4000,2325,20375,6500,6500,0,14494,6500,0,20994,7550,13875,-619,924
50221488,SP2024 ,14750,600,5720,1270,22340,4485,4485,0,19157,4485,0,23642,10865,17855,-1302,924
50228454,FA2023 ,13500,550,5150,2325,21525,8500,8500,0,14737,8500,0,23237,5550,13025,-1712,155
50228454,FA2024 ,14750,600,NULL,NULL,15350,5865,5865,0,16491,5865,0,22356,9485,9485,-7006,155
50228454,SP2023 ,13500,550,5150,2325,21525,8500,8500,0,13640,8500,0,22140,5550,13025,-615,155
50228454,SP2024 ,14750,600,5410,2450,23210,5865,5865,0,18214,5865,0,24079,9485,17345,-869,155
50233099,FA2024 ,14750,600,4200,2450,22000,12000,1000,11000,9015,14470,0,23485,880,7530,-1485,-41
50233099,SP2024 ,14750,600,NULL,NULL,15350,6900,1000,5900,6429,9370,0,15799,5980,5980,-449,-41
50203448,FA2021 ,12625,500,4270,1080,18475,5175,5175,0,9585,7947,0,17532,5178,10528,943,0
50221022,FA2021 ,12625,500,3740,2110,18975,4800,4800,0,10250,5800,0,16050,7325,13175,2925,0
50221022,FA2022 ,13005,515,3855,2220,19595,4300,4300,0,13250,4300,0,17550,9220,15295,2045,0
50221022,SP2021 ,12625,500,4050,2110,19285,4800,4800,0,10250,4800,0,15050,8325,14485,4235,0
50225028,FA2022 ,13005,515,4810,2220,20550,5500,5500,0,2750,5500,0,8250,8020,15050,12300,0
50225028,FA2023 ,13500,550,5150,2325,21525,5500,5500,0,NULL,5500,0,5500,8550,16025,16025,0
50225028,FA2024 ,14750,600,5030,1270,21650,5500,5500,0,3750,5500,0,9250,9850,16150,12400,0
50225028,SP2022 ,13005,515,4810,2220,20550,5500,5500,0,2750,5500,0,8250,8020,15050,12300,0
50225028,SP2023 ,7450,550,5150,2325,15475,3035,3035,0,NULL,3035,0,3035,4965,12440,12440,0
50225028,SP2024 ,14750,600,5030,1270,21650,5500,5500,0,3750,5500,0,9250,9850,16150,12400,0
50228834,FA2023 ,13500,550,5150,2325,21525,9000,9000,0,10371,9000,0,19371,5050,12525,2154,0
50228834,FA2024 ,14750,600,5410,2450,23210,9000,9000,0,7750,9000,0,16750,6350,14210,6460,0
50228834,SP2023 ,13500,550,5150,2325,21525,9000,9000,0,10371,9000,0,19371,5050,12525,2154,0
50228834,SP2024 ,14750,600,5410,2450,23210,9000,9000,0,7750,9000,0,16750,6350,14210,6460,0
50222533,FA2021 ,12625,500,3740,2110,18975,9500,9500,0,2750,10500,0,13250,2625,8475,5725,0
50222533,FA2022 ,13005,515,4610,1140,19270,9000,9000,0,3750,9000,0,12750,4520,10270,6520,0
50222533,FA2023 ,13500,550,4790,NULL,18840,9000,8500,500,2750,9000,0,11750,5050,9840,7090,0
50222533,FA2024 ,14750,600,NULL,NULL,15350,9000,8500,500,3750,9000,0,12750,6350,6350,2600,0
50222533,SP2021 ,12625,500,3740,2110,18975,9500,9500,0,2750,9500,0,12250,3625,9475,6725,0
50222533,SP2022 ,13005,515,4610,NULL,18130,9000,9000,0,3750,9000,0,12750,4520,9130,5380,0
50222533,SP2023 ,13500,550,4790,NULL,18840,9000,8500,500,2750,9000,0,11750,5050,9840,7090,0
50215520,FA2021 ,12625,500,3740,2110,18975,2925,2925,0,3250,4425,0,7675,8700,14550,11300,0
50215520,FA2022 ,13005,515,3855,2220,19595,2925,2925,0,3750,4035,0,7785,9485,15560,11810,0
50215520,FA2023 ,13500,550,4790,1200,20040,1463,1463,0,0,1463,0,1463,12587,18577,18577,0
50215520,SP2021 ,12625,500,3740,2110,18975,2925,2925,0,3250,2925,0,6175,10200,16050,12800,0
50215520,SP2022 ,13005,6590,6590,NULL,19595,1325,1325,0,3750,1764,0,5514,17831,17831,14081,0
50204695,FA2021 ,19340,860,4600,2110,26050,11250,11250,0,3750,16622,0,20372,3578,9428,5678,0
50204695,FA2022 ,19910,890,4745,2220,26875,11250,10750,500,3000,11250,0,14250,9550,15625,12625,0
50204695,SP2021 ,19340,860,4600,2110,26050,11250,11250,0,3750,14623,0,18373,5577,11427,7677,0
50204695,SP2023 ,20670,950,4950,2745,28365,10000,9500,500,NULL,13698,0,13698,7922,14667,14667,0
50229858,FA2023 ,13500,550,NULL,NULL,14050,4140,4140,0,15280,4140,0,19420,9910,9910,-5370,-534
50229858,FA2024 ,14750,600,NULL,NULL,15350,4140,4140,0,3250,4140,0,7390,11210,11210,7960,-534
50229858,SP2023 ,13500,550,NULL,NULL,14050,4140,4140,0,15280,4140,0,19420,9910,9910,-5370,-534
50229858,SP2024 ,14750,600,NULL,NULL,15350,4140,4140,0,12648,4140,0,16788,11210,11210,-1438,-534
50225569,FA2022 ,13005,515,4380,2690,20590,6600,6600,0,0,21298,0,21298,-7778,-708,-708,0
50225569,FA2023 ,13500,550,4990,2745,21785,6022,5750,272,0,23370,0,23370,-9320,-1585,-1585,0
50225569,FA2024 ,14750,600,4790,2450,22590,6522,5750,772,0,21870,0,21870,-6520,720,720,0
50225569,SP2022 ,13005,515,4380,2690,20590,6600,6600,0,0,21597,0,21597,-8077,-1007,-1007,0
50225569,SP2023 ,13500,550,4990,2745,21785,6022,5750,272,0,23369,0,23369,-9319,-1584,-1584,0
50232218,FA2024 ,14750,600,4790,2680,22820,6500,6500,0,2750,6500,0,9250,8850,16320,13570,0
50232218,SP2024 ,14750,600,4790,2450,22590,6500,6500,0,2750,6500,0,9250,8850,16090,13340,0
50209473,FA2021 ,12625,500,4270,1080,18475,4325,2100,2225,3750,5825,0,9575,7300,12650,8900,0
50209473,FA2022 ,13005,515,3855,1140,18515,6325,2000,4325,11113,8252,0,19365,5268,10263,-850,0
50209473,SP2021 ,12625,500,4270,1080,18475,4325,2100,2225,3750,4325,0,8075,8800,14150,10400,0
50215500,FA2021 ,2525,100,317,111.75,3053.75,1300,1300,0,0,8300,0,8300,-5675,-5246.25,-5246.25,0
50232034,FA2024 ,14750,600,5410,2450,23210,9650,9650,0,2750,9650,0,12400,5700,13560,10810,-250
50232034,SP2024 ,14750,600,5410,2450,23210,10900,9900,1000,2750,13000,0,15750,2350,10210,7460,-250
50231702,FA2024 ,14750,600,4790,2450,22590,10950,8750,2200,2750,10950,0,13700,4400,11640,8890,2083
50231702,SP2024 ,14750,600,4790,2450,22590,8750,8750,0,2750,8750,0,11500,6600,13840,11090,2083
50231964,SP2023 ,14500,7000,7000,NULL,21500,0,0,0,NULL,0,0,0,21500,21500,21500,0
50226996,FA2023 ,13500,550,4000,2325,20375,4423,4423,0,5250,5896,0,11146,8154,14479,9229,-1392.33
50226996,FA2024 ,14750,600,NULL,NULL,15350,4623,4423,200,6250,9821,0,16071,5529,5529,-721,-1392.33
50226996,SP2023 ,13500,550,4000,2325,20375,4423,4423,0,10250,5895,0,16145,8155,14480,4230,-1392.33
50226996,SP2024 ,14750,600,NULL,NULL,15350,4623,4423,200,6250,9821,0,16071,5529,5529,-721,-1392.33
50216182,SP2022 ,13005,515,NULL,NULL,13520,4450,4450,0,0,4450,0,4450,9070,9070,9070,0
50225475,FA2022 ,13005,515,4810,2220,20550,6300,6300,0,2750,6300,0,9050,7220,14250,11500,708
50225475,FA2023 ,13500,550,5150,2325,21525,6300,6300,0,NULL,6300,0,6300,7750,15225,15225,708
50225475,SP2022 ,7170,515,4810,2220,14715,3473,3473,0,2750,3473,0,6223,4212,11242,8492,708
50222527,FA2021 ,12625,500,4580,2110,19815,5500,5500,0,NULL,6500,0,6500,6625,13315,13315,0
50222527,FA2022 ,13005,515,3855,2220,19595,5000,5000,0,NULL,5000,0,5000,8520,14595,14595,0
50222527,FA2023 ,13500,550,4790,1200,20040,5000,5000,0,NULL,5000,0,5000,9050,15040,15040,0
50222527,FA2024 ,14750,600,5030,1270,21650,5000,5000,0,NULL,5000,0,5000,10350,16650,16650,0
50222527,SP2021 ,12625,500,4580,2110,19815,5500,5500,0,NULL,5500,0,5500,7625,14315,14315,0
50222527,SP2022 ,13005,515,3855,2220,19595,5000,5000,0,NULL,5000,0,5000,8520,14595,14595,0
50222527,SP2023 ,13500,550,4790,1200,20040,5000,5000,0,NULL,5000,0,5000,9050,15040,15040,0
50222527,SP2024 ,14750,600,5030,1270,21650,5000,5000,0,NULL,5000,0,5000,10350,16650,16650,0
50229627,FA2023 ,13500,550,4550,2325,20925,7500,7000,500,0,22448,0,22448,-8398,-1523,-1523,210
50229627,FA2024 ,14750,600,5410,2450,23210,9000,9000,0,0,22698,0,22698,-7348,512,512,210
50229627,SP2023 ,13500,550,4550,2325,20925,9000,9000,0,0,22697,0,22697,-8647,-1772,-1772,210
50229627,SP2024 ,14750,600,5410,2450,23210,9000,9000,0,0,22697,0,22697,-7347,513,513,210
50236873,SP2024 ,14750,600,4790,2450,22590,6000,6000,0,NULL,6000,0,6000,9350,16590,16590,0
50221624,FA2022 ,13005,515,3855,2220,19595,6500,6500,0,2750,6500,0,9250,7020,13095,10345,0
50221624,FA2023 ,13500,550,4560,2325,20935,6500,6500,0,13167,6500,0,19667,7550,14435,1268,0
50221624,SP2022 ,13005,515,3855,2220,19595,6500,6500,0,2750,6500,0,9250,7020,13095,10345,0
50221624,SP2023 ,13500,550,4550,2325,20925,6500,6500,0,4300,6500,0,10800,7550,14425,10125,0
50210240,FA2021 ,12625,500,4580,2110,19815,3675,3675,0,3250,6698,0,9948,6427,13117,9867,0
50210240,SP2021 ,12625,500,NULL,NULL,13125,2175,2175,0,3250,3197,0,6447,9928,9928,6678,0
50222541,FA2021 ,12625,500,4050,2110,19285,6500,6500,0,NULL,14300,0,14300,-1175,4985,4985,10100
50222541,FA2022 ,13005,515,3855,2220,19595,6500,6500,0,NULL,6500,0,6500,7020,13095,13095,10100
50222541,FA2023 ,13500,550,5440,NULL,19490,6500,6500,0,NULL,6500,0,6500,7550,12990,12990,10100
50222541,FA2024 ,14750,600,5720,NULL,21070,6500,6500,0,NULL,6500,0,6500,8850,14570,14570,10100
50222541,SP2021 ,12625,500,4050,2110,19285,6500,6500,0,NULL,6500,0,6500,6625,12785,12785,10100
50222541,SP2022 ,13005,515,3855,2220,19595,6500,6500,0,NULL,6500,0,6500,7020,13095,13095,10100
50222541,SP2023 ,13500,550,5440,NULL,19490,6500,6500,0,NULL,6500,0,6500,7550,12990,12990,10100
50222541,SP2024 ,14750,600,5720,NULL,21070,6500,6500,0,NULL,6500,0,6500,8850,14570,14570,10100
50210661,FA2021 ,12625,500,4270,NULL,17395,9725,7225,2500,2750,14148,0,16898,-1023,3247,497,0
50210661,SP2021 ,12625,500,4270,NULL,17395,9225,6725,2500,2750,11647,0,14397,1478,5748,2998,0
50218540,FA2021 ,12625,500,3740,2550,19415,8925,8925,0,1000,13698,0,14698,-573,5717,4717,0
50218540,FA2022 ,13005,515,3855,1140,18515,8425,8425,0,3750,11098,0,14848,2422,7417,3667,0
50218540,FA2023 ,13500,550,5440,1200,20690,8925,8925,0,3750,10248,0,13998,3802,10442,6692,0
50218540,SP2021 ,12625,500,3740,2550,19415,8925,8925,0,3750,11697,0,15447,1428,7718,3968,0
50218540,SP2022 ,13005,515,3855,1140,18515,8425,8425,0,3750,11097,0,14847,2423,7418,3668,0
50223306,FA2021 ,12625,500,NULL,NULL,13125,5020,5020,0,2750,8020,0,10770,5105,5105,2355,0
50223306,FA2022 ,13005,515,NULL,NULL,13520,5175,5175,0,5750,5175,0,10925,8345,8345,2595,0
50223306,SP2021 ,12625,500,NULL,NULL,13125,5020,5020,0,2750,5020,0,7770,8105,8105,5355,0
50223306,SP2022 ,13005,515,NULL,NULL,13520,5175,5175,0,5750,5175,0,10925,8345,8345,2595,0
50204183,FA2021 ,12625,500,4270,1080,18475,5175,5175,0,3750,6675,0,10425,6450,11800,8050,3356.66
50204183,SP2021 ,12625,500,4270,NULL,17395,5175,5175,0,3750,5175,0,8925,7950,12220,8470,3356.66
50221664,FA2021 ,12625,500,4580,2550,20255,9000,9000,0,2750,9500,0,12250,3625,10755,8005,0
50221664,FA2022 ,13005,515,4810,2220,20550,8500,8500,0,NULL,9000,0,9000,4520,11550,11550,0
50221664,SP2021 ,12625,500,4580,2550,20255,9000,9000,0,2750,9500,0,12250,3625,10755,8005,0
40001093,FA2024 ,14750,600,NULL,NULL,15350,5279,5279,0,2750,6757,0,9507,8593,8593,5843,0
40001093,SP2024 ,14750,600,NULL,NULL,15350,5279,5279,0,2750,6756,0,9506,8594,8594,5844,0
50118685,FA2021 ,12625,500,4270,1080,18475,3675,3675,0,3750,5175,0,8925,7950,13300,9550,0
50118685,FA2022 ,13005,515,4610,1140,19270,3675,3675,0,3750,3675,0,7425,9845,15595,11845,0
50118685,SP2021 ,12625,500,4270,1080,18475,3675,3675,0,3750,3675,0,7425,9450,14800,11050,0
50118685,SP2022 ,13005,515,4610,1140,19270,3675,3675,0,3750,3675,0,7425,9845,15595,11845,0
50212165,FA2021 ,6960,500,3740,2110,13310,510,510,0,NULL,510,0,510,6950,12800,12800,0
50212165,SP2021 ,6960,500,3740,2110,13310,510,510,0,NULL,510,0,510,6950,12800,12800,0
50225111,FA2022 ,13005,515,4810,2220,20550,7000,7000,0,2750,7000,0,9750,6520,13550,10800,8608.59
50225111,FA2023 ,13500,550,4000,2325,20375,7000,7000,0,0,7000,0,7000,7050,13375,13375,8608.59
50225111,FA2024 ,14750,600,5410,2450,23210,7000,5500,1500,3750,7000,0,10750,8350,16210,12460,8608.59
50225111,SP2022 ,13005,515,4810,2220,20550,7000,7000,0,2750,7000,0,9750,6520,13550,10800,8608.59
50225111,SP2023 ,13500,550,4000,2325,20375,7000,7000,0,0,7000,0,7000,7050,13375,13375,8608.59
50225111,SP2024 ,14750,600,5410,2450,23210,7000,5500,1500,3750,7000,0,10750,8350,16210,12460,8608.59
50203428,FA2021 ,12625,500,4270,NULL,17395,6850,6850,0,11059,8350,0,19409,4775,9045,-2014,0
50203428,SP2021 ,12625,500,4270,NULL,17395,6850,6850,0,11059,6850,0,17909,6275,10545,-514,0
50228189,FA2023 ,13500,550,5150,2325,21525,11500,0,11500,2750,11500,0,14250,2550,10025,7275,4585.42
50228189,FA2024 ,14750,600,5410,1270,22030,11500,0,11500,3250,11500,0,14750,3850,10530,7280,4585.42
50228189,SP2023 ,13500,550,5150,2325,21525,9500,0,9500,2750,9500,0,12250,4550,12025,9275,4585.42
50228189,SP2024 ,14750,600,5410,1270,22030,9500,0,9500,3250,9500,0,12750,5850,12530,9280,4585.42
50204618,FA2021 ,12625,500,4830,NULL,17955,925,925,0,NULL,925,0,925,12200,17030,17030,0
50204618,SP2021 ,12625,500,4830,NULL,17955,925,925,0,NULL,925,0,925,12200,17030,17030,0
50217181,FA2021 ,12625,500,4580,2110,19815,8725,8725,0,5250,12498,0,17748,627,7317,2067,0
50230279,SP2024 ,14750,600,6090,2450,23890,11700,9500,2200,2750,11700,0,14450,3650,12190,9440,-2144
50233263,FA2024 ,14750,600,5410,2450,23210,10303,10303,0,13979,13706,0,27685,1644,9504,-4475,79
50233263,SP2024 ,14750,600,5410,2450,23210,10303,10303,0,9968,13705,0,23673,1645,9505,-463,79
50234636,FA2024 ,14750,600,NULL,NULL,15350,7500,7500,0,NULL,9000,0,9000,6350,6350,6350,-2880
50234636,SP2024 ,14750,600,NULL,NULL,15350,7500,7500,0,NULL,9000,0,9000,6350,6350,6350,-2880
50197083,FA2023 ,3720,NULL,NULL,NULL,3720,0,0,0,NULL,3720,3720,3720,0,0,0,0
50214437,FA2021 ,19340,860,4600,2110,26050,15000,0,15000,NULL,15500,0,15500,4700,10550,10550,0
50214437,FA2022 ,19910,890,5700,2220,27830,16250,0,16250,NULL,16250,0,16250,4550,11580,11580,0
50214437,FA2023 ,20670,950,5740,1200,27610,15500,0,15500,NULL,15500,0,15500,6120,12110,12110,0
50214437,SP2021 ,19340,860,4600,2110,26050,15000,0,15000,NULL,15000,0,15000,5200,11050,11050,0
50214437,SP2022 ,19910,890,5700,2220,27830,16250,0,16250,NULL,16250,0,16250,4550,11580,11580,0
50214437,SP2023 ,20670,950,5740,1200,27610,15500,0,15500,NULL,15500,0,15500,6120,12110,12110,0
50209828,FA2021 ,12625,500,3740,2110,18975,925,0,925,3750,1925,0,5675,11200,17050,13300,0
50209828,FA2022 ,13005,515,4260,2220,20000,925,0,925,3750,925,0,4675,12595,19075,15325,0
50209828,SP2021 ,12625,500,3740,2110,18975,925,0,925,3750,925,0,4675,12200,18050,14300,0
50209828,SP2022 ,13005,515,4260,2220,20000,925,0,925,3750,925,0,4675,12595,19075,15325,0
50221859,FA2021 ,12625,500,4580,2110,19815,7250,7250,0,2750,8250,0,11000,4875,11565,8815,0
50221859,FA2022 ,13005,515,4260,2220,20000,6750,6750,0,3250,6750,0,10000,6770,13250,10000,0
50221859,FA2023 ,13500,550,4790,1200,20040,6750,0,6750,3750,6750,0,10500,7300,13290,9540,0
50221859,FA2024 ,14750,600,5030,1270,21650,6750,6750,0,3750,6750,0,10500,8600,14900,11150,0
50221859,SP2021 ,12625,500,4580,2110,19815,7250,7250,0,2750,7250,0,10000,5875,12565,9815,0
50221859,SP2022 ,13005,515,4260,2220,20000,6750,6750,0,3250,6750,0,10000,6770,13250,10000,0
50221859,SP2023 ,13500,550,4790,1200,20040,6750,0,6750,3750,6750,0,10500,7300,13290,9540,0
50221859,SP2024 ,14750,600,5030,1270,21650,6750,6750,0,3750,6750,0,10500,8600,14900,11150,0
50229795,FA2023 ,13500,550,4560,2325,20935,6550,6550,0,9402,13498,0,22900,552,7437,-1965,0
50229795,SP2023 ,13500,550,4560,2325,20935,6550,6550,0,8405,13497,0,21902,553,7438,-967,0
50225145,FA2022 ,13005,515,4260,2690,20470,6000,6000,0,NULL,6000,0,6000,7520,14470,14470,0
50225145,FA2023 ,13500,550,4000,2535,20585,6000,6000,0,NULL,6000,0,6000,8050,14585,14585,0
50225145,FA2024 ,14750,600,5720,1270,22340,6000,6000,0,NULL,6000,0,6000,9350,16340,16340,0
50225145,SP2022 ,13005,515,4260,2690,20470,6000,6000,0,NULL,6000,0,6000,7520,14470,14470,0
50225145,SP2023 ,13500,550,4000,2535,20585,6000,6000,0,NULL,6000,0,6000,8050,14585,14585,0
50225145,SP2024 ,14750,600,5720,1270,22340,6000,6000,0,NULL,6000,0,6000,9350,16340,16340,0
50222516,FA2021 ,12625,500,4580,2110,19815,5900,5900,0,2750,9073,0,11823,4052,10742,7992,0
50228379,SP2022 ,14269,7231,7231,NULL,21500,0,0,0,NULL,0,0,0,21500,21500,21500,0
50222659,FA2021 ,12625,500,4580,2110,19815,7300,7300,0,8750,8300,0,17050,4825,11515,2765,1058.6
50222659,FA2022 ,13005,515,4810,2220,20550,6800,6800,0,12500,6800,0,19300,6720,13750,1250,1058.6
50222659,FA2023 ,13500,550,5150,2325,21525,6800,6800,0,14250,6800,0,21050,7250,14725,475,1058.6
50222659,FA2024 ,14750,600,5410,2450,23210,6800,5000,1800,17950,6800,0,24750,8550,16410,-1540,1058.6
50222659,SP2021 ,12625,500,4580,2110,19815,7300,7300,0,7750,7300,0,15050,5825,12515,4765,1058.6
50222659,SP2022 ,13005,515,4810,2220,20550,6800,6800,0,13550,6800,0,20350,6720,13750,200,1058.6
50222659,SP2023 ,13500,550,5150,2325,21525,6800,6800,0,14850,6800,0,21650,7250,14725,-125,1058.6
50222659,SP2024 ,14750,600,5410,2450,23210,6800,5000,1800,15750,6800,0,22550,8550,16410,660,1058.6
50227112,FA2022 ,13005,515,3855,2220,19595,7000,7000,0,11250,7000,0,18250,6520,12595,1345,0
50227112,FA2023 ,13500,550,4560,2325,20935,7000,7000,0,14100,7000,0,21100,7050,13935,-165,0
50227112,SP2022 ,13005,515,3855,2220,19595,7000,7000,0,11250,7000,0,18250,6520,12595,1345,0
50227112,SP2023 ,13500,550,4560,2325,20935,7000,7000,0,14100,7000,0,21100,7050,13935,-165,0
50234711,FA2024 ,14750,600,4200,2450,22000,8350,8350,0,13722,8350,0,22072,7000,13650,-72,0
50234711,SP2024 ,14750,600,4200,2450,22000,8350,8350,0,13722,8350,0,22072,7000,13650,-72,0
50154213,FA2021 ,12625,6350,6350,NULL,18975,925,925,0,3750,1925,0,5675,17050,17050,13300,0
50154213,SP2021 ,12625,500,4270,2110,19505,925,925,0,3750,925,0,4675,12200,18580,14830,0
50215236,FA2021 ,12625,500,3740,2110,18975,5425,5425,0,3250,6925,0,10175,6200,12050,8800,0
50215236,FA2022 ,13005,515,4610,1140,19270,5175,5175,0,3750,5175,0,8925,8345,14095,10345,0
50215236,FA2023 ,13500,550,4000,2325,20375,5175,5175,0,3750,5175,0,8925,8875,15200,11450,0
50215236,SP2021 ,12625,500,3740,2110,18975,5175,5175,0,3250,5175,0,8425,7950,13800,10550,0
50215236,SP2022 ,13005,515,4810,2220,20550,5175,5175,0,3750,5175,0,8925,8345,15375,11625,0
50221325,FA2021 ,12625,500,4580,2110,19815,8900,8900,0,11482,9900,0,21382,3225,9915,-1567,0
50221325,FA2022 ,13005,515,4810,2220,20550,10150,5500,4650,3250,13373,0,16623,147,7177,3927,0
50221325,FA2023 ,13500,550,5440,NULL,19490,8400,5000,3400,3750,11172,0,14922,2878,8318,4568,0
50221325,SP2021 ,12625,500,4580,2110,19815,8900,8900,0,11050,8900,0,19950,4225,10915,-135,0
50221325,SP2022 ,13005,515,4133,2220,19873,10150,5500,4650,3250,13372,0,16622,148,6501,3251,0
50221325,SP2023 ,16950,550,5440,NULL,22940,8400,5000,3400,16750,11173,0,27923,6327,11767,-4983,0
50208961,FA2021 ,12625,500,4580,2550,20255,1500,0,1500,3750,2500,0,6250,10625,17755,14005,0
50208961,FA2022 ,13005,515,5080,1140,19740,1500,0,1500,3750,1500,0,5250,12020,18240,14490,0
50208961,SP2021 ,12625,500,4580,2550,20255,1500,0,1500,3750,1500,0,5250,11625,18755,15005,0
50208961,SP2022 ,13005,515,5080,1140,19740,6500,0,6500,3750,6500,0,10250,7020,13240,9490,0
50214411,FA2021 ,12625,500,4580,2110,19815,7925,7925,0,3250,9425,0,12675,3700,10390,7140,0
50214411,FA2022 ,13005,515,4810,2220,20550,7925,7925,0,3750,7925,0,11675,5595,12625,8875,0
50214411,FA2023 ,13500,550,4790,1200,20040,7925,7375,550,3750,7925,0,11675,6125,12115,8365,0
50214411,SP2021 ,12625,500,4580,2110,19815,7925,7925,0,3250,7925,0,11175,5200,11890,8640,0
50214411,SP2022 ,13005,515,4810,2220,20550,7925,7925,0,3750,7925,0,11675,5595,12625,8875,0
50214411,SP2023 ,13500,550,4790,1200,20040,7925,7375,550,3750,7925,0,11675,6125,12115,8365,0
50203465,FA2021 ,12625,500,NULL,NULL,13125,9650,800,8850,3750,13036,0,16786,89,89,-3661,0
50203465,SP2021 ,12625,500,NULL,NULL,13125,8850,0,8850,3750,10736,0,14486,2389,2389,-1361,0
50209640,FA2021 ,12625,500,NULL,NULL,13125,2425,2425,0,3250,3425,0,6675,9700,9700,6450,0
50209640,SP2021 ,12625,500,NULL,NULL,13125,2425,2425,0,3250,2425,0,5675,10700,10700,7450,0
50234526,FA2024 ,14750,600,4200,1270,20820,6500,6500,0,12409,12698,0,25107,2652,8122,-4287,0
50234526,SP2024 ,14750,600,4200,1270,20820,6500,6500,0,12408,12697,0,25105,2653,8123,-4285,0
50223329,FA2021 ,12625,500,NULL,NULL,13125,2768,2768,0,4750,10316,0,15066,2809,2809,-1941,0
50223329,SP2021 ,12625,500,NULL,NULL,13125,2768,2768,0,4750,9875,0,14625,3250,3250,-1500,0
50223329,SP2022 ,13005,515,NULL,NULL,13520,3923,2923,1000,5250,9871,0,15121,3649,3649,-1601,0
50225660,SP2021 ,6960,250,NULL,NULL,7210,2212,2212,0,5500,2212,0,7712,4998,4998,-502,0
50236489,SP2024 ,14750,600,0,0,15350,4830,4830,0,2750,4830,0,7580,10520,10520,7770,0
50233154,FA2024 ,14750,600,4200,2450,22000,5750,5750,0,2750,12198,0,14948,3152,9802,7052,2572.32
50233154,SP2024 ,14750,600,4200,2680,22230,5750,5750,0,2750,12197,0,14947,3153,10033,7283,2572.32
50228539,FA2023 ,13500,550,5150,2535,21735,9000,9000,0,15551,9000,0,24551,5050,12735,-2816,0
50228539,FA2024 ,14750,600,5410,2450,23210,9000,0,9000,13750,9000,0,22750,6350,14210,460,0
50228539,SP2023 ,13500,550,5150,2325,21525,9000,9000,0,14351,9000,0,23351,5050,12525,-1826,0
50228539,SP2024 ,14750,600,5410,2450,23210,9000,0,9000,13750,9000,0,22750,6350,14210,460,0
50233085,FA2024 ,14750,600,4200,2450,22000,6000,6000,0,2750,6000,0,8750,9350,16000,13250,5398.66
50233085,SP2024 ,14750,600,4200,2450,22000,6000,6000,0,2750,6000,0,8750,9350,16000,13250,5398.66
50228084,FA2023 ,13500,550,5150,2535,21735,7800,7800,0,2750,9050,0,11800,5000,12685,9935,0
50228084,SP2023 ,13500,550,5150,2535,21735,7800,7800,0,2750,9050,0,11800,5000,12685,9935,0
50217256,FA2021 ,12625,500,4580,2110,19815,4825,4825,0,7250,12823,0,20073,302,6992,-258,0
50217256,SP2021 ,6960,250,NULL,NULL,7210,2522,2522,0,5250,5727,0,10977,1483,1483,-3767,0
50222082,FA2021 ,12625,500,4580,2110,19815,5000,5000,0,2750,10773,0,13523,2352,9042,6292,0
50222082,FA2022 ,13005,515,4810,2220,20550,4500,4500,0,3250,14558,0,17808,-1038,5992,2742,0
50222082,FA2023 ,13500,550,4790,1200,20040,7000,7000,0,3750,12598,0,16348,1452,7442,3692,0
50222082,SP2021 ,12625,500,4580,2110,19815,5000,5000,0,2750,9272,0,12022,3853,10543,7793,0
50222082,SP2022 ,7170,515,4810,2220,14715,2481,2481,0,3250,8031,0,11281,-346,6684,3434,0
50222082,SP2023 ,7450,275,4790,NULL,12515,1471,1471,0,3750,3541,0,7291,4184,8974,5224,0
50203717,FA2021 ,12625,500,4830,NULL,17955,3925,2650,1275,12250,8425,0,20675,4700,9530,-2720,0
50203717,SP2021 ,12625,500,4830,NULL,17955,3925,2650,1275,12250,3925,0,16175,9200,14030,1780,0
50210189,FA2021 ,12625,500,NULL,NULL,13125,5125,0,5125,5750,8998,0,14748,4127,4127,-1623,0
50210189,SP2021 ,12625,500,NULL,NULL,13125,5125,0,5125,5750,7497,0,13247,5628,5628,-122,0
50229501,FA2023 ,7450,275,NULL,1200,8925,2608,2139,469,2750,4920,0,7670,2805,4005,1255,2641
50229501,FA2024 ,2120,NULL,NULL,NULL,2120,0,0,0,NULL,629,0,629,1491,1491,1491,2641
50229501,SP2023 ,7450,275,NULL,NULL,7725,2609,2140,469,2750,4920,0,7670,2805,2805,55,2641
50229501,SP2024 ,4070,NULL,NULL,NULL,4070,1150,0,1150,NULL,2370,0,2370,1700,1700,1700,2641
50211144,FA2021 ,12625,500,3740,2110,18975,0,0,0,NULL,1500,0,1500,11625,17475,17475,0
50211144,FA2022 ,13005,515,3855,2220,19595,500,500,0,NULL,500,0,500,13020,19095,19095,0
50211144,SP2021 ,12625,500,3740,2110,18975,0,0,0,NULL,0,0,0,13125,18975,18975,0
50211144,SP2022 ,13005,515,3855,2220,19595,500,500,0,NULL,500,0,500,13020,19095,19095,0
50221938,FA2021 ,12625,500,4580,2110,19815,6500,6500,0,2750,6500,0,9250,6625,13315,10565,4300
50221938,FA2022 ,13005,515,4810,2220,20550,6000,6000,0,14500,6000,0,20500,7520,14550,50,4300
50221938,FA2023 ,13500,550,5440,1200,20690,6000,6000,0,14500,6000,0,20500,8050,14690,190,4300
50221938,FA2024 ,14750,600,5720,1270,22340,6000,6000,0,15750,6000,0,21750,9350,16340,590,4300
50221938,SP2021 ,12625,500,4580,2110,19815,6500,6500,0,2750,6500,0,9250,6625,13315,10565,4300
50221938,SP2022 ,13005,515,4810,2220,20550,6000,6000,0,14500,6000,0,20500,7520,14550,50,4300
50221938,SP2023 ,13500,550,5440,NULL,19490,6000,6000,0,14500,6000,0,20500,8050,13490,-1010,4300
50221938,SP2024 ,14750,7250,7250,NULL,22000,6000,6000,0,15750,6000,0,21750,16000,16000,250,4300
50232611,FA2024 ,14750,600,5410,2450,23210,10000,10000,0,2750,10000,0,12750,5350,13210,10460,-4965
50232611,SP2024 ,14750,600,5410,2450,23210,10000,10000,0,2750,10000,0,12750,5350,13210,10460,-4965
50207461,FA2021 ,12625,500,4580,2110,19815,4425,3225,1200,3750,5425,0,9175,7700,14390,10640,4555
50207461,SP2021 ,12625,500,NULL,NULL,13125,2925,1725,1200,4548,2925,0,7473,10200,10200,5652,4555
50212083,FA2021 ,12625,500,3740,1080,17945,1725,1725,0,3750,6848,0,10598,6277,11097,7347,0
50212083,FA2022 ,13005,515,5080,1140,19740,4725,2725,2000,3750,7747,0,11497,5773,11993,8243,0
50212083,FA2023 ,13500,550,5150,2325,21525,3225,3225,0,3750,6548,0,10298,7502,14977,11227,0
50212083,SP2021 ,12625,500,3740,1080,17945,1725,1725,0,3750,4847,0,8597,8278,13098,9348,0
50212083,SP2022 ,13005,515,5080,1140,19740,2725,2725,0,3750,5748,0,9498,7772,13992,10242,0
50212083,SP2023 ,13500,550,5150,2325,21525,3225,3225,0,3750,6547,0,10297,7503,14978,11228,0
50203482,FA2021 ,12625,500,5160,1080,19365,0,0,0,3750,14125,12625,17875,-1000,5240,1490,0
50203482,SP2021 ,12625,500,5160,1080,19365,0,0,0,8250,12625,12625,20875,500,6740,-1510,0
50231415,FA2024 ,14750,600,5410,2450,23210,9000,0,9000,2750,12698,0,15448,2652,10512,7762,3643.82
50231415,SP2024 ,14750,600,5410,2450,23210,9000,0,9000,2750,12697,0,15447,2653,10513,7763,3643.82
50206409,FA2021 ,12625,500,4270,1080,18475,0,0,0,NULL,0,0,0,13125,18475,18475,0
50206409,FA2022 ,13005,515,4610,1140,19270,0,0,0,NULL,0,0,0,13520,19270,19270,0
50206409,SP2021 ,12625,500,4270,1080,18475,0,0,0,NULL,0,0,0,13125,18475,18475,0
50206409,SP2022 ,13005,515,4610,1140,19270,0,0,0,NULL,0,0,0,13520,19270,19270,0
50233426,FA2024 ,14750,600,5410,2450,23210,9500,9500,0,14947,10888,0,25835,4462,12322,-2625,-8919
50233426,SP2024 ,14750,600,5410,2450,23210,9500,9500,0,13553,10887,0,24440,4463,12323,-1230,-8919
50225583,FA2022 ,13005,515,4260,2220,20000,9300,9300,0,10250,10073,0,20323,3447,9927,-323,0
50225583,FA2023 ,13500,550,5150,2325,21525,9300,9300,0,12279,9300,0,21579,4750,12225,-54,0
50225583,SP2022 ,13005,515,4260,2220,20000,9300,9300,0,10250,10072,0,20322,3448,9928,-322,0
50225046,FA2022 ,13005,515,3855,2220,19595,8550,8550,0,2750,18550,0,21300,-5030,1045,-1705,3748.5
50225046,FA2023 ,13500,550,5800,1200,21050,8550,8550,0,3250,8550,0,11800,5500,12500,9250,3748.5
50225046,FA2024 ,14750,600,6090,1270,22710,8550,5000,3550,3750,12248,0,15998,3102,10462,6712,3748.5
50225046,SP2022 ,13005,515,3855,2220,19595,8550,8550,0,2750,8550,0,11300,4970,11045,8295,3748.5
50225046,SP2023 ,13500,550,5800,1200,21050,8550,8550,0,3250,8550,0,11800,5500,12500,9250,3748.5
50225046,SP2024 ,14750,600,6090,1270,22710,8550,5000,3550,3750,12247,0,15997,3103,10463,6713,3748.5
50203442,FA2021 ,12625,500,4830,1080,19035,2000,0,2000,1000,16125,12625,17125,-3000,2910,1910,0
50203442,SP2021 ,12625,500,4830,1080,19035,0,0,0,3750,12625,12625,16375,500,6410,2660,0
50195942,FA2021 ,3470,NULL,NULL,0,3470,0,0,0,NULL,0,0,0,3470,3470,3470,-6390
50195942,FA2022 ,1860,NULL,NULL,NULL,1860,0,0,0,NULL,0,0,0,1860,1860,1860,-6390
50195942,SP2021 ,6960,250,NULL,NULL,7210,0,0,0,NULL,0,0,0,7210,7210,7210,-6390
50195942,SP2022 ,3580,NULL,NULL,NULL,3580,0,0,0,NULL,0,0,0,3580,3580,3580,-6390
50203414,FA2021 ,12625,500,4050,1080,18255,2425,2425,0,15750,3925,0,19675,9200,14330,-1420,0
50203414,SP2021 ,12625,500,4270,NULL,17395,2425,2425,0,15750,2425,0,18175,10700,14970,-780,0
50204490,FA2021 ,19340,860,5690,NULL,25030,12650,10250,2400,3750,16873,0,20623,3327,8157,4407,0
50204490,SP2021 ,19340,860,5690,NULL,25030,12400,10000,2400,3750,14622,0,18372,5578,10408,6658,0
50228540,FA2023 ,13500,550,4560,2325,20935,6000,6000,0,2750,6000,0,8750,8050,14935,12185,0
50228540,SP2023 ,13500,550,4560,2325,20935,6000,6000,0,2750,6000,0,8750,8050,14935,12185,0
50204219,FA2021 ,12625,500,4650,1080,18855,925,925,0,NULL,1425,0,1425,11700,17430,17430,0
50204219,SP2021 ,12625,500,3740,1080,17945,925,925,0,NULL,925,0,925,12200,17020,17020,0
50210603,FA2021 ,12625,500,4580,2110,19815,3525,1525,2000,3250,10298,0,13548,2827,9517,6267,0
50210603,FA2022 ,13005,515,4610,NULL,18130,775,775,0,3750,5748,0,9498,7772,12382,8632,0
50210603,SP2021 ,12625,500,4580,2110,19815,1275,1275,0,3250,6047,0,9297,7078,13768,10518,0
50210603,SP2022 ,13005,515,4610,1140,19270,2775,775,2000,3750,7747,0,11497,5773,11523,7773,0
50232177,FA2024 ,14750,600,5410,2450,23210,7000,7000,0,19456,7000,0,26456,8350,16210,-3246,40
50232177,SP2024 ,14750,600,5410,2450,23210,7000,7000,0,15280,7000,0,22280,8350,16210,930,40
40000902,FA2021 ,12625,500,4050,1080,18255,0,0,0,NULL,13125,12625,13125,0,5130,5130,0
40000902,FA2022 ,13005,515,3855,NULL,17375,0,0,0,NULL,13005,13005,13005,515,4370,4370,0
40000902,SP2021 ,12625,500,4050,1080,18255,0,0,0,NULL,12625,12625,12625,500,5630,5630,0
40000902,SP2022 ,13005,515,3855,NULL,17375,0,0,0,NULL,13005,13005,13005,515,4370,4370,0
50225201,FA2022 ,13005,515,4810,2220,20550,5750,5750,0,16980,5750,0,22730,7770,14800,-2180,-93
50225201,FA2023 ,13500,550,4000,2325,20375,5750,5750,0,14750,5750,0,20500,8300,14625,-125,-93
50225201,FA2024 ,14750,600,5410,2450,23210,5750,5750,0,17950,5750,0,23700,9600,17460,-490,-93
50225201,SP2022 ,13005,515,4810,2220,20550,5750,5750,0,16673,5750,0,22423,7770,14800,-1873,-93
50225201,SP2023 ,13500,550,4000,2325,20375,5750,5750,0,15350,5750,0,21100,8300,14625,-725,-93
50225201,SP2024 ,14750,600,5410,2450,23210,5750,5750,0,17750,5750,0,23500,9600,17460,-290,-93
50231875,FA2024 ,14750,600,5410,2450,23210,7500,7500,0,17354,7500,0,24854,7850,15710,-1644,0
50231875,SP2024 ,14750,600,5410,2450,23210,7500,7500,0,15739,7500,0,23239,7850,15710,-29,0
50199361,FA2021 ,12625,500,3740,2110,18975,4325,0,4325,3750,9898,0,13648,3227,9077,5327,0
50199361,SP2021 ,12625,500,3740,2110,18975,4325,0,4325,3750,7897,0,11647,5228,11078,7328,0
50212668,FA2021 ,12625,500,4580,2110,19815,425,0,425,3250,1425,0,4675,11700,18390,15140,0
50212668,FA2022 ,13005,515,NULL,151.65,13671.65,0,0,0,NULL,0,0,0,13520,13671.65,13671.65,0
50212668,FA2023 ,3720,NULL,NULL,NULL,3720,0,0,0,NULL,0,0,0,3720,3720,3720,0
50212668,SP2021 ,12625,500,4580,2110,19815,425,0,425,3250,425,0,3675,12700,19390,16140,0
50212668,SP2022 ,13005,515,NULL,NULL,13520,0,0,0,NULL,0,0,0,13520,13520,13520,0
50212668,SP2023 ,7450,275,NULL,NULL,7725,0,0,0,NULL,0,0,0,7725,7725,7725,0
50204154,FA2021 ,12625,500,4830,1080,19035,7875,0,7875,8750,9875,0,18625,3250,9160,410,0
50204154,SP2021 ,12625,500,4830,NULL,17955,7875,0,7875,8750,8375,0,17125,4750,9580,830,0
50221378,FA2021 ,12625,500,3740,2110,18975,6850,6850,0,4500,8350,0,12850,4775,10625,6125,5274.57
50221378,FA2022 ,13005,515,3855,2220,19595,6350,6350,0,5250,6350,0,11600,7170,13245,7995,5274.57
50221378,FA2023 ,13500,550,4000,2325,20375,6350,5000,1350,7500,6350,0,13850,7700,14025,6525,5274.57
50221378,FA2024 ,14750,600,5030,NULL,20380,6350,5000,1350,7500,6850,0,14350,8500,13530,6030,5274.57
50221378,SP2021 ,12625,500,3740,2110,18975,6850,6850,0,4500,7350,0,11850,5775,11625,7125,5274.57
50221378,SP2022 ,13005,515,3855,2220,19595,6350,6350,0,5250,6350,0,11600,7170,13245,7995,5274.57
50221378,SP2023 ,13500,550,4000,2325,20375,6350,5000,1350,7500,6350,0,13850,7700,14025,6525,5274.57
50221378,SP2024 ,14750,600,5030,NULL,20380,6350,5000,1350,7500,6850,0,14350,8500,13530,6030,5274.57
50228660,FA2024 ,14750,600,5410,2450,23210,6500,6500,0,NULL,6500,0,6500,8850,16710,16710,-250
50228660,SP2024 ,14750,600,5410,2450,23210,6750,6750,0,NULL,6750,0,6750,8600,16460,16460,-250
50209931,FA2021 ,12625,500,NULL,NULL,13125,2425,1312,1113,NULL,3925,0,3925,9200,9200,9200,0
50209931,FA2022 ,13005,515,4810,2220,20550,3925,2505,1420,NULL,3925,0,3925,9595,16625,16625,0
50209931,SP2021 ,12625,500,NULL,NULL,13125,2425,1313,1112,NULL,2425,0,2425,10700,10700,10700,0
50212099,FA2021 ,6960,250,NULL,NULL,7210,0,0,0,NULL,1500,0,1500,5710,5710,5710,0
50212099,FA2022 ,13005,515,4810,2220,20550,0,0,0,NULL,0,0,0,13520,20550,20550,0
50212099,FA2023 ,13500,550,4790,1200,20040,0,0,0,NULL,0,0,0,14050,20040,20040,0
50212099,FA2024 ,8140,600,5720,1270,15730,0,0,0,NULL,0,0,0,8740,15730,15730,0
50212099,SP2021 ,6960,250,NULL,NULL,7210,0,0,0,NULL,0,0,0,7210,7210,7210,0
50212099,SP2022 ,13005,515,4810,2220,20550,0,0,0,NULL,0,0,0,13520,20550,20550,0
50212099,SP2023 ,13500,550,4790,1200,20040,0,0,0,NULL,0,0,0,14050,20040,20040,0
50228360,FA2023 ,13500,550,4000,2745,20795,10000,9000,1000,NULL,10000,0,10000,4050,10795,10795,3746.32
50228360,FA2024 ,14750,600,4790,1270,21410,10000,9000,1000,NULL,10000,0,10000,5350,11410,11410,3746.32
50228360,SP2022 ,13005,515,3855,2220,19595,7000,7000,0,NULL,7000,0,7000,6520,12595,12595,3746.32
50228360,SP2023 ,13500,550,4000,2325,20375,9000,9000,0,NULL,9000,0,9000,5050,11375,11375,3746.32
50228360,SP2024 ,14750,600,4790,0,20140,10000,9000,1000,NULL,10000,0,10000,5350,10140,10140,3746.32
50230551,FA2023 ,13500,550,5150,2325,21525,14050,14050,0,NULL,14050,0,14050,0,7475,7475,0
50232462,FA2024 ,14750,600,5410,2450,23210,6500,6500,0,NULL,6500,0,6500,8850,16710,16710,0
50228378,SP2022 ,14269,7231,7231,NULL,21500,0,0,0,NULL,0,0,0,21500,21500,21500,0
50233750,FA2024 ,14750,600,4200,2450,22000,5500,5500,0,NULL,5500,0,5500,9850,16500,16500,879
50233750,SP2024 ,14750,600,4200,2450,22000,5500,5500,0,NULL,5500,0,5500,9850,16500,16500,879
50223302,FA2021 ,12625,500,3740,2110,18975,5500,5500,0,2750,11348,0,14098,1777,7627,4877,-5396
50223302,FA2022 ,13005,515,NULL,NULL,13520,3105,3105,0,5250,8352,0,13602,5168,5168,-82,-5396
50223302,FA2023 ,13500,550,NULL,NULL,14050,3605,3605,0,5750,7703,0,13453,6347,6347,597,-5396
50223302,FA2024 ,8140,300,NULL,NULL,8440,1628,1628,0,6250,4918,0,11168,3522,3522,-2728,-5396
50223302,SP2021 ,12625,500,3740,2110,18975,5500,5500,0,2750,10907,0,13657,2218,8068,5318,-5396
50223302,SP2022 ,13005,515,NULL,NULL,13520,3105,3105,0,5250,8353,0,13603,5167,5167,-83,-5396
50223302,SP2023 ,13500,550,NULL,NULL,14050,3605,3605,0,5750,7702,0,13452,6348,6348,598,-5396
50223302,SP2024 ,8140,300,NULL,NULL,8440,1904,1904,0,6250,5526,0,11776,2914,2914,-3336,-5396
50226942,FA2022 ,1860,NULL,NULL,NULL,1860,0,0,0,NULL,0,0,0,1860,1860,1860,0
50226942,SP2022 ,3580,NULL,NULL,NULL,3580,3523,3523,0,NULL,3523,0,3523,57,57,57,0
50119410,FA2023 ,13500,550,4560,2325,20935,9500,7500,2000,NULL,11600,0,11600,2450,9335,9335,0
50119410,FA2024 ,14750,600,4790,2450,22590,7500,7500,0,NULL,7500,0,7500,7850,15090,15090,0
50119410,SP2023 ,13500,550,4560,2325,20935,7500,7500,0,NULL,7500,0,7500,6550,13435,13435,0
50119410,SP2024 ,14750,600,4790,2450,22590,7500,7500,0,NULL,7500,0,7500,7850,15090,15090,0
50225113,FA2022 ,13005,515,4260,2220,20000,10500,8500,2000,10842,10500,0,21342,3020,9500,-1342,-1038
50225113,FA2023 ,13500,550,5150,2325,21525,10500,8500,2000,13587,10500,0,24087,3550,11025,-2562,-1038
50225113,FA2024 ,14750,600,4790,2450,22590,8500,8500,0,12625,11098,0,23723,4252,11492,-1133,-1038
50225113,SP2022 ,13005,515,4260,2220,20000,8500,8500,0,12150,8500,0,20650,5020,11500,-650,-1038
50225113,SP2023 ,13500,550,5150,2325,21525,8500,8500,0,11909,8500,0,20409,5550,13025,1116,-1038
50225113,SP2024 ,14750,600,5720,1270,22340,8500,8500,0,12626,11097,0,23723,4253,11243,-1383,-1038
50228661,FA2023 ,13500,550,5150,2325,21525,9000,7000,2000,14250,9000,0,23250,5050,12525,-1725,1066.67
50228661,FA2024 ,14750,600,NULL,1270,16620,4830,4830,0,8471,8090,0,16561,7260,8530,59,1066.67
50228661,SP2023 ,13500,550,5150,2325,21525,7000,7000,0,15410,7000,0,22410,7050,14525,-885,1066.67
50228661,SP2024 ,14750,600,NULL,1270,16620,4830,4830,0,8471,8090,0,16561,7260,8530,59,1066.67
50221347,FA2021 ,12625,500,4050,2110,19285,9500,0,9500,2750,11000,0,13750,2125,8285,5535,0
50221347,FA2022 ,13005,515,3855,2220,19595,9500,0,9500,3250,9500,0,12750,4020,10095,6845,0
50221347,FA2023 ,13500,550,5440,1200,20690,9550,0,9550,3750,9550,0,13300,4500,11140,7390,0
50221347,FA2024 ,14750,600,6090,1270,22710,9500,0,9500,3750,9500,0,13250,5850,13210,9460,0
50221347,SP2021 ,12625,500,4050,2110,19285,9500,0,9500,2750,9500,0,12250,3625,9785,7035,0
50221347,SP2022 ,13005,515,3855,2220,19595,9500,0,9500,3250,9500,0,12750,4020,10095,6845,0
50221347,SP2023 ,13500,550,5440,1200,20690,9500,0,9500,3750,9500,0,13250,4550,11190,7440,0
50222226,FA2021 ,12625,500,4580,2110,19815,6500,6500,0,2750,8523,0,11273,4602,11292,8542,0
50222226,SP2021 ,12625,500,4580,2110,19815,6500,6500,0,2750,7022,0,9772,6103,12793,10043,0
50220701,FA2021 ,12625,500,4580,2110,19815,12000,10000,2000,4750,16748,0,21498,-3623,3067,-1683,0
50220701,FA2022 ,13005,515,4810,2220,20550,9000,9000,0,5250,12447,0,17697,1073,8103,2853,0
50220701,SP2021 ,12625,500,4580,2110,19815,10000,10000,0,4750,14307,0,19057,-1182,5508,758,0
50220701,SP2022 ,13005,515,4810,2220,20550,9000,9000,0,5250,12448,0,17698,1072,8102,2852,0
50218418,FA2021 ,12625,500,3740,1080,17945,2000,0,2000,NULL,3500,0,3500,9625,14445,14445,0
50218418,FA2022 ,13005,515,5080,1140,19740,0,0,0,NULL,0,0,0,13520,19740,19740,0
50218418,FA2023 ,13500,550,5440,1200,20690,0,0,0,NULL,0,0,0,14050,20690,20690,0
50218418,SP2021 ,12625,500,3740,1080,17945,0,0,0,NULL,0,0,0,13125,17945,17945,0
50218418,SP2022 ,13005,515,5080,1140,19740,0,0,0,NULL,0,0,0,13520,19740,19740,0
50218418,SP2023 ,13500,550,5440,1200,20690,0,0,0,NULL,0,0,0,14050,20690,20690,0
50218469,FA2021 ,12625,500,4050,1080,18255,7925,6425,1500,NULL,16653,0,16653,-3528,1602,1602,0
50218469,SP2021 ,12625,500,4050,NULL,17175,9925,6425,3500,NULL,11795,0,11795,1330,5380,5380,0
50204217,FA2021 ,12625,500,NULL,NULL,13125,1425,0,1425,3750,7448,0,11198,5677,5677,1927,0
50204217,FA2022 ,5360,257,NULL,NULL,5617,1206,0,1206,0,2930,0,2930,2687,2687,2687,0
50204217,SP2021 ,12625,500,NULL,NULL,13125,1425,0,1425,3750,5447,0,9197,7678,7678,3928,0
50224894,FA2022 ,13005,515,3855,2220,19595,9500,0,9500,NULL,9500,0,9500,4020,10095,10095,34942.14
50224894,FA2023 ,13500,550,4000,2325,20375,9500,0,9500,NULL,9500,0,9500,4550,10875,10875,34942.14
50224894,SP2022 ,13005,515,3855,2220,19595,9500,0,9500,NULL,9500,0,9500,4020,10095,10095,34942.14
50224894,SP2023 ,13500,550,4000,1200,19250,9550,0,9550,NULL,9550,0,9550,4500,9700,9700,34942.14
50205068,FA2021 ,12625,500,4830,NULL,17955,4425,4425,0,3750,5925,0,9675,7200,12030,8280,0
50205068,SP2021 ,12625,500,4830,NULL,17955,4425,4425,0,3750,4425,0,8175,8700,13530,9780,0
50221519,FA2021 ,12625,500,4580,2110,19815,0,0,0,1000,16814,12625,17814,-3689,3001,2001,-11044
50221519,FA2022 ,13005,515,4810,2220,20550,0,0,0,3250,16978,13005,20228,-3458,3572,322,-11044
50221519,FA2023 ,13500,550,4560,1200,19810,0,0,0,3750,17423,13500,21173,-3373,2387,-1363,-11044
50221519,FA2024 ,14750,600,4790,1270,21410,0,0,0,2750,19948,14750,22698,-4598,1462,-1288,-11044
50221519,SP2021 ,12625,500,4580,2110,19815,2000,0,2000,1000,16897,12625,17897,-3772,2918,1918,-11044
50221519,SP2022 ,13005,515,4810,2220,20550,0,0,0,3250,16977,13005,20227,-3457,3573,323,-11044
50221519,SP2023 ,13500,550,4560,1200,19810,0,0,0,3750,17422,13500,21172,-3372,2388,-1362,-11044
50221519,SP2024 ,14750,600,NULL,NULL,15350,0,0,0,2750,19948,14750,22698,-4598,-4598,-7348,-11044
50204433,FA2021 ,12625,6350,6350,NULL,18975,1713,1713,0,NULL,1713,0,1713,17262,17262,17262,0
50204433,SP2021 ,6960,500,4270,NULL,11730,1888,1888,0,NULL,1888,0,1888,5572,9842,9842,0
50203423,FA2021 ,12625,6350,6350,NULL,18975,5425,3575,1850,12887,6925,0,19812,12050,12050,-837,0
50203423,SP2021 ,12625,500,4830,1080,19035,5425,3575,1850,12886,5425,0,18311,7700,13610,724,0
50209719,FA2021 ,19340,860,5440,2110,26890,12500,12500,0,3750,14000,0,17750,6200,12890,9140,0
50209719,FA2022 ,19910,890,5970,1140,27020,12500,12500,0,3750,12500,0,16250,8300,14520,10770,0
50209719,SP2021 ,19340,860,5440,2110,26890,12500,12500,0,3750,12500,0,16250,7700,14390,10640,0
50209719,SP2022 ,19910,890,5970,1140,27020,12500,12500,0,3750,12500,0,16250,8300,14520,10770,0
50232848,FA2024 ,14750,600,5410,2450,23210,6000,6000,0,2750,6000,0,8750,9350,17210,14460,6042.32
50232848,SP2024 ,14750,600,5410,2450,23210,6000,6000,0,2750,6000,0,8750,9350,17210,14460,6042.32
50210128,FA2021 ,12625,500,3740,1080,17945,8425,8425,0,3750,9925,0,13675,3200,8020,4270,0
50210128,SP2021 ,12625,500,3740,1080,17945,8425,8425,0,3750,8425,0,12175,4700,9520,5770,0
50211427,FA2021 ,12625,500,3740,2110,18975,4425,4425,0,NULL,5925,0,5925,7200,13050,13050,0
50211427,FA2022 ,13005,515,NULL,NULL,13520,2925,2925,0,NULL,2925,0,2925,10595,10595,10595,0
50211427,SP2021 ,12625,500,4580,2110,19815,4425,4425,0,NULL,4425,0,4425,8700,15390,15390,0
50211427,SP2022 ,7170,257,NULL,NULL,7427,1613,1613,0,NULL,1613,0,1613,5814,5814,5814,0
50233619,FA2024 ,14750,600,5240,2450,23040,8500,8500,0,2750,8500,0,11250,6850,14540,11790,4359
50233619,SP2024 ,14750,600,5240,2450,23040,8500,8500,0,2750,8500,0,11250,6850,14540,11790,4359
50230090,FA2023 ,13500,550,5150,2325,21525,6500,6500,0,2750,6500,0,9250,7550,15025,12275,0
50230090,SP2023 ,2700,110,1030,465,4305,1300,1300,0,2750,1300,0,4050,1510,3005,255,0
50229348,FA2023 ,13500,550,5150,2325,21525,7000,7000,0,2750,7000,0,9750,7050,14525,11775,4550.32
50229348,FA2024 ,14750,600,5410,2450,23210,7000,5500,1500,3250,7000,0,10250,8350,16210,12960,4550.32
50229348,SP2023 ,13500,550,5150,2325,21525,7000,7000,0,2750,7000,0,9750,7050,14525,11775,4550.32
50229348,SP2024 ,14750,600,5410,2450,23210,7000,5500,1500,3250,7000,0,10250,8350,16210,12960,4550.32
50231624,FA2024 ,14750,600,5410,2450,23210,9000,9000,0,2750,9000,0,11750,6350,14210,11460,3787
50231624,SP2024 ,14750,600,5410,2450,23210,9000,9000,0,2750,9000,0,11750,6350,14210,11460,3787
50225752,FA2022 ,13005,515,4810,2220,20550,5850,5850,0,6750,11948,0,18698,1572,8602,1852,492.71
50225752,SP2022 ,13005,515,4810,2220,20550,6141,6141,0,6750,12238,0,18988,1282,8312,1562,492.71
50209247,FA2021 ,12625,500,4580,2110,19815,6125,5950,175,14890,7625,0,22515,5500,12190,-2700,0
50209247,FA2022 ,13005,515,4260,2220,20000,6125,4950,1175,14480,6125,0,20605,7395,13875,-605,0
50209247,SP2021 ,12625,500,4580,2110,19815,6125,5950,175,14890,6125,0,21015,7000,13690,-1200,0
50209247,SP2022 ,13005,515,4260,2220,20000,6125,4950,1175,14480,6125,0,20605,7395,13875,-605,0
50225476,FA2022 ,13005,515,4810,2220,20550,6500,6500,0,2750,6500,0,9250,7020,14050,11300,0
50225476,FA2023 ,13500,550,5150,2325,21525,6500,6500,0,NULL,6500,0,6500,7550,15025,15025,0
50225476,FA2024 ,14750,600,5410,2450,23210,6500,500,6000,NULL,6500,0,6500,8850,16710,16710,0
50225476,SP2022 ,13005,515,4810,2220,20550,6500,6500,0,2750,6500,0,9250,7020,14050,11300,0
50225476,SP2023 ,13500,550,5150,2325,21525,6500,6500,0,NULL,6500,0,6500,7550,15025,15025,0
50204869,FA2021 ,12625,500,4270,NULL,17395,3425,3425,0,3750,4425,0,8175,8700,12970,9220,0
50204869,SP2021 ,12625,500,4270,NULL,17395,3425,3425,0,3750,3425,0,7175,9700,13970,10220,0
50234996,FA2024 ,14750,600,4790,2450,22590,6528,6528,0,NULL,6528,0,6528,8822,16062,16062,0
50234996,SP2024 ,14750,600,4790,2450,22590,6528,6528,0,NULL,6528,0,6528,8822,16062,16062,0
50216516,FA2021 ,12625,500,NULL,NULL,13125,4925,4925,0,6750,6425,0,13175,6700,6700,-50,0
50216516,FA2023 ,3720,NULL,NULL,NULL,3720,0,0,0,NULL,3720,3720,3720,0,0,0,0
50216516,FA2024 ,8140,300,NULL,NULL,8440,0,0,0,NULL,8140,8140,8140,300,300,300,0
50216516,SP2022 ,3580,NULL,NULL,NULL,3580,0,0,0,NULL,3580,3580,3580,0,0,0,0
50216516,SP2023 ,7450,275,NULL,NULL,7725,0,0,0,NULL,7450,7450,7450,275,275,275,0
50216516,SP2024 ,8140,300,NULL,NULL,8440,0,0,0,NULL,8140,8140,8140,300,300,300,0
50230502,FA2023 ,13500,550,4000,2745,20795,8200,8200,0,0,8200,0,8200,5850,12595,12595,-2890
50230502,FA2024 ,14750,600,5410,2680,23440,8200,7000,1200,3750,8200,0,11950,7150,15240,11490,-2890
50230502,SP2023 ,13500,550,4000,2745,20795,8200,8200,0,0,8200,0,8200,5850,12595,12595,-2890
50230502,SP2024 ,8140,600,5410,2450,16600,4525,3863,662,3750,4525,0,8275,4215,12075,8325,-2890
50231054,SP2023 ,13500,550,NULL,NULL,14050,7675,7675,0,5500,7675,0,13175,6375,6375,875,0
50228105,FA2023 ,13500,550,4000,2745,20795,7500,7500,0,16609,9500,0,26109,4550,11295,-5314,5
50228105,FA2024 ,14750,600,5410,2450,23210,7500,7500,0,18250,7500,0,25750,7850,15710,-2540,5
50228105,SP2023 ,13500,550,4000,2535,20585,7500,7500,0,14600,7500,0,22100,6550,13085,-1515,5
50228105,SP2024 ,14750,600,5410,2450,23210,7500,7500,0,16100,7500,0,23600,7850,15710,-390,5
50228338,FA2023 ,13500,550,NULL,NULL,14050,5020,5020,0,2750,6270,0,9020,7780,7780,5030,1647.33
50228338,FA2024 ,14750,600,NULL,NULL,15350,7270,4270,3000,3250,7270,0,10520,8080,8080,4830,1647.33
50228338,SP2023 ,13500,550,NULL,NULL,14050,5020,5020,0,2750,6270,0,9020,7780,7780,5030,1647.33
50228338,SP2024 ,14750,600,NULL,NULL,15350,7270,4270,3000,3250,7270,0,10520,8080,8080,4830,1647.33
50215299,FA2021 ,12625,500,4580,2110,19815,3425,3425,0,0,3425,0,3425,9700,16390,16390,0
50215299,FA2022 ,13005,515,4260,2220,20000,3425,3425,0,18146,3425,0,21571,10095,16575,-1571,0
50215299,FA2023 ,13500,550,4560,2325,20935,3425,3425,0,19236,3425,0,22661,10625,17510,-1726,0
50215299,SP2021 ,12625,500,4580,2110,19815,3425,3425,0,13756,3425,0,17181,9700,16390,2634,0
50215299,SP2022 ,13005,515,4260,2220,20000,3425,3425,0,15296,3425,0,18721,10095,16575,1279,0
50215299,SP2023 ,13500,550,4560,2325,20935,3425,3425,0,12256,3425,0,15681,10625,17510,5254,0
50207433,FA2021 ,12625,500,4270,1080,18475,625,625,0,25677,2125,0,27802,11000,16350,-9327,0
50225973,FA2022 ,13005,515,4810,2220,20550,6000,6000,0,15802,6000,0,21802,7520,14550,-1252,0
50225973,SP2022 ,13005,515,4810,2220,20550,6000,6000,0,15802,7000,0,22802,6520,13550,-2252,0
50221222,FA2021 ,12625,500,3740,2110,18975,5500,5500,0,2750,12148,0,14898,977,6827,4077,0
50228456,FA2023 ,13500,550,5150,2325,21525,11000,9000,2000,12774,11000,0,23774,3050,10525,-2249,0
50228456,FA2024 ,14750,600,5410,2450,23210,9000,9000,0,14663,9000,0,23663,6350,14210,-453,0
50228456,SP2023 ,13500,550,5150,2325,21525,9000,9000,0,12975,9000,0,21975,5050,12525,-450,0
50228456,SP2024 ,14750,600,5410,2450,23210,9000,9000,0,14866,9000,0,23866,6350,14210,-656,0
50228449,FA2023 ,13500,550,4000,2325,20375,7500,7500,0,2750,7500,0,10250,6550,12875,10125,0
50228449,FA2024 ,14750,600,4200,2450,22000,7500,7500,0,0,7500,0,7500,7850,14500,14500,0
50228449,SP2023 ,13500,550,4000,2325,20375,7500,7500,0,2750,7500,0,10250,6550,12875,10125,0
50228449,SP2024 ,14750,600,4200,2450,22000,7500,7500,0,0,7500,0,7500,7850,14500,14500,0
50216184,FA2021 ,12625,500,4580,2110,19815,8225,8225,0,12500,10225,0,22725,2900,9590,-2910,0
50216184,FA2022 ,13005,515,4610,1140,19270,8225,8225,0,11750,8725,0,20475,4795,10545,-1205,0
50216184,FA2023 ,13500,550,5440,1200,20690,8225,8225,0,17106,8725,0,25831,5325,11965,-5141,0
50216184,SP2021 ,12625,500,4580,2110,19815,8225,8225,0,15300,8725,0,24025,4400,11090,-4210,0
50216184,SP2022 ,13005,515,4610,1140,19270,8225,8225,0,11750,8725,0,20475,4795,10545,-1205,0
50216184,SP2023 ,13500,550,5440,1200,20690,8225,8225,0,14966,8725,0,23691,5325,11965,-3001,0
50231437,FA2024 ,14750,600,5410,2450,23210,6500,6500,0,NULL,6500,0,6500,8850,16710,16710,0
50231437,SP2024 ,14750,600,5410,2450,23210,6500,6500,0,NULL,6500,0,6500,8850,16710,16710,0
50119203,FA2021 ,12625,500,4580,2110,19815,6500,6000,500,2750,6500,0,9250,6625,13315,10565,0
50119203,SP2021 ,12625,500,4580,2110,19815,6250,6250,0,2750,6250,0,9000,6875,13565,10815,0
50235927,SP2024 ,15000,7500,7500,NULL,22500,0,0,0,NULL,0,0,0,22500,22500,22500,0
50197536,FA2021 ,12625,500,4270,1080,18475,2425,2425,0,0,8073,0,8073,5052,10402,10402,0
50212248,FA2021 ,12625,500,3740,1080,17945,4175,3725,450,8667,10148,0,18815,2977,7797,-870,0
50212248,FA2022 ,13005,515,5080,1140,19740,4175,3725,450,14695,5425,0,20120,8095,14315,-380,0
50212248,SP2021 ,12625,500,3740,223.6,17088.6,4175,3725,450,8666,8147,0,16813,4978,8941.6,275.6,0
50212248,SP2022 ,13005,515,5080,1140,19740,4175,3725,450,14666,5425,0,20091,8095,14315,-351,0
50212258,FA2021 ,12625,500,3740,2550,19415,6450,6450,0,8196,8700,0,16896,4425,10715,2519,0
50212258,FA2022 ,13005,515,3855,2690,20065,5450,5450,0,9312,8873,0,18185,4647,11192,1880,0
50212258,FA2023 ,13500,550,4000,2535,20585,7200,7200,0,13340,7200,0,20540,6850,13385,45,0
50212258,FA2024 ,14750,600,5410,2900,23660,7200,4500,2700,16424,7200,0,23624,8150,16460,36,0
50212258,SP2021 ,12625,500,3740,2550,19415,6450,6450,0,10743,7700,0,18443,5425,11715,972,0
50212258,SP2022 ,13005,515,3855,2690,20065,5450,5450,0,11135,8872,0,20007,4648,11193,58,0
50212258,SP2023 ,13500,550,4000,2535,20585,7200,7200,0,13550,7200,0,20750,6850,13385,-165,0
50214556,FA2021 ,12625,500,4050,2110,19285,0,0,0,3250,14125,12625,17375,-1000,5160,1910,0
50214556,FA2022 ,13005,515,5080,1140,19740,800,800,0,3750,13805,13005,17555,-285,5935,2185,0
50214556,FA2023 ,13500,550,4790,1200,20040,0,0,0,3750,13500,13500,17250,550,6540,2790,0
50214556,SP2021 ,12625,500,3740,2110,18975,0,0,0,3250,12625,12625,15875,500,6350,3100,0
50214556,SP2022 ,13005,515,5080,1140,19740,0,0,0,3750,13005,13005,16755,515,6735,2985,0
50225584,FA2022 ,13005,515,4810,2220,20550,6700,6700,0,2750,7000,0,9750,6520,13550,10800,4528.64
50225584,FA2023 ,13500,550,5150,2325,21525,8200,5500,2700,3250,8500,0,11750,5550,13025,9775,4528.64
50225584,FA2024 ,14750,600,5720,1270,22340,6700,500,6200,3750,6700,0,10450,8650,15640,11890,4528.64
50225584,SP2022 ,13005,515,4810,2220,20550,6700,6700,0,2750,7000,0,9750,6520,13550,10800,4528.64
50225584,SP2023 ,13500,550,5150,2325,21525,8200,5500,2700,3250,8500,0,11750,5550,13025,9775,4528.64
50225584,SP2024 ,14750,600,5720,1270,22340,6700,500,6200,3750,6700,0,10450,8650,15640,11890,4528.64
50229646,FA2023 ,13500,550,5150,2325,21525,8900,7900,1000,2750,9623,0,12373,4427,11902,9152,4568.32
50229646,FA2024 ,14750,600,4200,2450,22000,8900,6000,2900,NULL,8900,0,8900,6450,13100,13100,4568.32
50229646,SP2023 ,13500,550,5150,2325,21525,8900,7900,1000,2750,9622,0,12372,4428,11903,9153,4568.32
50229646,SP2024 ,14750,600,4200,2450,22000,8900,6000,2900,NULL,8900,0,8900,6450,13100,13100,4568.32
50221431,FA2021 ,12625,500,4580,2110,19815,7500,7500,0,NULL,7500,0,7500,5625,12315,12315,3483.99
50221431,FA2022 ,13005,515,3855,2220,19595,7000,7000,0,NULL,7000,0,7000,6520,12595,12595,3483.99
50221431,FA2023 ,13500,550,4560,2325,20935,7000,7000,0,NULL,7000,0,7000,7050,13935,13935,3483.99
50221431,FA2024 ,14750,600,5030,1270,21650,7500,7000,500,NULL,7500,0,7500,7850,14150,14150,3483.99
50221431,SP2021 ,12625,500,4580,2110,19815,7500,7500,0,NULL,7500,0,7500,5625,12315,12315,3483.99
50221431,SP2022 ,13005,515,3855,2220,19595,7000,7000,0,NULL,7000,0,7000,6520,12595,12595,3483.99
50221431,SP2023 ,13500,6825,6825,NULL,20325,0,0,0,NULL,0,0,0,20325,20325,20325,3483.99
50221431,SP2024 ,14750,600,5030,1270,21650,7500,7000,500,NULL,7500,0,7500,7850,14150,14150,3483.99
50226544,FA2022 ,13005,515,4810,2690,21020,9500,7500,2000,0,10500,0,10500,3020,10520,10520,7546.08
50226544,FA2023 ,13500,550,5150,2745,21945,11000,9000,2000,3250,11000,0,14250,3050,10945,7695,7546.08
50226544,FA2024 ,14750,600,5410,2450,23210,11000,9000,2000,0,11000,0,11000,4350,12210,12210,7546.08
50226544,SP2022 ,13005,515,4810,2690,21020,7500,7500,0,0,13000,0,13000,520,8020,8020,7546.08
50226544,SP2023 ,13500,550,5150,2745,21945,9000,9000,0,3250,9000,0,12250,5050,12945,9695,7546.08
50226544,SP2024 ,14750,7250,7250,NULL,22000,9000,9000,0,0,9000,0,9000,13000,13000,13000,7546.08
50214429,FA2021 ,12625,500,4580,2110,19815,8425,8425,0,NULL,11425,0,11425,1700,8390,8390,0
50214429,FA2022 ,13005,515,4810,2220,20550,8425,0,8425,NULL,11425,0,11425,2095,9125,9125,0
50214429,FA2023 ,13500,550,4790,1200,20040,8425,0,8425,NULL,11425,0,11425,2625,8615,8615,0
50214429,SP2021 ,12625,500,4580,2110,19815,8425,8425,0,NULL,8425,0,8425,4700,11390,11390,0
50214429,SP2022 ,13005,6590,6590,NULL,19595,8425,0,8425,NULL,8425,0,8425,11170,11170,11170,0
50214429,SP2023 ,13500,550,4790,1200,20040,8425,0,8425,NULL,8425,0,8425,5625,11615,11615,0
50211092,FA2021 ,12625,500,3740,2110,18975,5725,5325,400,3750,11248,0,14998,1877,7727,3977,0
50211092,FA2022 ,13005,515,4610,NULL,18130,5725,5325,400,3750,9573,0,13323,3947,8557,4807,0
50211092,SP2021 ,12625,500,3740,2110,18975,5725,5325,400,3750,9247,0,12997,3878,9728,5978,0
50211092,SP2022 ,7170,515,4610,NULL,12295,3157,2936,221,3750,5963,0,9713,1722,6332,2582,0
50225477,FA2022 ,13005,515,3855,2220,19595,7500,7500,0,2750,11898,0,14648,1622,7697,4947,0
50225477,FA2023 ,13500,550,4000,2325,20375,9500,7500,2000,3250,13598,0,16848,452,6777,3527,0
50225477,FA2024 ,14750,600,4200,2450,22000,8950,5500,3450,3750,13005,0,16755,2345,8995,5245,0
50225477,SP2022 ,13005,515,3855,2220,19595,7500,7500,0,2750,10947,0,13697,2573,8648,5898,0
50225477,SP2023 ,13500,550,4000,2325,20375,7500,7500,0,3250,11597,0,14847,2453,8778,5528,0
50225477,SP2024 ,14750,600,4200,2450,22000,7500,5500,2000,3750,11555,0,15305,3795,10445,6695,0
50231992,FA2024 ,14750,600,4200,2450,22000,11050,9050,2000,2750,14705,0,17455,645,7295,4545,0
50231992,SP2024 ,14750,600,4200,2450,22000,9050,9050,0,2750,12705,0,15455,2645,9295,6545,0
50215915,FA2021 ,12625,500,3740,2550,19415,8275,8275,0,3250,11025,0,14275,2100,8390,5140,0
50215915,FA2022 ,13005,515,3855,2690,20065,9775,7775,2000,3750,13998,0,17748,-478,6067,2317,0
50215915,SP2021 ,12625,500,3740,2550,19415,8275,8275,0,3250,9525,0,12775,3600,9890,6640,0
50215915,SP2022 ,13005,515,3855,2690,20065,7775,7775,0,3750,11997,0,15747,1523,8068,4318,0
50224896,FA2023 ,13500,550,4000,2325,20375,9000,500,8500,2750,15673,0,18423,-1623,4702,1952,0
50224896,FA2024 ,14750,600,4200,2450,22000,9500,1000,8500,3250,15540,0,18790,-190,6460,3210,0
50224896,SP2023 ,13500,550,4000,2325,20375,9000,500,8500,2750,10672,0,13422,3378,9703,6953,0
50224896,SP2024 ,14750,600,4200,2450,22000,9500,1000,8500,3250,15540,0,18790,-190,6460,3210,0
50115132,FA2021 ,3470,NULL,NULL,NULL,3470,0,0,0,NULL,0,0,0,3470,3470,3470,0
50229487,FA2023 ,13500,550,5150,2325,21525,7000,7000,0,0,7000,0,7000,7050,14525,14525,8334.99
50229487,FA2024 ,14750,600,5410,2450,23210,7000,7000,0,NULL,7000,0,7000,8350,16210,16210,8334.99
50229487,SP2023 ,13500,550,5150,2325,21525,7000,7000,0,0,7000,0,7000,7050,14525,14525,8334.99
50229487,SP2024 ,14750,600,5410,2450,23210,7000,7000,0,NULL,7000,0,7000,8350,16210,16210,8334.99
50078308,FA2021 ,12625,500,4830,1080,19035,4425,0,4425,NULL,4925,0,4925,8200,14110,14110,0
50078308,SP2021 ,12625,500,4830,1080,19035,4425,0,4425,NULL,4425,0,4425,8700,14610,14610,0
50228979,FA2023 ,13500,550,5150,2745,21945,9000,9000,0,0,22375,0,22375,-8325,-430,-430,0
50228979,FA2024 ,14750,600,5410,2450,23210,6000,6000,0,3250,21600,0,24850,-6250,1610,-1640,0
50228979,SP2023 ,13500,550,5150,2325,21525,9000,9000,0,0,17500,0,17500,-3450,4025,4025,0
50228979,SP2024 ,14750,600,5410,2450,23210,12000,12000,0,3250,16600,0,19850,-1250,6610,3360,0
50228470,FA2023 ,13500,550,4000,2325,20375,13250,11250,2000,2750,13250,0,16000,800,7125,4375,3749.68
50228470,FA2024 ,14750,600,4200,2450,22000,13250,10000,3250,3250,13250,0,16500,2100,8750,5500,3749.68
50228470,SP2023 ,13500,550,4000,2325,20375,11250,11250,0,2750,11250,0,14000,2800,9125,6375,3749.68
50228470,SP2024 ,14750,600,4200,2450,22000,11250,10000,1250,3250,11250,0,14500,4100,10750,7500,3749.68
50198575,FA2021 ,12625,500,NULL,NULL,13125,0,0,0,15940,1500,0,17440,11625,11625,-4315,0
50222752,FA2021 ,12625,500,4580,2110,19815,6200,6200,0,2750,12073,0,14823,1052,7742,4992,0
50222752,FA2022 ,13005,515,4810,2220,20550,6100,6100,0,14527,9973,0,24500,3547,10577,-3950,0
50222752,FA2023 ,13500,550,4560,2325,20935,6100,6100,0,14582,10998,0,25580,3052,9937,-4645,0
50222752,FA2024 ,14750,600,5030,1270,21650,6600,0,6600,14191,10998,0,25189,4352,10652,-3539,0
50222752,SP2021 ,12625,500,4580,2110,19815,6200,6200,0,2750,10572,0,13322,2553,9243,6493,0
50222752,SP2022 ,13005,515,4810,2220,20550,6100,6100,0,14527,9972,0,24499,3548,10578,-3949,0
50222752,SP2023 ,13500,550,4560,2325,20935,6100,6100,0,12290,10997,0,23287,3053,9938,-2352,0
50222752,SP2024 ,14750,600,5030,1270,21650,6600,0,6600,14192,10997,0,25189,4353,10653,-3539,0
50225944,FA2022 ,13005,515,4810,2220,20550,6503,6503,0,2750,6503,0,9253,7017,14047,11297,6731
50216076,FA2021 ,12625,500,3740,2110,18975,12375,4375,8000,3250,18588,0,21838,-5463,387,-2863,0
50216076,FA2022 ,13005,515,3855,2220,19595,12075,7700,4375,3750,13898,0,17648,-378,5697,1947,0
50216076,FA2023 ,13500,550,NULL,1200,15250,9075,0,9075,3750,11698,0,15448,2352,3552,-198,0
50216076,SP2021 ,12625,500,3740,2110,18975,12075,4075,8000,3250,16287,0,19537,-3162,2688,-562,0
50216076,SP2022 ,13005,515,3855,2220,19595,10575,7700,2875,3750,12397,0,16147,1123,7198,3448,0
50216076,SP2023 ,13500,550,NULL,NULL,14050,9075,0,9075,3750,11697,0,15447,2353,2353,-1397,0
50209300,FA2021 ,12625,500,4050,2110,19285,0,0,0,20000,0,0,20000,13125,19285,-715,0
50209300,FA2022 ,13005,515,NULL,1140,14660,0,0,0,21500,0,0,21500,13520,14660,-6840,0
50209300,FA2023 ,7450,550,5440,1200,14640,0,0,0,25000,0,0,25000,8000,14640,-10360,0
50209300,SP2021 ,12625,500,4050,2110,19285,0,0,0,20000,0,0,20000,13125,19285,-715,0
50209300,SP2022 ,13005,515,NULL,1140,14660,0,0,0,21500,0,0,21500,13520,14660,-6840,0
50226673,FA2022 ,13005,515,4810,2690,21020,6000,6000,0,11582,11448,0,23030,2072,9572,-2010,-1
50226673,FA2023 ,13500,550,5150,2325,21525,6600,6000,600,3750,12197,0,15947,1853,9328,5578,-1
50226673,FA2024 ,14750,600,5030,1270,21650,6600,6000,600,3750,12198,0,15948,3152,9452,5702,-1
50226673,SP2022 ,13005,515,4810,2690,21020,6000,6000,0,11582,11447,0,23029,2073,9573,-2009,-1
50226673,SP2023 ,13500,550,5150,2325,21525,6600,6000,600,3750,12198,0,15948,1852,9327,5577,-1
50226673,SP2024 ,14750,600,5030,1270,21650,6600,6000,600,3750,12198,0,15948,3152,9452,5702,-1
50231239,FA2024 ,14750,600,4200,2450,22000,8500,8500,0,2750,9000,0,11750,6350,13000,10250,4376.66
50231239,SP2024 ,14750,600,4200,2450,22000,8500,8500,0,2750,9000,0,11750,6350,13000,10250,4376.66
50230487,FA2024 ,14750,600,4200,2450,22000,9000,9000,0,2750,9000,0,11750,6350,13000,10250,4668.32
50230487,SP2024 ,14750,600,4200,2450,22000,9000,9000,0,2750,9000,0,11750,6350,13000,10250,4668.32
50232755,FA2024 ,14750,600,4790,2450,22590,12790,11790,1000,NULL,20790,0,20790,-5440,1800,1800,3084.08
50232755,SP2024 ,14750,600,4790,2450,22590,7000,7000,0,NULL,7000,0,7000,8350,15590,15590,3084.08
50223596,FA2021 ,12625,500,4580,2110,19815,6450,6450,0,15222,7450,0,22672,5675,12365,-2857,0
50223596,FA2022 ,13005,515,3855,1140,18515,5950,5950,0,14736,5950,0,20686,7570,12565,-2171,0
50223596,FA2023 ,13500,550,4560,2325,20935,5950,5950,0,16713,5950,0,22663,8100,14985,-1728,0
50223596,FA2024 ,14750,600,NULL,1270,16620,4105,4105,0,16913,5698,0,22611,9652,10922,-5991,0
50223596,SP2021 ,12625,500,4580,2110,19815,6450,6450,0,15222,6450,0,21672,6675,13365,-1857,0
50223596,SP2022 ,13005,515,3855,1140,18515,5950,5950,0,14736,5950,0,20686,7570,12565,-2171,0
50223596,SP2023 ,13500,550,4560,1200,19810,5950,5950,0,16712,5950,0,22662,8100,13860,-2852,0
50225772,FA2022 ,13005,515,4810,2220,20550,9000,9000,0,0,10473,0,10473,3047,10077,10077,4588.37
50225772,SP2022 ,13005,515,4810,2220,20550,9000,9000,0,0,10472,0,10472,3048,10078,10078,4588.37
50204771,FA2022 ,13005,515,4610,NULL,18130,7175,7175,0,11070,7175,0,18245,6345,10955,-115,0
50204771,SP2021 ,12625,500,4270,NULL,17395,7175,7175,0,9750,7175,0,16925,5950,10220,470,0
50206605,FA2021 ,12625,500,4830,NULL,17955,15707,8500,7207,NULL,19455,0,19455,-6330,-1500,-1500,0
50206605,SP2021 ,12625,6350,6350,NULL,18975,19380,7500,11880,NULL,23687,0,23687,-4712,-4712,-4712,0
50211208,FA2021 ,12625,500,3740,1080,17945,1175,250,925,NULL,1675,0,1675,11450,16270,16270,0
50211208,FA2022 ,7170,257,NULL,NULL,7427,0,0,0,NULL,0,0,0,7427,7427,7427,0
50211208,SP2021 ,12625,500,3740,1080,17945,925,0,925,NULL,925,0,925,12200,17020,17020,0
50211208,SP2022 ,1860,NULL,NULL,NULL,1860,0,0,0,NULL,0,0,0,1860,1860,1860,0
50204602,FA2021 ,12625,500,NULL,NULL,13125,6925,4925,2000,NULL,7425,0,7425,5700,5700,5700,0
50204602,SP2021 ,12625,500,NULL,NULL,13125,4925,4925,0,NULL,4925,0,4925,8200,8200,8200,0
50221881,FA2021 ,12625,500,3740,2110,18975,5500,5500,0,14653,6500,0,21153,6625,12475,-2178,0
50221881,FA2022 ,13005,515,3855,2220,19595,5000,5000,0,3250,5000,0,8250,8520,14595,11345,0
50221881,FA2023 ,7450,550,4560,1200,13760,2759,2759,0,1283,2759,0,4042,5241,11001,9718,0
50221881,SP2021 ,12625,500,3740,2110,18975,5500,5500,0,14654,5500,0,20154,7625,13475,-1179,0
50232097,FA2024 ,14750,600,4200,2450,22000,6500,6500,0,13500,7500,0,21000,7850,14500,1000,0
50232097,SP2024 ,14750,600,4200,2450,22000,6500,6500,0,13500,6500,0,20000,8850,15500,2000,0
50211000,FA2021 ,12625,500,NULL,NULL,13125,0,0,0,NULL,0,0,0,13125,13125,13125,0
50211000,FA2022 ,13005,515,NULL,NULL,13520,0,0,0,NULL,0,0,0,13520,13520,13520,0
50211000,SP2021 ,6960,250,NULL,NULL,7210,0,0,0,NULL,0,0,0,7210,7210,7210,0
50211000,SP2022 ,13005,515,NULL,NULL,13520,0,0,0,NULL,0,0,0,13520,13520,13520,0
50230200,FA2023 ,13500,550,4000,2325,20375,9550,9550,0,13183,9550,0,22733,4500,10825,-2358,0
50230200,FA2024 ,14750,600,4790,2450,22590,9550,7000,2550,13435,9550,0,22985,5800,13040,-395,0
50230200,SP2023 ,13500,550,4000,2325,20375,9550,9550,0,10335,9550,0,19885,4500,10825,490,0
50230200,SP2024 ,14750,600,4790,2450,22590,9550,7000,2550,13371,9550,0,22921,5800,13040,-331,0
50232679,FA2024 ,14750,600,5410,2450,23210,9700,9700,0,11541,13398,0,24939,1952,9812,-1729,3992
50232679,SP2024 ,14750,600,5410,2450,23210,9700,9700,0,10666,13397,0,24063,1953,9813,-853,3992
50235030,FA2024 ,14750,600,NULL,NULL,15350,6478,6478,0,NULL,6478,0,6478,8872,8872,8872,0
50225048,SP2022 ,13005,515,4810,2220,20550,7500,7500,0,2750,7500,0,10250,6020,13050,10300,0
50203514,FA2021 ,12625,500,4830,1080,19035,6675,0,6675,13881,9748,0,23629,3377,9287,-4594,0
50203514,SP2021 ,12625,500,4830,1080,19035,6675,0,6675,12682,7747,0,20429,5378,11288,-1394,0
50210180,FA2021 ,19340,860,4600,2110,26050,14500,10000,4500,0,16000,0,16000,4200,10050,10050,0
50210180,SP2021 ,19340,860,860,NULL,20200,13000,8500,4500,0,13000,0,13000,7200,7200,7200,0
50226050,FA2022 ,13005,515,3855,2220,19595,7000,7000,0,9895,7000,0,16895,6520,12595,2700,212.85
50226050,FA2023 ,13500,6825,6825,NULL,20325,7000,7000,0,17250,7000,0,24250,13325,13325,-3925,212.85
50226050,FA2024 ,14750,600,4200,2450,22000,7000,7000,0,13750,7000,0,20750,8350,15000,1250,212.85
50226050,SP2022 ,13005,515,3855,2220,19595,7000,7000,0,9896,7000,0,16896,6520,12595,2699,212.85
50226050,SP2023 ,13500,550,4000,2325,20375,7000,7000,0,13750,7000,0,20750,7050,13375,-375,212.85
50226050,SP2024 ,14750,600,4200,2450,22000,7000,7000,0,13750,7000,0,20750,8350,15000,1250,212.85
50209820,FA2021 ,12625,500,NULL,1080,14205,325,0,325,8250,7298,0,15548,5827,6907,-1343,0
50209820,SP2021 ,12625,500,NULL,1080,14205,2325,2000,325,8250,7297,0,15547,5828,6908,-1342,0
50235928,SP2024 ,15000,7500,7500,NULL,22500,0,0,0,NULL,0,0,0,22500,22500,22500,0
50222177,FA2021 ,12625,500,4580,2110,19815,4500,4500,0,0,4500,0,4500,8625,15315,15315,0
50228427,FA2023 ,13500,550,4000,2325,20375,6500,6500,0,15493,6500,0,21993,7550,13875,-1618,-501
50228427,FA2024 ,14750,600,4200,2450,22000,6500,6500,0,16004,6500,0,22504,8850,15500,-504,-501
50228427,SP2023 ,13500,550,4000,2325,20375,6500,6500,0,14692,6500,0,21192,7550,13875,-817,-501
50228427,SP2024 ,14750,600,4200,2450,22000,6500,6500,0,16462,6500,0,22962,8850,15500,-962,-501
50215730,FA2021 ,12625,500,4050,2550,19725,8375,2162,6213,4750,9875,0,14625,3250,9850,5100,0
50215730,FA2022 ,13005,515,5080,1140,19740,8375,5000,3375,3750,8375,0,12125,5145,11365,7615,0
50215730,FA2023 ,13500,550,5440,1200,20690,10375,0,10375,3750,10375,0,14125,3675,10315,6565,0
50215730,SP2021 ,12625,500,4050,2550,19725,8375,2163,6212,4750,8375,0,13125,4750,11350,6600,0
50215730,SP2022 ,13005,515,5080,1140,19740,8375,5000,3375,3750,8375,0,12125,5145,11365,7615,0
50215048,FA2021 ,12625,500,4580,2110,19815,5875,5875,0,3250,7375,0,10625,5750,12440,9190,0
50215048,FA2022 ,13005,515,4810,2220,20550,5375,5375,0,3750,5375,0,9125,8145,15175,11425,0
50215048,FA2023 ,13500,550,5440,1200,20690,5375,5025,350,3750,5375,0,9125,8675,15315,11565,0
50215048,SP2021 ,12625,500,4580,2110,19815,5875,5875,0,3250,5875,0,9125,7250,13940,10690,0
50215048,SP2022 ,13005,515,4810,2220,20550,5375,5375,0,3750,5375,0,9125,8145,15175,11425,0
50235425,SP2024 ,14750,600,5410,2450,23210,6500,6500,0,16650,6500,0,23150,8850,16710,60,0
50231905,FA2024 ,14750,600,4790,2450,22590,7000,7000,0,17264,7000,0,24264,8350,15590,-1674,-2264
50231905,SP2024 ,14750,600,4790,2450,22590,9000,7000,2000,17264,9000,0,26264,6350,13590,-3674,-2264
50224751,FA2023 ,13500,550,5150,2325,21525,9000,9000,0,3250,10000,0,13250,4050,11525,8275,4372
50224751,FA2024 ,14750,600,6090,1270,22710,9500,9500,0,3750,11600,0,15350,3750,11110,7360,4372
50224751,SP2022 ,13005,515,4810,2220,20550,11000,9000,2000,2750,12200,0,14950,1320,8350,5600,4372
50224751,SP2023 ,13500,550,5150,2325,21525,9000,9000,0,3250,9000,0,12250,5050,12525,9275,4372
50224751,SP2024 ,14750,600,6090,1270,22710,9500,9500,0,3750,11600,0,15350,3750,11110,7360,4372
50211611,FA2021 ,12625,500,4270,1080,18475,6150,6150,0,0,7150,0,7150,5975,11325,11325,0
50211611,FA2022 ,13005,515,4810,2220,20550,6000,6000,0,NULL,6000,0,6000,7520,14550,14550,0
50211611,SP2022 ,13005,515,4810,2220,20550,6000,6000,0,NULL,6000,0,6000,7520,14550,14550,0
50228541,FA2023 ,13500,550,5150,2325,21525,8000,8000,0,15437,8000,0,23437,6050,13525,-1912,0
50228541,SP2023 ,13500,550,5150,2325,21525,8000,8000,0,15438,8000,0,23438,6050,13525,-1913,0
50211269,FA2021 ,12625,500,4830,1080,19035,7300,7300,0,10457,8800,0,19257,4325,10235,-222,0
50211269,FA2022 ,13005,515,4610,57.45,18187.45,7300,7300,0,12032,7300,0,19332,6220,10887.45,-1144.55,0
50211269,SP2021 ,12625,500,4830,1080,19035,7300,7300,0,10457,7300,0,17757,5825,11735,1278,0
50216644,FA2021 ,12625,500,4050,2110,19285,1425,1425,0,18912,2425,0,21337,10700,16860,-2052,0
50225704,FA2022 ,13005,515,4810,2220,20550,6750,6750,0,2750,6750,0,9500,6770,13800,11050,-130
50225704,FA2023 ,13500,550,5150,2325,21525,6500,6500,0,3250,6500,0,9750,7550,15025,11775,-130
50225704,FA2024 ,14750,7250,7250,NULL,22000,3450,3450,0,3750,3450,0,7200,18550,18550,14800,-130
50225704,SP2022 ,13005,515,4810,2220,20550,6500,6500,0,2750,6500,0,9250,7020,14050,11300,-130
50225704,SP2023 ,13500,550,5150,2325,21525,6500,6500,0,3250,6500,0,9750,7550,15025,11775,-130
50210248,FA2021 ,12625,6350,6350,NULL,18975,4963,3463,1500,10889,8036,0,18925,10939,10939,50,0
50210248,FA2022 ,13005,515,5420,1140,20080,9925,7425,2500,10750,9925,0,20675,3595,10155,-595,0
50210248,SP2021 ,12625,500,4830,1080,19035,8425,6925,1500,9628,9497,0,19125,3628,9538,-90,0
50210248,SP2022 ,13005,515,5420,1140,20080,9925,7425,2500,10750,9925,0,20675,3595,10155,-595,0
50121372,FA2021 ,19340,860,5690,1080,26110,13425,13425,0,3750,16811,0,20561,3389,9299,5549,0
50121372,SP2021 ,19340,860,860,NULL,20200,11925,11925,0,3750,13811,0,17561,6389,6389,2639,0
50222867,FA2021 ,12625,500,4580,2110,19815,6850,6850,0,2750,7850,0,10600,5275,11965,9215,0
50222867,FA2022 ,13005,515,4810,2220,20550,6350,4500,1850,3250,6350,0,9600,7170,14200,10950,0
50222867,FA2023 ,13500,550,4790,NULL,18840,6350,4500,1850,3750,6350,0,10100,7700,12490,8740,0
50222867,SP2021 ,12625,500,4580,2110,19815,6850,6850,0,2750,6850,0,9600,6275,12965,10215,0
50222867,SP2022 ,13005,515,4810,2220,20550,6350,4500,1850,3250,6350,0,9600,7170,14200,10950,0
50222867,SP2023 ,13500,550,4790,NULL,18840,6350,4500,1850,3750,6350,0,10100,7700,12490,8740,0
50223607,FA2021 ,12625,500,3740,2110,18975,13125,13125,0,NULL,13125,0,13125,0,5850,5850,0
50202822,FA2021 ,12625,500,3740,2110,18975,7425,0,7425,NULL,8925,0,8925,4200,10050,10050,0
50218254,FA2021 ,12625,500,3740,2110,18975,7425,7425,0,NULL,8925,0,8925,4200,10050,10050,0
50218254,SP2021 ,12625,500,3740,2110,18975,5925,5925,0,NULL,5925,0,5925,7200,13050,13050,0
50225222,FA2022 ,13005,515,4810,2690,21020,5000,5000,0,2750,5000,0,7750,8520,16020,13270,-3723.89
50225222,FA2023 ,13500,550,5150,2325,21525,5000,5000,0,3250,5000,0,8250,9050,16525,13275,-3723.89
50225222,FA2024 ,14750,600,5030,1270,21650,5000,5000,0,3750,5000,0,8750,10350,16650,12900,-3723.89
50225222,SP2022 ,13005,515,4810,2690,21020,5000,5000,0,2750,5000,0,7750,8520,16020,13270,-3723.89
50225222,SP2023 ,13500,550,5150,2325,21525,5000,5000,0,3250,5000,0,8250,9050,16525,13275,-3723.89
50225222,SP2024 ,14750,7250,7250,NULL,22000,5000,5000,0,3750,5000,0,8750,17000,17000,13250,-3723.89
50234728,FA2024 ,14750,600,6090,1270,22710,6500,6500,0,13,10198,0,10211,5152,12512,12499,6513.68
50222972,FA2021 ,15944,5556,5556,NULL,21500,0,0,0,NULL,0,0,0,21500,21500,21500,0
50210930,FA2021 ,12625,500,NULL,NULL,13125,1975,1975,0,14750,3475,0,18225,9650,9650,-5100,0
50210930,FA2022 ,13005,515,NULL,NULL,13520,1975,1975,0,15500,1975,0,17475,11545,11545,-3955,0
50210930,SP2021 ,12625,6350,6350,NULL,18975,1900,1900,0,15750,1900,0,17650,17075,17075,1325,0
50210930,SP2022 ,7170,257,NULL,NULL,7427,1089,1089,0,15500,1089,0,16589,6338,6338,-9162,0
50218215,FA2021 ,12625,500,4650,2110,19885,3925,3925,0,17177,4925,0,22102,8200,14960,-2217,0
50218215,FA2022 ,7170,257,NULL,NULL,7427,1337,1337,0,9310,1337,0,10647,6090,6090,-3220,0
50218215,SP2021 ,12625,500,4580,2110,19815,3925,3925,0,14365,3925,0,18290,9200,15890,1525,0
50228522,FA2023 ,13500,550,5150,2325,21525,9250,9250,0,2750,13023,0,15773,1027,8502,5752,5156.88
50228522,FA2024 ,18520,600,4200,2450,25770,9750,9750,0,3250,12738,0,15988,6382,13032,9782,5156.88
50228522,SP2023 ,13500,550,5150,2325,21525,9300,9300,0,2750,13072,0,15822,978,8453,5703,5156.88
50228522,SP2024 ,14750,600,4200,2450,22000,9450,9450,0,3250,12437,0,15687,2913,9563,6313,5156.88
50230325,FA2023 ,13500,550,5150,2745,21945,7000,7000,0,2750,7000,0,9750,7050,14945,12195,4355.65
50230325,FA2024 ,14750,600,5410,2450,23210,7000,6000,1000,3250,7385,0,10635,7965,15825,12575,4355.65
50230325,SP2023 ,13500,550,5150,2745,21945,7000,7000,0,2750,7000,0,9750,7050,14945,12195,4355.65
50230325,SP2024 ,14750,600,5410,2450,23210,7000,6000,1000,3250,7385,0,10635,7965,15825,12575,4355.65
50230022,FA2023 ,13500,550,4000,2325,20375,6500,6500,0,2750,11698,0,14448,2352,8677,5927,0
50230022,FA2024 ,14750,600,4200,2450,22000,6500,6500,0,3250,11698,0,14948,3652,10302,7052,0
50230022,SP2023 ,13500,550,4000,2325,20375,6500,6500,0,2750,11697,0,14447,2353,8678,5928,0
50230022,SP2024 ,14750,600,4200,2450,22000,6500,6500,0,3250,11697,0,14947,3653,10303,7053,0
50228126,FA2023 ,13500,550,5150,2325,21525,8000,8000,0,2750,8000,0,10750,6050,13525,10775,5172.66
50228126,FA2024 ,14750,600,4200,2450,22000,8000,8000,0,NULL,8000,0,8000,7350,14000,14000,5172.66
50228126,SP2023 ,13500,550,5150,2325,21525,8000,8000,0,2750,8000,0,10750,6050,13525,10775,5172.66
50228126,SP2024 ,14750,600,4200,2450,22000,8000,8000,0,NULL,8000,0,8000,7350,14000,14000,5172.66
50120110,FA2024 ,14750,600,4790,2450,22590,11550,9550,2000,2750,15113,0,17863,237,7477,4727,0
50120110,SP2024 ,14750,600,4790,2450,22590,9550,9550,0,2750,13112,0,15862,2238,9478,6728,0
50210066,FA2021 ,12625,500,3740,2110,18975,3775,3775,0,3250,9423,0,12673,3702,9552,6302,0
50224693,FA2022 ,13005,515,3855,2220,19595,7500,7500,0,2750,7800,0,10550,5720,11795,9045,0
50229396,FA2023 ,13500,550,5150,2325,21525,7500,7500,0,2750,7500,0,10250,6550,14025,11275,5644
50229396,FA2024 ,14750,600,5410,2450,23210,7500,7500,0,NULL,7500,0,7500,7850,15710,15710,5644
50229396,SP2023 ,13500,550,5150,2325,21525,7500,7500,0,2750,7500,0,10250,6550,14025,11275,5644
50229396,SP2024 ,14750,600,5410,2450,23210,7500,7500,0,NULL,7500,0,7500,7850,15710,15710,5644
50216672,FA2021 ,12625,500,NULL,NULL,13125,4485,4485,0,NULL,4485,0,4485,8640,8640,8640,0
50216672,FA2022 ,7170,257,NULL,NULL,7427,2282,2282,0,NULL,2282,0,2282,5145,5145,5145,0
50216672,SP2021 ,12625,500,NULL,NULL,13125,4485,4485,0,NULL,4485,0,4485,8640,8640,8640,0
50217737,FA2021 ,12625,500,4050,2110,19285,2425,2425,0,NULL,2925,0,2925,10200,16360,16360,0
50217737,FA2022 ,13005,515,4810,2220,20550,2425,2425,0,NULL,2425,0,2425,11095,18125,18125,0
50217737,FA2023 ,13500,550,4000,1200,19250,2425,2425,0,0,2425,0,2425,11625,16825,16825,0
50217737,SP2022 ,13005,515,4810,2220,20550,2425,2425,0,NULL,2425,0,2425,11095,18125,18125,0
50217737,SP2023 ,13500,550,4000,1200,19250,2425,2425,0,0,2425,0,2425,11625,16825,16825,0
50221626,FA2021 ,12625,500,4270,NULL,17395,3925,3925,0,1403,5425,0,6828,7700,11970,10567,0
50221626,FA2022 ,13005,515,NULL,NULL,13520,2425,2425,0,0,2425,0,2425,11095,11095,11095,0
50221626,FA2023 ,13500,550,NULL,NULL,14050,2425,0,2425,6250,2425,0,8675,11625,11625,5375,0
50221626,SP2022 ,7170,257,NULL,NULL,7427,1337,1337,0,0,1337,0,1337,6090,6090,6090,0
50221626,SP2023 ,13500,550,NULL,NULL,14050,2425,0,2425,6250,2425,0,8675,11625,11625,5375,0
50233638,FA2024 ,14750,600,4790,2900,23040,10750,10750,0,13660,10750,0,24410,4600,12290,-1370,0
50233638,SP2024 ,15720,600,4790,2680,23790,10750,10750,0,13888,10750,0,24638,5570,13040,-848,0
50234280,FA2024 ,14750,600,4200,1270,20820,7000,7000,0,NULL,7000,0,7000,8350,13820,13820,0
50234280,SP2024 ,14750,600,4200,1270,20820,7000,7000,0,NULL,7000,0,7000,8350,13820,13820,0
50217341,FA2021 ,12625,500,3740,2110,18975,7675,7675,0,3250,14748,0,17998,-1623,4227,977,0
50217341,FA2022 ,13005,515,4610,1140,19270,8175,8175,0,3750,13798,0,17548,-278,5472,1722,0
50217341,FA2023 ,13500,550,4790,NULL,18840,7675,7675,0,3750,13048,0,16798,1002,5792,2042,0
50217341,SP2021 ,12625,500,3740,2110,18975,7675,7675,0,3250,12747,0,15997,378,6228,2978,0
50217341,SP2022 ,13005,515,4610,1140,19270,8175,8175,0,3750,13797,0,17547,-277,5473,1723,0
50217341,SP2023 ,13500,550,4790,NULL,18840,7675,7675,0,3750,13047,0,16797,1003,5793,2043,0
50199989,FA2021 ,12625,500,3740,NULL,16865,3375,0,3375,0,12375,0,12375,750,4490,4490,0
50199989,SP2021 ,6960,500,3740,NULL,11200,1861,0,1861,0,1861,0,1861,5599,9339,9339,0
50216800,FA2021 ,12625,500,3740,2110,18975,3175,0,3175,3250,4175,0,7425,8950,14800,11550,0
50216800,FA2022 ,13005,515,3855,2690,20065,3175,3175,0,3750,3175,0,6925,10345,16890,13140,0
50216800,FA2023 ,13500,550,4990,2325,21365,3175,3175,0,3750,3175,0,6925,10875,18190,14440,0
50216800,SP2021 ,12625,500,3740,2110,18975,3175,0,3175,3250,3175,0,6425,9950,15800,12550,0
50216800,SP2022 ,13005,515,3855,2690,20065,3175,3175,0,3750,3175,0,6925,10345,16890,13140,0
50216800,SP2023 ,13500,6825,6825,NULL,20325,3175,3175,0,3750,3175,0,6925,17150,17150,13400,0
50217829,FA2021 ,12625,500,3740,2550,19415,5750,5750,0,0,5750,0,5750,7375,13665,13665,73
50217829,FA2022 ,7170,515,3855,2690,14230,3032,3032,0,3250,3032,0,6282,4653,11198,7948,73
50217829,FA2024 ,14750,600,5410,2450,23210,5500,5500,0,3750,5500,0,9250,9850,17710,13960,73
50217829,SP2021 ,12625,500,3740,2550,19415,5750,5750,0,0,5750,0,5750,7375,13665,13665,73
50217829,SP2022 ,13005,515,3855,2690,20065,5500,5500,0,3250,5500,0,8750,8020,14565,11315,73
50217829,SP2023 ,13500,550,5150,2325,21525,5500,5500,0,3750,5500,0,9250,8550,16025,12275,73
50217829,SP2024 ,14750,600,5410,2450,23210,5500,5500,0,3750,5500,0,9250,9850,17710,13960,73
50229706,FA2023 ,13500,550,4000,2745,20795,8250,8250,0,0,8250,0,8250,5800,12545,12545,60
50229706,FA2024 ,14750,600,4200,2450,22000,8250,6000,2250,15258,8250,0,23508,7100,13750,-1508,60
50229706,SP2023 ,13500,550,4000,2745,20795,8250,8250,0,0,8250,0,8250,5800,12545,12545,60
50229706,SP2024 ,14750,600,4200,2450,22000,8250,6000,2250,15258,8250,0,23508,7100,13750,-1508,60
50209348,FA2021 ,12625,500,4270,NULL,17395,8925,6925,2000,3750,10425,0,14175,2700,6970,3220,0
50209348,FA2022 ,13005,515,4610,NULL,18130,8925,6925,2000,3750,8925,0,12675,4595,9205,5455,0
50209348,SP2021 ,12625,500,4270,NULL,17395,6925,6925,0,3750,6925,0,10675,6200,10470,6720,0
50209348,SP2022 ,13005,515,4610,NULL,18130,6925,6925,0,3750,6925,0,10675,6595,11205,7455,0
50221575,FA2021 ,12625,500,3740,2110,18975,8500,6500,2000,2750,9000,0,11750,4125,9975,7225,30
50221575,FA2022 ,13005,515,3855,2220,19595,8000,6000,2000,3250,8000,0,11250,5520,11595,8345,30
50221575,FA2023 ,13500,550,5440,NULL,19490,8000,6000,2000,3750,8000,0,11750,6050,11490,7740,30
50221575,FA2024 ,14750,600,5030,NULL,20380,7500,5500,2000,3750,7500,0,11250,7850,12880,9130,30
50221575,SP2021 ,12625,500,3740,2110,18975,6500,6500,0,2750,6500,0,9250,6625,12475,9725,30
50221575,SP2022 ,13005,515,3855,2220,19595,6000,6000,0,9250,6000,0,15250,7520,13595,4345,30
50221575,SP2023 ,13500,6825,6825,NULL,20325,1800,1800,0,16750,1800,0,18550,18525,18525,1775,30
50221575,SP2024 ,14750,600,5030,NULL,20380,6000,6000,0,11750,6000,0,17750,9350,14380,2630,30
50227189,FA2023 ,13500,550,4000,2325,20375,9000,5000,4000,NULL,9000,0,9000,5050,11375,11375,678
50227189,FA2024 ,14750,600,4200,1270,20820,9000,5000,4000,NULL,9000,0,9000,6350,11820,11820,678
50227189,SP2022 ,13005,515,4380,2220,20120,7000,7000,0,NULL,7000,0,7000,6520,13120,13120,678
50227189,SP2023 ,13500,550,4000,2325,20375,9000,5000,4000,NULL,9000,0,9000,5050,11375,11375,678
50221869,FA2021 ,12625,500,3740,2110,18975,0,0,0,2750,14625,12625,17375,-1500,4350,1600,1156.67
50221869,FA2022 ,13005,515,3855,2220,19595,0,0,0,NULL,16860,13005,16860,-3340,2735,2735,1156.67
50221869,FA2023 ,13500,550,4000,2325,20375,0,0,0,NULL,17500,13500,17500,-3450,2875,2875,1156.67
50221869,FA2024 ,14750,600,5030,NULL,20380,0,0,0,NULL,17450,14750,17450,-2100,2930,2930,1156.67
50221869,SP2021 ,12625,500,3740,2110,18975,0,0,0,2750,12625,12625,15375,500,6350,3600,1156.67
50221869,SP2022 ,13005,515,3855,2220,19595,0,0,0,NULL,16860,13005,16860,-3340,2735,2735,1156.67
50221869,SP2023 ,13500,550,4000,2325,20375,0,0,0,NULL,17500,13500,17500,-3450,2875,2875,1156.67
50221869,SP2024 ,14750,600,5030,NULL,20380,0,0,0,NULL,17450,14750,17450,-2100,2930,2930,1156.67
50204413,FA2021 ,12625,500,4270,NULL,17395,5325,4325,1000,10750,7825,0,18575,5300,9570,-1180,0
50204413,SP2021 ,12625,500,4270,NULL,17395,4325,4325,0,10750,6325,0,17075,6800,11070,320,0
50221783,FA2021 ,12625,500,4580,2110,19815,10300,9300,1000,11000,11300,0,22300,1825,8515,-2485,-3521
50221783,FA2022 ,13005,515,4260,2220,20000,9550,8550,1000,10600,9550,0,20150,3970,10450,-150,-3521
50221783,FA2023 ,13500,550,5440,1200,20690,9550,6000,3550,13000,9550,0,22550,4500,11140,-1860,-3521
50221783,FA2024 ,14750,600,5720,1270,22340,9550,6000,3550,13000,9550,0,22550,5800,12790,-210,-3521
50221783,SP2021 ,12625,500,4580,2110,19815,9300,9300,0,11000,9300,0,20300,3825,10515,-485,-3521
50221783,SP2022 ,13005,515,4260,2220,20000,8550,8550,0,10600,8550,0,19150,4970,11450,850,-3521
50221783,SP2023 ,13500,550,5440,1200,20690,8550,6000,2550,13000,8550,0,21550,5500,12140,-860,-3521
50221783,SP2024 ,6090,600,5720,1270,13680,3530,2477,1053,13000,3530,0,16530,3160,10150,-2850,-3521
50233277,FA2024 ,14750,600,5410,2450,23210,6000,6000,0,2750,9698,0,12448,5652,13512,10762,11374.16
50233277,SP2024 ,14750,600,5410,2450,23210,6000,6000,0,2750,9697,0,12447,5653,13513,10763,11374.16
50214315,FA2021 ,12625,500,3740,2110,18975,3425,3425,0,6250,11423,0,17673,1702,7552,1302,1580
50214315,FA2022 ,13005,515,3855,1140,18515,3425,3425,0,6250,9523,0,15773,3997,8992,2742,1580
50214315,SP2021 ,12625,500,3740,2110,18975,3425,3425,0,6250,10482,0,16732,2643,8493,2243,1580
50214315,SP2022 ,7170,515,3855,1140,12680,2577,2577,0,6250,5162,0,11412,2523,7518,1268,1580
50222543,FA2021 ,12625,500,4580,2110,19815,5000,5000,0,0,10848,0,10848,2277,8967,8967,6925.53
50230608,FA2023 ,13500,550,NULL,NULL,14050,4140,4140,0,2750,9038,0,11788,5012,5012,2262,0
50220900,FA2021 ,12625,500,3740,2550,19415,7600,7600,0,2750,8600,0,11350,4525,10815,8065,-200
50220900,FA2022 ,13005,515,3855,2220,19595,7100,7100,0,3250,7100,0,10350,6420,12495,9245,-200
50220900,FA2023 ,13500,550,4000,2325,20375,7100,7100,0,3750,8173,0,11923,5877,12202,8452,-200
50220900,SP2021 ,12625,500,3740,2110,18975,7600,7600,0,2750,7600,0,10350,5525,11375,8625,-200
50220900,SP2022 ,13005,515,3855,2220,19595,7100,7100,0,3250,7100,0,10350,6420,12495,9245,-200
50220900,SP2023 ,13500,550,4000,2325,20375,7100,7100,0,3750,8172,0,11922,5878,12203,8453,-200
50228240,FA2023 ,13500,550,4000,2325,20375,8700,8700,0,2750,8700,0,11450,5350,11675,8925,3696
50228240,FA2024 ,14750,600,4200,2450,22000,8700,6500,2200,2750,8700,0,11450,6650,13300,10550,3696
50228240,SP2023 ,13500,550,4000,2325,20375,8700,8700,0,2750,8700,0,11450,5350,11675,8925,3696
50228240,SP2024 ,14750,600,4200,2450,22000,8700,6500,2200,2750,8700,0,11450,6650,13300,10550,3696
50228823,FA2023 ,13500,550,5150,2325,21525,6000,6000,0,17557,6000,0,23557,8050,15525,-2032,0
50228823,SP2023 ,13500,550,5150,2325,21525,6000,6000,0,17557,6000,0,23557,8050,15525,-2032,0
50227717,FA2023 ,13500,550,NULL,NULL,14050,6485,4485,2000,3750,6485,0,10235,7565,7565,3815,4765.5
50227717,FA2024 ,14750,600,5030,NULL,20380,8500,6500,2000,3750,8500,0,12250,6850,11880,8130,4765.5
50227717,SP2022 ,13005,515,NULL,NULL,13520,5485,4485,1000,3250,5485,0,8735,8035,8035,4785,4765.5
50227717,SP2023 ,13500,550,NULL,NULL,14050,4485,4485,0,3750,4485,0,8235,9565,9565,5815,4765.5
50227717,SP2024 ,14750,600,5030,NULL,20380,6500,6500,0,3750,7500,0,11250,7850,12880,9130,4765.5
50204613,FA2021 ,12625,500,4270,1080,18475,2125,0,2125,13147,3625,0,16772,9500,14850,1703,0
50204613,SP2021 ,12625,500,4270,1080,18475,2125,0,2125,13147,2125,0,15272,11000,16350,3203,0
50222069,FA2021 ,12625,500,4580,2110,19815,7000,5000,2000,14096,9000,0,23096,4125,10815,-3281,-2699
50222069,FA2022 ,13005,515,4810,2220,20550,5500,4500,1000,11081,10310,0,21391,3210,10240,-841,-2699
50222069,FA2023 ,13500,550,5150,2325,21525,4500,4500,0,3750,9650,0,13400,4400,11875,8125,-2699
50222069,FA2024 ,14750,600,5030,NULL,20380,10000,1000,9000,11522,12100,0,23622,3250,8280,-3242,-2699
50222069,SP2021 ,12625,500,4580,2110,19815,5000,5000,0,14463,5000,0,19463,8125,14815,352,-2699
50222069,SP2022 ,13005,515,4810,2220,20550,4500,4500,0,11081,9310,0,20391,4210,11240,159,-2699
50222069,SP2023 ,13500,550,5150,2325,21525,11500,9000,2500,3750,17150,0,20900,-3100,4375,625,-2699
50222069,SP2024 ,14750,600,5030,NULL,20380,10000,1000,9000,11522,12100,0,23622,3250,8280,-3242,-2699
50226873,FA2023 ,13500,550,5150,2325,21525,6000,6000,0,0,6000,0,6000,8050,15525,15525,0
50226873,FA2024 ,14750,600,5410,2450,23210,6000,6000,0,NULL,6000,0,6000,9350,17210,17210,0
50226873,SP2023 ,13500,550,5150,2325,21525,6000,6000,0,0,6000,0,6000,8050,15525,15525,0
50226873,SP2024 ,14750,600,5410,2450,23210,6000,6000,0,NULL,6000,0,6000,9350,17210,17210,0
50231966,SP2023 ,14500,7000,7000,NULL,21500,0,0,0,NULL,0,0,0,21500,21500,21500,0
50221461,FA2021 ,12625,500,4580,2110,19815,7250,7250,0,2750,10010,0,12760,3115,9805,7055,3697
50221461,FA2022 ,13005,515,4810,2220,20550,6500,6500,0,3250,6500,0,9750,7020,14050,10800,3697
50221461,FA2023 ,13500,550,5440,1200,20690,7750,6500,1250,3750,7750,0,11500,6300,12940,9190,3697
50221461,FA2024 ,14750,600,5030,1270,21650,6500,6500,0,3750,6500,0,10250,8850,15150,11400,3697
50221461,SP2021 ,12625,500,4580,2110,19815,7250,7250,0,2750,11750,0,14500,1375,8065,5315,3697
50221461,SP2022 ,13005,515,4810,2220,20550,6500,6500,0,3250,6500,0,9750,7020,14050,10800,3697
50221461,SP2023 ,13500,550,5440,1200,20690,7750,6500,1250,3750,7750,0,11500,6300,12940,9190,3697
50221461,SP2024 ,14750,600,5030,NULL,20380,6500,6500,0,3750,6500,0,10250,8850,13880,10130,3697
50229192,SP2022 ,7170,515,4260,2220,14165,2205,2205,0,NULL,2205,0,2205,5480,11960,11960,0
50231003,FA2024 ,14750,600,4790,2450,22590,6500,6500,0,2750,6500,0,9250,8850,16090,13340,0
50231003,SP2024 ,14750,600,4790,2450,22590,6500,6500,0,2750,6500,0,9250,8850,16090,13340,0
50221432,FA2021 ,12625,500,4580,2110,19815,5500,5500,0,0,6500,0,6500,6625,13315,13315,0
50221432,SP2021 ,12625,500,4580,2110,19815,5500,5500,0,0,5500,0,5500,7625,14315,14315,0
50225479,FA2022 ,13005,515,NULL,NULL,13520,3795,3795,0,2750,3795,0,6545,9725,9725,6975,0
50225479,FA2023 ,13500,550,NULL,NULL,14050,3795,3795,0,NULL,3795,0,3795,10255,10255,10255,0
50225479,FA2024 ,6090,300,NULL,NULL,6390,1463,1463,0,NULL,1463,0,1463,4927,4927,4927,0
50225479,SP2022 ,13005,515,NULL,NULL,13520,3795,3795,0,2750,3795,0,6545,9725,9725,6975,0
50225479,SP2023 ,13500,550,NULL,NULL,14050,3795,3795,0,NULL,3795,0,3795,10255,10255,10255,0
50225479,SP2024 ,14750,600,NULL,NULL,15350,3795,3795,0,NULL,3795,0,3795,11555,11555,11555,0
50225161,FA2022 ,13005,515,3855,2220,19595,7450,7450,0,2750,10873,0,13623,2647,8722,5972,2490.66
50225161,FA2023 ,13500,550,4000,2325,20375,10200,8250,1950,3250,12973,0,16223,1077,7402,4152,2490.66
50225161,FA2024 ,14750,600,5030,1270,21650,8700,6750,1950,3750,14298,0,18048,1052,7352,3602,2490.66
50225161,SP2022 ,13005,515,3855,2220,19595,7450,7450,0,2750,10872,0,13622,2648,8723,5973,2490.66
50225161,SP2023 ,13500,550,4000,2325,20375,10200,8250,1950,3250,12972,0,16222,1078,7403,4153,2490.66
50225161,SP2024 ,14750,600,5030,1270,21650,8700,6750,1950,3750,14298,0,18048,1052,7352,3602,2490.66
50232810,FA2024 ,14750,600,5410,2450,23210,8100,7150,950,2750,13955,0,16705,1395,9255,6505,3227
50232810,SP2024 ,14750,600,5410,2680,23440,8100,7150,950,2750,13955,0,16705,1395,9485,6735,3227
50226217,FA2022 ,13005,515,4260,2220,20000,6250,6250,0,NULL,6250,0,6250,7270,13750,13750,0
50226217,SP2022 ,13005,515,4260,2220,20000,6250,6250,0,NULL,6250,0,6250,7270,13750,13750,0
50218866,FA2021 ,12625,500,4580,2550,20255,6925,6925,0,NULL,8425,0,8425,4700,11830,11830,-50
50218866,FA2022 ,13005,515,5080,1140,19740,6925,6925,0,NULL,6925,0,6925,6595,12815,12815,-50
50218866,FA2023 ,13500,550,5150,2745,21945,6925,6925,0,NULL,6925,0,6925,7125,15020,15020,-50
50218866,SP2021 ,12625,500,4580,2550,20255,6925,6925,0,NULL,6925,0,6925,6200,13330,13330,-50
50218866,SP2022 ,13005,515,5080,1140,19740,6925,6925,0,NULL,6925,0,6925,6595,12815,12815,-50
50218866,SP2023 ,13500,550,5150,2745,21945,6925,6925,0,NULL,6925,0,6925,7125,15020,15020,-50
50225305,FA2022 ,13005,515,3855,2690,20065,6500,6500,0,2750,6500,0,9250,7020,13565,10815,212
50225305,FA2023 ,13500,550,4000,2745,20795,6500,6500,0,3250,6500,0,9750,7550,14295,11045,212
50225305,FA2024 ,14750,600,5720,1270,22340,7000,7000,0,2750,7000,0,9750,8350,15340,12590,212
50225305,SP2022 ,13005,515,3855,2690,20065,6500,6500,0,2750,6500,0,9250,7020,13565,10815,212
50225305,SP2023 ,13500,550,4000,2745,20795,6500,6500,0,3250,6500,0,9750,7550,14295,11045,212
50225305,SP2024 ,14750,600,5720,NULL,21070,7000,7000,0,2750,7000,0,9750,8350,14070,11320,212
50232071,FA2024 ,14750,600,4200,2450,22000,6500,6500,0,2750,6500,0,9250,8850,15500,12750,3585.68
50232071,SP2024 ,14750,600,4200,2450,22000,6500,6500,0,2750,6500,0,9250,8850,15500,12750,3585.68
50212080,FA2021 ,12625,500,4580,2110,19815,4425,4425,0,6250,15373,0,21623,-2248,4442,-1808,0
50212080,SP2021 ,12625,500,4580,2110,19815,4425,4425,0,6250,14432,0,20682,-1307,5383,-867,0
50228149,FA2023 ,13500,550,4560,2745,21355,5000,5000,0,20245,5000,0,25245,9050,16355,-3890,-0.56
50228149,FA2024 ,14750,600,4790,2450,22590,5000,5000,0,22011,5000,0,27011,10350,17590,-4421,-0.56
50228149,SP2022 ,13005,515,4260,2690,20470,5000,5000,0,17587,5000,0,22587,8520,15470,-2117,-0.56
50228149,SP2023 ,13500,550,4560,2325,20935,5000,5000,0,14491,5000,0,19491,9050,15935,1444,-0.56
50228149,SP2024 ,14750,600,4790,2450,22590,5000,5000,0,19413,5000,0,24413,10350,17590,-1823,-0.56
50212782,FA2021 ,12625,500,3740,1080,17945,0,0,0,3750,14495,12625,18245,-1370,3450,-300,0
50212782,FA2022 ,13005,515,3855,1140,18515,0,0,0,5250,13005,13005,18255,515,5510,260,0
50212782,SP2021 ,12625,500,3740,1080,17945,0,0,0,3750,14495,12625,18245,-1370,3450,-300,0
50212782,SP2022 ,13005,515,3855,NULL,17375,0,0,0,5250,13005,13005,18255,515,4370,-880,0
50128089,FA2021 ,12625,500,4830,NULL,17955,0,0,0,3750,17618,12625,21368,-4493,337,-3413,0
50128089,SP2021 ,12625,500,4830,NULL,17955,0,0,0,3750,15617,12625,19367,-2492,2338,-1412,0
50214317,FA2021 ,12625,500,4580,2110,19815,4775,4775,0,3750,14633,0,18383,-1508,5182,1432,0
50214317,SP2021 ,12625,500,4580,2110,19815,4775,4775,0,3750,12634,0,16384,491,7181,3431,0
50217623,FA2021 ,12625,500,4580,2110,19815,6553,6553,0,9743,9876,0,19619,3249,9939,196,10965
50217623,SP2021 ,12625,500,4580,2110,19815,6552,6552,0,9744,7874,0,17618,5251,11941,2197,10965
50217623,SP2022 ,3580,NULL,4810,2220,10610,6552,6552,0,3250,6952,0,10202,-3372,3658,408,10965
50228796,FA2023 ,13500,550,5150,2325,21525,7000,7000,0,NULL,7000,0,7000,7050,14525,14525,12
50228796,FA2024 ,14750,600,5410,2450,23210,7000,7000,0,NULL,7000,0,7000,8350,16210,16210,12
50228796,SP2023 ,13500,550,5150,2325,21525,7000,7000,0,NULL,7000,0,7000,7050,14525,14525,12
50228796,SP2024 ,14750,600,5410,2450,23210,7000,7000,0,NULL,7000,0,7000,8350,16210,16210,12
50222726,FA2021 ,12625,500,4580,2110,19815,5500,5500,0,2750,8100,0,10850,5025,11715,8965,0
50222726,FA2022 ,13005,515,3855,2220,19595,5000,5000,0,3250,5000,0,8250,8520,14595,11345,0
50222726,FA2023 ,13500,550,4000,2325,20375,5000,5000,0,3750,5000,0,8750,9050,15375,11625,0
50222726,FA2024 ,14750,600,4200,2450,22000,5000,5000,0,3750,6500,0,10250,8850,15500,11750,0
50222726,SP2021 ,12625,500,4580,2110,19815,5500,5500,0,2750,5500,0,8250,7625,14315,11565,0
50222726,SP2022 ,13005,515,3855,2220,19595,5000,5000,0,3250,5000,0,8250,8520,14595,11345,0
50222726,SP2023 ,13500,550,4000,2325,20375,5000,5000,0,3750,5000,0,8750,9050,15375,11625,0
50222726,SP2024 ,14750,600,4200,2450,22000,5000,5000,0,3750,5000,0,8750,10350,17000,13250,0
50225923,FA2022 ,13005,515,4810,2220,20550,9750,7750,2000,0,19042,0,19042,-5522,1508,1508,0
50225923,FA2023 ,13500,550,5150,2325,21525,11250,8000,3250,3250,16875,0,20125,-2825,4650,1400,0
50225923,FA2024 ,14750,600,5410,2450,23210,12000,500,11500,3750,16375,0,20125,-1025,6835,3085,0
50225923,SP2022 ,13005,515,4810,2220,20550,7750,7750,0,2750,13375,0,16125,145,7175,4425,0
50225923,SP2023 ,13500,550,5150,2325,21525,9250,8000,1250,3250,14875,0,18125,-825,6650,3400,0
50225923,SP2024 ,14750,600,5410,2450,23210,10000,500,9500,3750,14375,0,18125,975,8835,5085,0
50221406,FA2021 ,12625,500,4050,2110,19285,9000,9000,0,0,17373,0,17373,-4248,1912,1912,350
50221406,FA2022 ,13005,515,4260,2220,20000,8250,8250,0,3250,13250,0,16500,270,6750,3500,350
50221406,FA2023 ,13500,550,5440,1200,20690,8750,6750,2000,3750,13750,0,17500,300,6940,3190,350
50221406,FA2024 ,14750,600,5720,1270,22340,9250,6750,2500,2750,13750,0,16500,1600,8590,5840,350
50221406,SP2021 ,12625,500,4050,2110,19285,9000,9000,0,1750,12972,0,14722,153,6313,4563,350
50221406,SP2022 ,13005,515,4260,2220,20000,8250,8250,0,3250,8250,0,11500,5270,11750,8500,350
50221406,SP2023 ,13500,6825,6825,NULL,20325,2000,1500,500,3750,2000,0,5750,18325,18325,14575,350
50221406,SP2024 ,14750,600,5720,NULL,21070,9250,6750,2500,2750,9250,0,12000,6100,11820,9070,350
50229893,FA2023 ,13500,550,5150,2745,21945,7000,7000,0,894,7000,0,7894,7050,14945,14051,0
50222832,FA2021 ,12625,500,3740,2110,18975,10600,8600,2000,2750,12850,0,15600,275,6125,3375,4684
50222832,FA2022 ,13005,515,NULL,NULL,13520,7201,5201,2000,3250,8451,0,11701,5069,5069,1819,4684
50222832,FA2023 ,13500,550,NULL,NULL,14050,8451,6451,2000,3750,8451,0,12201,5599,5599,1849,4684
50222832,FA2024 ,14750,600,NULL,NULL,15350,8451,5101,3350,3750,8451,0,12201,6899,6899,3149,4684
50222832,SP2021 ,12625,500,3740,2110,18975,8600,8600,0,2750,9850,0,12600,3275,9125,6375,4684
50222832,SP2022 ,13005,515,NULL,NULL,13520,5202,5202,0,3250,6452,0,9702,7068,7068,3818,4684
50222832,SP2023 ,13500,550,NULL,NULL,14050,6452,6452,0,3750,6452,0,10202,7598,7598,3848,4684
50222832,SP2024 ,14750,600,NULL,NULL,15350,6452,5102,1350,3750,6452,0,10202,8898,8898,5148,4684
50229746,FA2023 ,13500,550,4000,2325,20375,6500,6500,0,2750,6500,0,9250,7550,13875,11125,0
50229746,SP2023 ,13500,550,4000,2325,20375,6500,6500,0,2750,6500,0,9250,7550,13875,11125,0
50204607,FA2021 ,12625,500,NULL,NULL,13125,0,0,0,NULL,0,0,0,13125,13125,13125,0
50204607,FA2022 ,13005,515,NULL,1140,14660,0,0,0,NULL,0,0,0,13520,14660,14660,0
50204607,FA2023 ,7450,275,NULL,NULL,7725,0,0,0,NULL,0,0,0,7725,7725,7725,0
50204607,SP2021 ,12625,500,NULL,NULL,13125,0,0,0,NULL,0,0,0,13125,13125,13125,0
50204607,SP2022 ,13005,515,NULL,1140,14660,0,0,0,NULL,0,0,0,13520,14660,14660,0
50209627,FA2021 ,12625,500,4580,2110,19815,7525,7525,0,3750,9775,0,13525,3350,10040,6290,0
50209627,FA2022 ,13005,515,NULL,NULL,13520,6025,4675,1350,3750,6775,0,10525,6745,6745,2995,0
50209627,SP2021 ,12625,500,4580,2110,19815,7525,7525,0,3750,8275,0,12025,4850,11540,7790,0
50209627,SP2022 ,5360,257,NULL,NULL,5617,2483,1927,556,0,3233,0,3233,2384,2384,2384,0
50221462,FA2021 ,12625,500,4580,2110,19815,8650,8650,0,2750,10750,0,13500,2375,9065,6315,0
50221462,FA2022 ,13005,515,4260,2220,20000,8150,8150,0,3250,9250,0,12500,4270,10750,7500,0
50221462,FA2023 ,13500,550,NULL,NULL,14050,5623,3223,2400,3000,8946,0,11946,5104,5104,2104,0
50221462,FA2024 ,14750,600,NULL,NULL,15350,5623,3223,2400,3750,6723,0,10473,8627,8627,4877,0
50221462,SP2021 ,12625,500,4580,2110,19815,8650,8650,0,2750,9750,0,12500,3375,10065,7315,0
50221462,SP2022 ,13005,515,4260,2220,20000,8150,8150,0,3250,9250,0,12500,4270,10750,7500,0
50221462,SP2023 ,13500,550,NULL,NULL,14050,5624,3224,2400,3000,8946,0,11946,5104,5104,2104,0
50221462,SP2024 ,14750,600,NULL,NULL,15350,5624,3224,2400,3750,6724,0,10474,8626,8626,4876,0
50231817,FA2024 ,14750,600,4200,2450,22000,9950,9950,0,2750,13060,0,15810,2290,8940,6190,0
50231817,SP2024 ,14750,600,4200,2450,22000,9950,9950,0,2750,13060,0,15810,2290,8940,6190,0
50231906,FA2024 ,14750,600,4790,2450,22590,8000,8000,0,2750,8000,0,10750,7350,14590,11840,0
50231906,SP2024 ,14750,600,4790,2450,22590,8000,8000,0,2750,8000,0,10750,7350,14590,11840,0
50228471,FA2023 ,13500,550,5150,2745,21945,7500,0,7500,2750,7500,0,10250,6550,14445,11695,0
50228471,FA2024 ,14750,600,5410,2450,23210,7500,0,7500,3250,12910,0,16160,2440,10300,7050,0
50228471,SP2023 ,13500,550,5150,2325,21525,7500,0,7500,2750,7500,0,10250,6550,14025,11275,0
50228471,SP2024 ,14750,600,5410,2450,23210,7500,0,7500,10333,12910,0,23243,2440,10300,-33,0
50228543,FA2023 ,13500,550,4000,2325,20375,10500,8500,2000,2750,10500,0,13250,3550,9875,7125,2329.37
50228543,FA2024 ,14750,600,4200,2450,22000,10500,2500,8000,3250,13000,0,16250,2350,9000,5750,2329.37
50228543,SP2023 ,13500,550,4000,2325,20375,8500,8500,0,2750,9500,0,12250,4550,10875,8125,2329.37
50228543,SP2024 ,14750,600,4200,2450,22000,8500,2500,6000,3250,8500,0,11750,6850,13500,10250,2329.37
50232763,SP2023 ,13500,550,4000,2325,20375,6500,6500,0,4750,8573,0,13323,5477,11802,7052,0
50220653,FA2021 ,12625,500,4580,2110,19815,8220,5000,3220,NULL,9720,0,9720,3405,10095,10095,0
50220653,FA2022 ,13005,515,5080,1140,19740,7675,5000,2675,NULL,9675,0,9675,3845,10065,10065,0
50220653,FA2023 ,7450,275,NULL,NULL,7725,2166,1931,235,NULL,2166,0,2166,5559,5559,5559,0
50220653,SP2021 ,12625,500,4580,2110,19815,5425,5000,425,NULL,5425,0,5425,7700,14390,14390,0
50220653,SP2022 ,13005,515,5080,1140,19740,5425,5000,425,NULL,5425,0,5425,8095,14315,14315,0
50235072,FA2024 ,14750,600,4790,2450,22590,14028,7028,7000,9985,14028,0,24013,1322,8562,-1423,-1206
50235072,SP2024 ,14750,600,4790,2450,22590,14028,7028,7000,10560,14028,0,24588,1322,8562,-1998,-1206
50222492,FA2021 ,12625,500,4580,2110,19815,6800,6800,0,2750,7800,0,10550,5325,12015,9265,0
50222492,SP2021 ,12625,500,4580,2110,19815,6800,6800,0,2750,6800,0,9550,6325,13015,10265,0
50209884,FA2021 ,12625,500,4580,2110,19815,6725,6725,0,3750,11048,0,14798,2077,8767,5017,0
50209884,FA2022 ,13005,515,4810,2220,20550,6725,0,6725,3750,10998,0,14748,2522,9552,5802,0
50209884,SP2021 ,12625,500,4580,2110,19815,6725,6725,0,3750,11547,0,15297,1578,8268,4518,0
50227612,FA2024 ,14750,600,NULL,NULL,15350,5106,4206,900,0,5726,0,5726,9624,9624,9624,-1653.17
50205227,FA2021 ,12625,500,4580,2550,20255,3425,0,3425,10750,4925,0,15675,8200,15330,4580,0
50222055,FA2021 ,12625,500,NULL,NULL,13125,3547,3547,0,2750,10195,0,12945,2930,2930,180,0
50222055,FA2022 ,13005,515,NULL,NULL,13520,3202,3202,0,3250,8850,0,12100,4670,4670,1420,0
50222055,SP2021 ,12625,500,NULL,NULL,13125,3547,3547,0,2750,9754,0,12504,3371,3371,621,0
50222055,SP2022 ,13005,515,NULL,NULL,13520,3202,3202,0,3250,8849,0,12099,4671,4671,1421,0
50221380,FA2021 ,12625,500,4580,2110,19815,5500,5500,0,2750,6500,0,9250,6625,13315,10565,0
50221380,FA2022 ,13005,515,NULL,NULL,13520,3450,3450,0,NULL,3450,0,3450,10070,10070,10070,0
50221380,SP2021 ,12625,500,4580,2110,19815,5500,5500,0,2750,5500,0,8250,7625,14315,11565,0
50233814,FA2024 ,14750,600,4200,2450,22000,10200,10200,0,15020,10200,0,25220,5150,11800,-3220,0
50233814,SP2024 ,14750,600,5410,2450,23210,10200,10200,0,12408,10200,0,22608,5150,13010,602,0
50225223,FA2022 ,13005,515,4810,2220,20550,6500,6500,0,2750,6500,0,9250,7020,14050,11300,0
50225223,FA2023 ,13500,550,5150,2325,21525,6500,6500,0,NULL,6500,0,6500,7550,15025,15025,0
50225223,FA2024 ,14750,600,5030,1270,21650,6500,6500,0,NULL,6500,0,6500,8850,15150,15150,0
50225223,SP2022 ,13005,515,4810,2220,20550,6500,6500,0,2750,6500,0,9250,7020,14050,11300,0
50225223,SP2023 ,13500,550,5150,2325,21525,6500,6500,0,NULL,6500,0,6500,7550,15025,15025,0
50225223,SP2024 ,14750,600,5030,1270,21650,6500,6500,0,NULL,6500,0,6500,8850,15150,15150,0
50230881,FA2023 ,13500,550,5150,2325,21525,7000,7000,0,2750,7000,0,9750,7050,14525,11775,0
50230881,SP2023 ,13500,550,5150,2325,21525,7000,7000,0,2750,7000,0,9750,7050,14525,11775,0
50221026,FA2021 ,12625,500,4580,2110,19815,6750,6750,0,NULL,6750,0,6750,6375,13065,13065,60
50221026,FA2022 ,13005,515,5080,1140,19740,6250,6250,0,NULL,6250,0,6250,7270,13490,13490,60
50221026,FA2023 ,13500,550,5440,1200,20690,6250,6250,0,NULL,6250,0,6250,7800,14440,14440,60
50221026,FA2024 ,14750,600,6090,1270,22710,6250,6250,0,NULL,8350,0,8350,7000,14360,14360,60
50221026,SP2021 ,12625,500,4580,2110,19815,6750,6750,0,NULL,6750,0,6750,6375,13065,13065,60
50221026,SP2022 ,13005,515,5080,1140,19740,6250,6250,0,NULL,6250,0,6250,7270,13490,13490,60
50221026,SP2023 ,13500,550,5440,1200,20690,6250,6250,0,NULL,6250,0,6250,7800,14440,14440,60
50221026,SP2024 ,14750,600,6090,1270,22710,6250,6250,0,NULL,8350,0,8350,7000,14360,14360,60
50232851,FA2024 ,14750,600,4200,2450,22000,9700,7500,2200,0,13398,0,13398,1952,8602,8602,3079.32
50232851,SP2024 ,14750,600,4200,2450,22000,9700,7500,2200,0,13397,0,13397,1953,8603,8603,3079.32
50209886,FA2022 ,13005,515,4810,2220,20550,7000,7000,0,3750,7000,0,10750,6520,13550,9800,0
50209886,SP2022 ,13005,515,4810,2690,21020,7000,7000,0,3750,7000,0,10750,6520,14020,10270,0
50206733,FA2021 ,12625,500,3740,1080,17945,1425,0,1425,3750,6798,0,10548,6327,11147,7397,0
50206733,SP2021 ,12625,500,3740,1080,17945,1425,0,1425,3750,4797,0,8547,8328,13148,9398,0
50225162,FA2022 ,13005,515,4260,2220,20000,6750,6750,0,2750,12098,0,14848,1422,7902,5152,0
50225162,FA2023 ,13500,550,4560,2535,21145,7250,6750,500,3250,12223,0,15473,1827,8922,5672,0
50225162,FA2024 ,14750,600,5410,2450,23210,7750,1250,6500,3250,13348,0,16598,2002,9862,6612,0
50225162,SP2022 ,13005,515,4260,2220,20000,6750,6750,0,2750,12097,0,14847,1423,7903,5153,0
50225162,SP2023 ,13500,550,4560,2535,21145,7250,6750,500,3250,12222,0,15472,1828,8923,5673,0
50225162,SP2024 ,14750,600,5410,2450,23210,7750,1250,6500,3250,13347,0,16597,2003,9863,6613,0
50226046,FA2022 ,13005,515,3855,2220,19595,9000,9000,0,7971,13623,0,21594,-103,5972,-1999,45
50226046,FA2023 ,13500,550,4000,2325,20375,9000,9000,0,10215,9000,0,19215,5050,11375,1160,45
50226046,FA2024 ,14750,600,5720,1270,22340,9000,0,9000,8502,14198,0,22700,1152,8142,-360,45
50226046,SP2022 ,13005,515,3855,2220,19595,9000,9000,0,7971,13622,0,21593,-102,5973,-1998,45
50226046,SP2023 ,13500,550,4000,2325,20375,9000,9000,0,10216,9000,0,19216,5050,11375,1159,45
50226046,SP2024 ,14750,600,5720,1270,22340,9000,0,9000,8369,14197,0,22566,1153,8143,-226,45
50229896,FA2023 ,13500,550,NULL,NULL,14050,3580,3580,0,2750,4830,0,7580,9220,9220,6470,0
50222355,FA2022 ,13005,515,4260,2690,20470,6250,6250,0,2750,6250,0,9000,7270,14220,11470,0
50222355,FA2023 ,13500,550,5150,2325,21525,6250,6250,0,3250,6250,0,9500,7800,15275,12025,0
50222355,FA2024 ,14750,600,5030,1270,21650,6550,6550,0,3750,6550,0,10300,8800,15100,11350,0
50222355,SP2022 ,13005,515,4260,2690,20470,6500,6500,0,2750,6500,0,9250,7020,13970,11220,0
50222355,SP2023 ,13500,550,5150,2325,21525,6250,6250,0,3250,6250,0,9500,7800,15275,12025,0
50222355,SP2024 ,14750,7250,7250,NULL,22000,0,0,0,3750,0,0,3750,22000,22000,18250,0
50226218,FA2022 ,13005,515,3855,2220,19595,7000,7000,0,2750,7000,0,9750,6520,12595,9845,0
50226218,FA2023 ,13500,550,4560,2325,20935,7000,7000,0,3250,7000,0,10250,7050,13935,10685,0
50226218,FA2024 ,14750,600,5720,1270,22340,7000,7000,0,3750,7000,0,10750,8350,15340,11590,0
50226218,SP2022 ,13005,515,3855,2220,19595,7000,7000,0,2750,7000,0,9750,6520,12595,9845,0
50226218,SP2023 ,13500,550,4560,2325,20935,7000,7000,0,3250,7000,0,10250,7050,13935,10685,0
50226218,SP2024 ,14750,600,5720,1270,22340,7000,7000,0,3750,7000,0,10750,8350,15340,11590,0
50236621,SP2024 ,14750,600,5410,2450,23210,5000,5000,0,NULL,5000,0,5000,10350,18210,18210,0
50225149,FA2022 ,13005,515,4260,2220,20000,9500,0,9500,NULL,9500,0,9500,4020,10500,10500,0
50225149,SP2022 ,13005,515,4260,2220,20000,9500,0,9500,NULL,9500,0,9500,4020,10500,10500,0
50232369,FA2024 ,14750,600,5410,2450,23210,6500,6500,0,NULL,6500,0,6500,8850,16710,16710,0
50232369,SP2024 ,14750,600,5410,2450,23210,6500,6500,0,NULL,6500,0,6500,8850,16710,16710,0
50228380,SP2022 ,14269,7231,7231,NULL,21500,0,0,0,NULL,0,0,0,21500,21500,21500,0
50228927,FA2023 ,13500,550,4560,2325,20935,0,0,0,7918,13923,13500,21841,127,7012,-906,1694.67
50228927,FA2024 ,14750,600,4790,2450,22590,0,0,0,3250,14750,14750,18000,600,7840,4590,1694.67
50228927,SP2023 ,13500,550,4560,2325,20935,0,0,0,7918,13922,13500,21840,128,7013,-905,1694.67
50228927,SP2024 ,14750,600,4790,2450,22590,0,0,0,3250,14750,14750,18000,600,7840,4590,1694.67
50228201,FA2023 ,13500,550,4560,2325,20935,6500,6500,0,2750,6500,0,9250,7550,14435,11685,4566
50228201,FA2024 ,14750,600,5410,2450,23210,6500,6500,0,3250,6500,0,9750,8850,16710,13460,4566
50228201,SP2023 ,13500,550,4560,2325,20935,6500,6500,0,2750,6500,0,9250,7550,14435,11685,4566
50228201,SP2024 ,14750,600,5410,2450,23210,6500,6500,0,3250,6500,0,9750,8850,16710,13460,4566
50224341,FA2022 ,13005,515,4810,2220,20550,8250,8250,0,2750,8250,0,11000,5270,12300,9550,130
50224341,FA2023 ,13500,550,4790,1200,20040,8250,8250,0,3250,8250,0,11500,5800,11790,8540,130
50224341,FA2024 ,14750,600,6090,NULL,21440,8250,8250,0,3750,8250,0,12000,7100,13190,9440,130
50224341,SP2022 ,13005,515,4810,2220,20550,8250,8250,0,2750,8250,0,11000,5270,12300,9550,130
50224341,SP2023 ,13500,550,4790,NULL,18840,8250,8250,0,3250,8250,0,11500,5800,10590,7340,130
50224341,SP2024 ,14750,600,6090,NULL,21440,8250,8250,0,3750,8250,0,12000,7100,13190,9440,130
50205186,FA2021 ,12625,500,4270,NULL,17395,0,0,0,3750,500,0,4250,12625,16895,13145,0
50205186,FA2022 ,13005,515,NULL,NULL,13520,0,0,0,3750,0,0,3750,13520,13520,9770,0
50205186,SP2021 ,12625,500,4270,NULL,17395,0,0,0,3750,0,0,3750,13125,17395,13645,0
50228202,FA2023 ,13500,550,4990,2745,21785,7000,7000,0,2750,8000,0,10750,6050,13785,11035,-312
50228202,FA2024 ,14750,600,5240,2450,23040,7000,1000,6000,0,8100,0,8100,7250,14940,14940,-312
50228202,SP2023 ,13500,550,4990,2325,21365,7000,7000,0,2750,7000,0,9750,7050,14365,11615,-312
50228202,SP2024 ,4070,NULL,0,0,4070,0,0,0,0,0,0,0,4070,4070,4070,-312
50218467,FA2021 ,12625,500,NULL,NULL,13125,925,925,0,2750,1925,0,4675,11200,11200,8450,0
50218467,FA2022 ,13005,515,NULL,NULL,13520,25,25,0,10850,3448,0,14298,10072,10072,-778,0
50218467,FA2023 ,13500,550,NULL,NULL,14050,925,0,925,24750,925,0,25675,13125,13125,-11625,0
50218467,FA2024 ,14750,600,NULL,NULL,15350,925,0,925,22175,925,0,23100,14425,14425,-7750,0
50218467,SP2021 ,12625,500,NULL,NULL,13125,925,925,0,14200,925,0,15125,12200,12200,-2000,0
50218467,SP2022 ,13005,515,NULL,NULL,13520,25,25,0,15250,3447,0,18697,10073,10073,-5177,0
50218467,SP2023 ,13500,550,NULL,NULL,14050,925,0,925,23250,925,0,24175,13125,13125,-10125,0
50218467,SP2024 ,8140,300,NULL,NULL,8440,511,0,511,24000,511,0,24511,7929,7929,-16071,0
50228046,FA2023 ,13500,550,5150,2325,21525,7500,7500,0,2750,7500,0,10250,6550,14025,11275,0
50228046,FA2024 ,14750,600,5410,2450,23210,7500,7500,0,NULL,7500,0,7500,7850,15710,15710,0
50228046,SP2023 ,13500,550,5150,2325,21525,7500,7500,0,2750,7500,0,10250,6550,14025,11275,0
50228046,SP2024 ,14750,600,5410,2450,23210,7500,7500,0,NULL,7500,0,7500,7850,15710,15710,0
50221489,FA2021 ,12625,500,3740,2110,18975,7750,7750,0,NULL,8750,0,8750,4375,10225,10225,-130
50221489,FA2022 ,13005,515,3855,2220,19595,7250,7250,0,NULL,7250,0,7250,6270,12345,12345,-130
50221489,FA2023 ,13500,550,4000,2325,20375,7250,7250,0,NULL,7250,0,7250,6800,13125,13125,-130
50221489,FA2024 ,14750,600,5030,1270,21650,10250,500,9750,NULL,10250,0,10250,5100,11400,11400,-130
50221489,SP2021 ,12625,500,3740,2110,18975,7750,7750,0,NULL,7750,0,7750,5375,11225,11225,-130
50221489,SP2022 ,13005,515,3855,2220,19595,7250,7250,0,NULL,7250,0,7250,6270,12345,12345,-130
50221489,SP2023 ,13500,550,4000,2325,20375,7250,7250,0,NULL,7250,0,7250,6800,13125,13125,-130
50221489,SP2024 ,2120,NULL,5030,NULL,7150,0,0,0,NULL,0,0,0,2120,7150,7150,-130
50222800,FA2021 ,12625,500,4050,2110,19285,4500,4500,0,NULL,13000,0,13000,125,6285,6285,7000
50222800,FA2022 ,13005,515,4810,2220,20550,4000,4000,0,NULL,4000,0,4000,9520,16550,16550,7000
50222800,SP2021 ,12625,500,3740,2110,18975,4500,4500,0,NULL,4500,0,4500,8625,14475,14475,7000
50222800,SP2022 ,13005,515,4810,2220,20550,4000,4000,0,NULL,4000,0,4000,9520,16550,16550,7000
50222800,SP2024 ,14750,600,5410,2450,23210,4000,4000,0,NULL,4000,0,4000,11350,19210,19210,7000
50225202,FA2022 ,13005,515,3855,2220,19595,7150,7150,0,1750,10860,0,12610,2660,8735,6985,0
50230548,FA2023 ,13500,550,5150,2325,21525,22565,22565,0,NULL,22565,0,22565,-8515,-1040,-1040,0
50221506,FA2021 ,12625,500,4050,2110,19285,7250,7250,0,13453,8250,0,21703,4875,11035,-2418,-10
50221506,FA2022 ,13005,515,3855,2220,19595,7000,7000,0,10559,7000,0,17559,6520,12595,2036,-10
50221506,FA2023 ,13500,550,4000,1200,19250,6750,6750,0,12829,6750,0,19579,7300,12500,-329,-10
50221506,FA2024 ,14750,600,4200,1270,20820,7750,7750,0,13527,7750,0,21277,7600,13070,-457,-10
50221506,SP2021 ,12625,500,4050,2110,19285,7250,7250,0,10686,7250,0,17936,5875,12035,1349,-10
50221506,SP2022 ,13005,515,3855,2220,19595,7050,7050,0,13091,7050,0,20141,6470,12545,-546,-10
50221506,SP2023 ,13500,550,4000,1200,19250,6750,6750,0,13750,6750,0,20500,7300,12500,-1250,-10
50222694,FA2021 ,12625,500,4580,2110,19815,6250,6250,0,2750,7250,0,10000,5875,12565,9815,0
50222694,SP2021 ,12625,500,3740,2110,18975,6250,6250,0,2750,6250,0,9000,6875,12725,9975,0
50222200,FA2021 ,12625,500,4580,2110,19815,8500,8500,0,2750,10723,0,13473,2402,9092,6342,-31.33
50222200,FA2023 ,13500,550,4000,1200,19250,8000,8000,0,11653,9823,0,21476,4227,9427,-2226,-31.33
50222200,FA2024 ,14750,600,5030,1270,21650,8000,5000,3000,17460,9520,0,26980,5830,12130,-5330,-31.33
50222200,SP2021 ,12625,500,4580,2110,19815,8500,8500,0,9722,9222,0,18944,3903,10593,871,-31.33
50222200,SP2022 ,13005,515,3855,1140,18515,8000,8000,0,12000,8922,0,20922,4598,9593,-2407,-31.33
50222200,SP2023 ,13500,550,4000,1200,19250,8000,8000,0,11652,9822,0,21474,4228,9428,-2224,-31.33
50222200,SP2024 ,14750,600,5030,1270,21650,8000,5000,3000,15040,9520,0,24560,5830,12130,-2910,-31.33
50205464,FA2021 ,12625,500,NULL,NULL,13125,2425,2425,0,0,3425,0,3425,9700,9700,9700,0
50227661,FA2023 ,13500,550,5150,2325,21525,0,0,0,8336,14923,13500,23259,-873,6602,-1734,1496.33
50227661,FA2024 ,14750,600,4790,2450,22590,0,0,0,3250,15923,14750,19173,-573,6667,3417,1496.33
50227661,SP2023 ,13500,550,5150,2325,21525,0,0,0,8336,14922,13500,23258,-872,6603,-1733,1496.33
50227661,SP2024 ,14750,600,4790,2450,22590,0,0,0,3250,15922,14750,19172,-572,6668,3418,1496.33
50205121,FA2021 ,12625,500,5160,NULL,18285,9850,3150,6700,3750,11350,0,15100,1775,6935,3185,0
50205121,SP2021 ,12625,500,5160,NULL,18285,7850,3150,4700,3750,7850,0,11600,5275,10435,6685,0
50216694,FA2021 ,12625,500,3740,2110,18975,6425,6425,0,3750,7925,0,11675,5200,11050,7300,0
50216694,SP2021 ,12625,500,3740,2110,18975,6425,6425,0,12750,6425,0,19175,6700,12550,-200,0
50234961,FA2024 ,14750,600,5410,2450,23210,6000,6000,0,NULL,6000,0,6000,9350,17210,17210,80
50234961,SP2024 ,14750,600,5410,2450,23210,6000,6000,0,NULL,6000,0,6000,9350,17210,17210,80
50231451,FA2024 ,14750,600,4200,2680,22230,8500,8500,0,2750,9000,0,11750,6350,13230,10480,0
50231451,SP2024 ,14750,600,4200,2450,22000,8500,8500,0,2750,8500,0,11250,6850,13500,10750,0
50222465,FA2021 ,12625,500,4580,2110,19815,7250,7250,0,13057,9500,0,22557,3625,10315,-2742,-1726.94
50222465,FA2022 ,13005,515,4810,2220,20550,9500,7880,1620,10750,9500,0,20250,4020,11050,300,-1726.94
50222465,FA2023 ,13500,550,5150,2325,21525,9500,0,9500,8250,15098,0,23348,-1048,6427,-1823,-1726.94
50222465,FA2024 ,14750,600,5410,2450,23210,10500,5000,5500,9142,15698,0,24840,-348,7512,-1630,-1726.94
50222465,SP2021 ,12625,500,4580,2110,19815,7250,7250,0,11932,8500,0,20432,4625,11315,-617,-1726.94
50222465,SP2022 ,13005,515,4810,2220,20550,9500,7880,1620,10750,9500,0,20250,4020,11050,300,-1726.94
50222465,SP2023 ,13500,550,5150,2325,21525,9500,0,9500,8250,15097,0,23347,-1047,6428,-1822,-1726.94
50222465,SP2024 ,14750,600,5410,2450,23210,10500,5000,5500,9143,15697,0,24840,-347,7513,-1630,-1726.94
50221637,FA2021 ,12625,500,3740,2110,18975,9850,7850,2000,2750,13623,0,16373,-498,5352,2602,0
50221637,FA2022 ,13005,515,4810,2220,20550,11072,5500,5572,3250,12345,0,15595,1175,8205,4955,0
50221637,FA2023 ,13500,550,5440,1200,20690,11443,0,11443,0,23316,0,23316,-9266,-2626,-2626,0
50221637,FA2024 ,14750,600,5030,1270,21650,20350,0,20350,1650,24448,0,26098,-9098,-2798,-4448,0
50221637,SP2021 ,12625,500,3740,2110,18975,7850,7850,0,2750,10122,0,12872,3003,8853,6103,0
50221637,SP2022 ,13005,515,4810,2220,20550,8850,5500,3350,3250,10122,0,13372,3398,10428,7178,0
50221637,SP2023 ,13500,550,5440,NULL,19490,9350,0,9350,0,12722,0,12722,1328,6768,6768,0
50230225,FA2023 ,13500,550,4560,2325,20935,9000,9000,0,2750,9000,0,11750,5050,11935,9185,6873
50230225,FA2024 ,14750,600,4790,2450,22590,9000,6000,3000,3250,9000,0,12250,6350,13590,10340,6873
50230225,SP2023 ,13500,550,4560,2325,20935,9000,9000,0,2750,9000,0,11750,5050,11935,9185,6873
50230225,SP2024 ,14750,600,4790,2450,22590,9000,6000,3000,3250,9000,0,12250,6350,13590,10340,6873
50212664,FA2021 ,19340,860,5330,NULL,24670,0,0,0,3250,14125,12625,17375,6075,10545,7295,0
50212664,FA2022 ,19910,890,6310,NULL,26220,0,0,0,3750,16405,13005,20155,4395,9815,6065,0
50212664,SP2021 ,19340,860,5330,1080,25750,0,0,0,3250,12625,12625,15875,7575,13125,9875,0
50212664,SP2022 ,19910,890,6310,NULL,26220,0,0,0,3750,16405,13005,20155,4395,9815,6065,0
50221520,FA2021 ,12625,500,4050,2110,19285,7900,7900,0,2750,8900,0,11650,4225,10385,7635,-410
50221520,FA2022 ,13005,515,4260,2220,20000,7400,7400,0,3250,7400,0,10650,6120,12600,9350,-410
50221520,FA2023 ,13500,550,4560,1200,19810,7400,7400,0,3750,7400,0,11150,6650,12410,8660,-410
50221520,FA2024 ,14750,600,4790,NULL,20140,7400,5000,2400,3750,12863,0,16613,2487,7277,3527,-410
50221520,SP2021 ,12625,500,4050,2110,19285,7900,7900,0,2750,7900,0,10650,5225,11385,8635,-410
50221520,SP2022 ,13005,515,4260,2220,20000,7400,7400,0,3250,7400,0,10650,6120,12600,9350,-410
50221520,SP2023 ,13500,550,4560,2325,20935,7400,7400,0,3750,7400,0,11150,6650,13535,9785,-410
50221520,SP2024 ,14750,600,4790,NULL,20140,7400,5000,2400,3750,12862,0,16612,2488,7278,3528,-410
50229502,FA2023 ,13500,550,4000,2325,20375,6000,6000,0,2750,6000,0,8750,8050,14375,11625,2738.25
50229502,FA2024 ,14750,600,5410,2450,23210,6000,6000,0,3250,10098,0,13348,5252,13112,9862,2738.25
50229502,SP2023 ,13500,550,4000,2325,20375,6000,6000,0,2750,6000,0,8750,8050,14375,11625,2738.25
50229502,SP2024 ,14750,600,5410,2450,23210,6000,6000,0,3250,10097,0,13347,5253,13113,9863,2738.25
50231667,FA2024 ,14750,600,4200,2450,22000,7000,7000,0,2750,7000,0,9750,8350,15000,12250,0
50213778,FA2021 ,12625,500,NULL,NULL,13125,4140,4140,0,8000,4140,0,12140,8985,8985,985,0
50213778,FA2022 ,13005,515,NULL,NULL,13520,3640,3640,0,13750,3640,0,17390,9880,9880,-3870,0
50213778,FA2023 ,13500,550,NULL,NULL,14050,3795,3795,0,11375,3795,0,15170,10255,10255,-1120,0
50213778,SP2021 ,12625,500,NULL,NULL,13125,4140,4140,0,8000,5640,0,13640,7485,7485,-515,0
50213778,SP2023 ,7450,275,NULL,NULL,7725,2094,2094,0,11375,2094,0,13469,5631,5631,-5744,0
50230212,FA2023 ,14500,7000,7000,NULL,21500,0,0,0,NULL,0,0,0,21500,21500,21500,0
50224405,FA2021 ,12625,500,4470,2110,19705,4500,4500,0,8471,4500,0,12971,8625,15205,6734,0
50224405,FA2023 ,7450,550,4990,2325,15315,2207,2207,0,3750,2207,0,5957,5793,13108,9358,0
50224405,SP2021 ,6960,500,4470,2110,14040,2481,2481,0,8250,2481,0,10731,4979,11559,3309,0
50224405,SP2022 ,7170,515,4380,2220,14285,2205,2205,0,3750,2205,0,5955,5480,12080,8330,0
50224405,SP2023 ,3720,NULL,NULL,NULL,3720,0,0,0,0,0,0,0,3720,3720,3720,0
50232062,FA2024 ,14750,600,5410,2450,23210,8000,8000,0,2750,8000,0,10750,7350,15210,12460,0
50232062,SP2024 ,14750,600,5410,2450,23210,8000,8000,0,2750,8000,0,10750,7350,15210,12460,0
50129702,FA2022 ,13005,515,3855,2220,19595,6500,6500,0,2750,6500,0,9250,7020,13095,10345,0
50129702,FA2023 ,13500,550,5150,2325,21525,6500,6500,0,3250,6500,0,9750,7550,15025,11775,0
50129702,FA2024 ,14750,600,5410,2450,23210,6500,6500,0,3750,6500,0,10250,8850,16710,12960,0
50129702,SP2022 ,13005,515,4810,2220,20550,6500,6500,0,2750,6500,0,9250,7020,14050,11300,0
50129702,SP2023 ,13500,550,5150,2325,21525,6500,6500,0,3250,6500,0,9750,7550,15025,11775,0
50129702,SP2024 ,14750,600,5410,2450,23210,6500,6500,0,3750,6500,0,10250,8850,16710,12960,0
50231381,FA2024 ,14750,600,5410,2450,23210,7000,7000,0,NULL,7000,0,7000,8350,16210,16210,0
50231381,SP2024 ,14750,600,5410,2450,23210,7000,7000,0,NULL,7000,0,7000,8350,16210,16210,0
50233892,FA2024 ,14750,600,4200,2450,22000,9000,0,9000,NULL,9000,0,9000,6350,13000,13000,0
50233892,SP2024 ,14750,600,4200,2450,22000,9000,0,9000,NULL,9000,0,9000,6350,13000,13000,0
50203887,FA2021 ,12625,500,4830,1080,19035,925,925,0,3750,1925,0,5675,11200,17110,13360,0
50203887,SP2021 ,12625,500,4830,1080,19035,925,925,0,3750,925,0,4675,12200,18110,14360,0
50229040,FA2023 ,13500,550,4000,2325,20375,6500,6500,0,2750,6500,0,9250,7550,13875,11125,5475.64
50229040,FA2024 ,14750,600,4200,2450,22000,6500,6500,0,NULL,6500,0,6500,8850,15500,15500,5475.64
50229040,SP2023 ,13500,550,4000,2325,20375,6500,6500,0,2750,6500,0,9250,7550,13875,11125,5475.64
50229040,SP2024 ,14750,600,4200,2450,22000,6500,6500,0,NULL,6500,0,6500,8850,15500,15500,5475.64
50233717,FA2024 ,14750,600,4200,2450,22000,8950,7850,1100,10250,10070,0,20320,5280,11930,1680,-5338.32
50233717,SP2024 ,14750,600,4200,2450,22000,8950,7850,1100,10250,15820,0,26070,-470,6180,-4070,-5338.32
50211965,FA2021 ,12625,500,3740,2110,18975,0,0,0,NULL,1500,0,1500,11625,17475,17475,0
50211965,FA2022 ,13005,515,4810,2220,20550,0,0,0,NULL,0,0,0,13520,20550,20550,0
50211965,FA2023 ,13500,550,5440,NULL,19490,0,0,0,NULL,0,0,0,14050,19490,19490,0
50211965,SP2021 ,12625,500,3740,2110,18975,0,0,0,NULL,0,0,0,13125,18975,18975,0
50211965,SP2022 ,13005,515,4810,2220,20550,0,0,0,NULL,0,0,0,13520,20550,20550,0
50211965,SP2023 ,13500,550,5440,1200,20690,0,0,0,NULL,0,0,0,14050,20690,20690,0
50210296,FA2021 ,12625,500,4580,2110,19815,1825,1825,0,3250,7798,0,11048,5327,12017,8767,0
50210296,SP2022 ,7170,257,NULL,NULL,7427,868,868,0,3250,4875,0,8125,2552,2552,-698,0
50229727,FA2024 ,14750,600,5410,2450,23210,7000,0,7000,16250,7000,0,23250,8350,16210,-40,0
50229727,SP2024 ,14750,600,5410,2450,23210,7000,0,7000,16250,7000,0,23250,8350,16210,-40,0
50204768,FA2021 ,19340,860,5130,NULL,24470,7500,7500,0,22750,9000,0,31750,11200,15470,-7280,0
50204768,SP2021 ,19340,860,5130,NULL,24470,7500,7500,0,3750,7500,0,11250,12700,16970,13220,0
50224785,FA2022 ,13005,515,4810,2220,20550,9500,0,9500,2750,16948,0,19698,-3428,3602,852,0
50224785,FA2023 ,13500,550,4000,2325,20375,9500,0,9500,3250,15573,0,18823,-1523,4802,1552,0
50224785,FA2024 ,14750,7250,7250,NULL,22000,8400,6400,2000,3750,16098,0,19848,5902,5902,2152,0
50224785,SP2022 ,13005,515,4810,2220,20550,9500,0,9500,2750,16947,0,19697,-3427,3603,853,0
50224785,SP2023 ,13500,550,4000,2325,20375,9500,0,9500,3250,15572,0,18822,-1522,4803,1553,0
50224785,SP2024 ,14750,600,4200,2450,22000,9500,0,9500,3750,17197,0,20947,-1847,4803,1053,0
50223303,FA2021 ,12625,500,3740,2110,18975,5200,5200,0,2750,6200,0,8950,6925,12775,10025,0
50223303,FA2022 ,13005,515,3855,2220,19595,5200,5200,0,NULL,5200,0,5200,8320,14395,14395,0
50223303,SP2021 ,5200,500,3740,2110,11550,2142,2142,0,0,2142,0,2142,3558,9408,9408,0
50227793,FA2023 ,13500,550,4000,2325,20375,6500,6500,0,NULL,6500,0,6500,7550,13875,13875,0
50227793,FA2024 ,14750,600,4200,2450,22000,6500,6500,0,NULL,6500,0,6500,8850,15500,15500,0
50227793,SP2023 ,13500,550,4000,2325,20375,6500,6500,0,NULL,6500,0,6500,7550,13875,13875,0
50227793,SP2024 ,14750,600,4200,2450,22000,6500,6500,0,NULL,6500,0,6500,8850,15500,15500,0
50231907,FA2024 ,14750,600,4200,2450,22000,7000,7000,0,NULL,7000,0,7000,8350,15000,15000,0
50231907,SP2024 ,14750,600,4200,2450,22000,7000,7000,0,NULL,7000,0,7000,8350,15000,15000,0
50231994,FA2024 ,14750,600,5410,2450,23210,6000,6000,0,0,6000,0,6000,9350,17210,17210,-4
50231994,SP2024 ,14750,600,5410,2450,23210,6000,6000,0,0,6000,0,6000,9350,17210,17210,-4
50206510,FA2021 ,12625,500,4270,1080,18475,3925,1925,2000,3750,5425,0,9175,7700,13050,9300,0
50206510,SP2021 ,12625,500,4270,1080,18475,1925,1925,0,3750,1925,0,5675,11200,16550,12800,0
50209956,FA2022 ,14269,7231,7231,NULL,21500,0,0,0,NULL,0,0,0,21500,21500,21500,0
50216270,FA2021 ,12625,500,4050,2110,19285,3925,3925,0,NULL,4425,0,4425,8700,14860,14860,0
50216270,SP2021 ,12625,500,4050,2110,19285,3925,3925,0,NULL,3925,0,3925,9200,15360,15360,0
50216250,FA2021 ,12625,500,4580,2110,19815,9500,0,9500,0,23073,0,23073,-9948,-3258,-3258,0
50216250,FA2022 ,13005,515,4810,2220,20550,9500,0,9500,0,21448,0,21448,-7928,-898,-898,0
50216250,FA2023 ,13500,550,4560,55.2,18665.2,10550,500,10050,0,24248,0,24248,-10198,-5582.8,-5582.8,0
50216250,SP2021 ,12625,500,4580,2110,19815,9801,301,9500,0,14373,0,14373,-1248,5442,5442,0
50216250,SP2022 ,13005,515,4810,2220,20550,9500,0,9500,0,16447,0,16447,-2927,4103,4103,0
50216250,SP2023 ,13500,550,4560,NULL,18610,10000,0,10000,0,16197,0,16197,-2147,2413,2413,0
50216255,FA2021 ,12625,500,3740,2110,18975,9500,0,9500,2750,16123,0,18873,-2998,2852,102,0
50216255,FA2022 ,13005,515,5420,1140,20080,9500,0,9500,3250,16448,0,19698,-2928,3632,382,0
50216255,FA2023 ,13500,550,4790,100.7,18940.7,13050,500,12550,0,20248,0,20248,-6198,-1307.3,-1307.3,0
50216255,FA2024 ,14750,7250,7250,NULL,22000,9500,6500,3000,3750,19198,0,22948,2802,2802,-948,0
50216255,SP2021 ,12625,500,3740,2110,18975,9500,0,9500,2750,16372,0,19122,-3247,2603,-147,0
50216255,SP2022 ,13005,515,5420,1140,20080,9500,0,9500,3250,16447,0,19697,-2927,3633,383,0
50216255,SP2023 ,13500,550,4790,NULL,18840,12500,0,12500,0,19697,0,19697,-5647,-857,-857,0
50228610,FA2023 ,13500,550,4000,2325,20375,9500,0,9500,2750,16698,0,19448,-2648,3677,927,-529.62
50228610,FA2024 ,14750,600,4200,2450,22000,9500,0,9500,0,16698,0,16698,-1348,5302,5302,-529.62
50228610,SP2023 ,13500,550,4000,2325,20375,9500,0,9500,2750,16697,0,19447,-2647,3678,928,-529.62
50228610,SP2024 ,14750,600,4200,2450,22000,9500,0,9500,0,20197,0,20197,-4847,1803,1803,-529.62
50221953,FA2021 ,12625,500,4580,2110,19815,5750,5750,0,2750,5750,0,8500,7375,14065,11315,0
50221953,FA2022 ,13005,515,4260,2220,20000,5250,5250,0,NULL,5250,0,5250,8270,14750,14750,0
50221953,FA2023 ,13500,550,5440,1200,20690,5250,5250,0,NULL,5250,0,5250,8800,15440,15440,0
50221953,FA2024 ,14750,600,NULL,NULL,15350,3623,3623,0,NULL,3623,0,3623,11727,11727,11727,0
50221953,SP2021 ,12625,500,4580,2110,19815,5750,5750,0,2750,5750,0,8500,7375,14065,11315,0
50221953,SP2022 ,13005,515,4260,2220,20000,5250,5250,0,NULL,5250,0,5250,8270,14750,14750,0
50221953,SP2023 ,13500,550,5440,1200,20690,5250,5250,0,NULL,5250,0,5250,8800,15440,15440,0
50221953,SP2024 ,14750,600,NULL,NULL,15350,3622,3622,0,NULL,3622,0,3622,11728,11728,11728,0
50204903,FA2021 ,12625,500,4830,NULL,17955,3925,0,3925,4875,11034,0,15909,2091,6921,2046,0
50204903,SP2021 ,12625,500,4830,NULL,17955,3925,0,3925,4875,9033,0,13908,4092,8922,4047,0
50224982,FA2022 ,13005,515,4260,2220,20000,6750,6750,0,2750,6750,0,9500,6770,13250,10500,0
50224982,FA2023 ,13500,550,5150,2325,21525,6750,6750,0,3250,7750,0,11000,6300,13775,10525,0
50224982,FA2024 ,14750,600,5720,1270,22340,6750,6750,0,3750,7750,0,11500,7600,14590,10840,0
50224982,SP2022 ,13005,515,4260,2220,20000,6750,6750,0,2750,6750,0,9500,6770,13250,10500,0
50224982,SP2023 ,13500,550,5150,2325,21525,6750,6750,0,3250,7750,0,11000,6300,13775,10525,0
50224982,SP2024 ,14750,600,5720,1270,22340,6750,6750,0,3750,7750,0,11500,7600,14590,10840,0
50225050,FA2022 ,13005,515,3855,2220,19595,6250,6250,0,0,9596,0,9596,3924,9999,9999,0
50204774,FA2021 ,12625,500,4830,1080,19035,5600,3275,2325,8870,12673,0,21543,452,6362,-2508,192
50229273,FA2023 ,13500,550,4560,2745,21355,7000,7000,0,2750,9500,0,12250,4550,11855,9105,0
50229273,FA2024 ,14750,600,4790,2900,23040,7000,7000,0,NULL,9500,0,9500,5850,13540,13540,0
50229273,SP2023 ,13500,550,4560,2745,21355,7000,7000,0,2750,7000,0,9750,7050,14355,11605,0
50229273,SP2024 ,14750,600,4790,2680,22820,7000,7000,0,NULL,7000,0,7000,8350,15820,15820,0
50215253,FA2021 ,12625,500,4580,2110,19815,6175,6175,0,NULL,10755,0,10755,2370,9060,9060,0
50215253,FA2022 ,13005,515,4810,2220,20550,6342,6342,0,NULL,11152,0,11152,2368,9398,9398,0
50215253,FA2023 ,13500,550,4790,1200,20040,5967,292,5675,NULL,8467,0,8467,5583,11573,11573,0
50215253,SP2021 ,12625,500,4580,2110,19815,6175,6175,0,NULL,10755,0,10755,2370,9060,9060,0
50215253,SP2022 ,13005,515,4810,2220,20550,6261,6261,0,NULL,11071,0,11071,2449,9479,9479,0
50215253,SP2023 ,1940,NULL,4790,0,6730,156,156,0,NULL,2156,0,2156,-216,4574,4574,0
50226477,FA2023 ,13500,550,4560,2325,20935,11000,6500,4500,NULL,11000,0,11000,3050,9935,9935,11836.96
50226477,FA2024 ,14750,600,4790,2450,22590,11000,6500,4500,NULL,11000,0,11000,4350,11590,11590,11836.96
50226477,SP2022 ,13005,515,4260,2220,20000,11000,9500,1500,NULL,11000,0,11000,2520,9000,9000,11836.96
50226477,SP2023 ,13500,550,4560,2325,20935,11000,6500,4500,NULL,11000,0,11000,3050,9935,9935,11836.96
50216319,FA2021 ,12625,500,3740,2110,18975,7325,7325,0,3250,8825,0,12075,4300,10150,6900,0
50216319,FA2022 ,13005,515,3855,2220,19595,7325,7325,0,3750,7325,0,11075,6195,12270,8520,0
50216319,FA2023 ,13500,550,4790,NULL,18840,7326,0,7326,3750,7326,0,11076,6724,11514,7764,0
50216319,SP2021 ,12625,500,3740,2110,18975,7325,7325,0,3250,7325,0,10575,5800,11650,8400,0
50216319,SP2023 ,13500,550,4790,NULL,18840,7324,0,7324,0,7324,0,7324,6726,11516,11516,0
50209443,FA2021 ,12625,500,4830,1080,19035,2425,2425,0,NULL,2425,0,2425,10700,16610,16610,0
50209443,FA2022 ,13005,515,5080,1140,19740,2925,2925,0,NULL,2925,0,2925,10595,16815,16815,0
50209443,SP2021 ,12625,500,4830,1080,19035,2425,2425,0,NULL,2425,0,2425,10700,16610,16610,0
50209443,SP2022 ,7170,515,5080,1140,13905,1337,1337,0,NULL,1337,0,1337,6348,12568,12568,0
50231512,FA2024 ,14750,600,4790,2450,22590,8000,8000,0,2750,8000,0,10750,7350,14590,11840,0
50231512,SP2024 ,14750,600,4790,2450,22590,8000,8000,0,2750,8000,0,10750,7350,14590,11840,0
50226840,FA2022 ,13005,515,4800,2220,20540,6500,6500,0,2750,6500,0,9250,7020,14040,11290,0
50226840,FA2023 ,13500,550,4000,2325,20375,5500,5500,0,3250,6500,0,9750,7550,13875,10625,0
50226840,FA2024 ,14750,600,4200,2450,22000,6500,5500,1000,3750,6500,0,10250,8850,15500,11750,0
50226840,SP2022 ,13005,515,4800,2220,20540,6500,6500,0,2750,6500,0,9250,7020,14040,11290,0
50226840,SP2023 ,13500,550,4990,2325,21365,5500,5500,0,3250,6500,0,9750,7550,14865,11615,0
50226840,SP2024 ,14750,600,4200,2450,22000,6500,5500,1000,3750,6500,0,10250,8850,15500,11750,0
50227622,FA2022 ,13005,515,4810,2220,20550,6500,6500,0,14555,6500,0,21055,7020,14050,-505,0
50227622,SP2022 ,13005,515,4810,2220,20550,6500,6500,0,14555,6500,0,21055,7020,14050,-505,0
50066152,FA2021 ,12625,500,4830,1080,19035,4225,2875,1350,3750,5725,0,9475,7400,13310,9560,0
50066152,SP2021 ,12625,500,5160,1080,19365,4225,2875,1350,3750,4225,0,7975,8900,15140,11390,0
50232744,FA2024 ,14750,600,4200,2450,22000,10250,8250,2000,2750,11250,0,14000,4100,10750,8000,0
50232744,SP2024 ,14750,600,4200,2450,22000,8000,8000,0,2750,8000,0,10750,7350,14000,11250,0
50224983,FA2022 ,13005,515,3855,2220,19595,9000,9000,0,2750,11500,0,14250,2020,8095,5345,4570
50224983,FA2023 ,13500,550,5150,2745,21945,9000,9000,0,NULL,9000,0,9000,5050,12945,12945,4570
50224983,FA2024 ,14750,600,5720,1270,22340,9000,9000,0,NULL,11500,0,11500,3850,10840,10840,4570
50224983,SP2022 ,13005,515,3855,2690,20065,9000,9000,0,2750,9000,0,11750,4520,11065,8315,4570
50224983,SP2023 ,13500,550,5150,2745,21945,9000,9000,0,NULL,9000,0,9000,5050,12945,12945,4570
50224983,SP2024 ,14750,600,5720,1270,22340,9000,9000,0,NULL,9000,0,9000,6350,13340,13340,4570
50232554,FA2024 ,14750,600,5410,2450,23210,10850,8000,2850,2750,10850,0,13600,4500,12360,9610,-6097
50232554,SP2024 ,14750,600,5410,2450,23210,8850,8000,850,2750,8850,0,11600,6500,14360,11610,-6097
50160169,FA2021 ,12625,500,5160,NULL,18285,9925,5875,4050,3750,11425,0,15175,1700,6860,3110,0
50160169,SP2021 ,12625,500,4830,NULL,17955,7925,5875,2050,3750,7925,0,11675,5200,10030,6280,0
50231967,SP2023 ,14500,7000,7000,NULL,21500,0,0,0,NULL,0,0,0,21500,21500,21500,0
50230320,FA2023 ,12500,4300,4300,NULL,16800,0,0,0,NULL,0,0,0,16800,16800,16800,0
50080097,FA2021 ,12625,500,3740,NULL,16865,0,0,0,17620,1500,0,19120,11625,15365,-2255,0
50080097,FA2022 ,13005,515,3855,NULL,17375,0,0,0,22279,0,0,22279,13520,17375,-4904,0
50080097,SP2021 ,12625,500,3740,NULL,16865,0,0,0,18512,0,0,18512,13125,16865,-1647,0
50080097,SP2022 ,13005,515,3855,NULL,17375,0,0,0,19412,0,0,19412,13520,17375,-2037,0
50210395,FA2021 ,12625,500,3740,2110,18975,1425,0,1425,3750,2925,0,6675,10200,16050,12300,4907.12
50210395,FA2022 ,13005,515,4610,1140,19270,2175,750,1425,3750,2175,0,5925,11345,17095,13345,4907.12
50210395,SP2021 ,12625,500,3740,2110,18975,1425,0,1425,3750,1425,0,5175,11700,17550,13800,4907.12
50210395,SP2022 ,13005,515,4610,1140,19270,2175,750,1425,3750,2675,0,6425,10845,16595,12845,4907.12
50231410,FA2024 ,14750,600,4200,2450,22000,7750,7500,250,NULL,7750,0,7750,7600,14250,14250,4613.32
50231410,SP2024 ,14750,600,4200,2450,22000,7750,7500,250,NULL,7750,0,7750,7600,14250,14250,4613.32
50225952,FA2022 ,13005,515,4260,2220,20000,7000,7000,0,5250,7000,0,12250,6520,13000,7750,4235.68
50225952,FA2023 ,13500,550,4560,2325,20935,7500,7500,0,5750,7500,0,13250,6550,13435,7685,4235.68
50225952,FA2024 ,14750,600,5030,1270,21650,7000,7000,0,6750,7000,0,13750,8350,14650,7900,4235.68
50225952,SP2022 ,13005,515,4260,2220,20000,7000,7000,0,5250,8000,0,13250,5520,12000,6750,4235.68
50225952,SP2023 ,13500,550,4560,2325,20935,7500,7500,0,5750,7500,0,13250,6550,13435,7685,4235.68
50225952,SP2024 ,14750,600,5030,1270,21650,7000,7000,0,6750,7000,0,13750,8350,14650,7900,4235.68
50229105,FA2023 ,13500,550,4000,2325,20375,6500,6500,0,2750,9223,0,11973,4827,11152,8402,4494.25
50229105,FA2024 ,14750,600,4200,2450,22000,6500,6500,0,3250,10598,0,13848,4752,11402,8152,4494.25
50229105,SP2023 ,13500,550,4000,2325,20375,6750,6750,0,2750,9472,0,12222,4578,10903,8153,4494.25
50229105,SP2024 ,14750,600,4200,2450,22000,6500,6500,0,3250,10597,0,13847,4753,11403,8153,4494.25
50120114,FA2023 ,13500,550,4560,2325,20935,7500,7500,0,14290,7500,0,21790,6550,13435,-855,0
50120114,FA2024 ,14750,600,4790,2450,22590,7500,7500,0,14750,7500,0,22250,7850,15090,340,0
50120114,SP2023 ,13500,550,4560,2325,20935,7500,7500,0,12710,7500,0,20210,6550,13435,725,0
50120114,SP2024 ,14750,600,4790,2450,22590,7500,7500,0,14750,7500,0,22250,7850,15090,340,0
50220881,FA2021 ,12625,500,4580,2110,19815,8400,8400,0,11050,9400,0,20450,3725,10415,-635,-673
50220881,FA2022 ,13005,515,3855,1140,18515,7650,5250,2400,3250,14028,0,17278,-508,4487,1237,-673
50220881,FA2023 ,13500,550,4560,1200,19810,7650,5250,2400,5500,13783,0,19283,267,6027,527,-673
50220881,FA2024 ,14750,600,NULL,NULL,15350,5969,3569,2400,20280,5969,0,26249,9381,9381,-10899,-673
50220881,SP2021 ,12625,500,4580,2110,19815,8400,8400,0,11050,8400,0,19450,4725,11415,365,-673
50220881,SP2022 ,13005,515,3855,1140,18515,7650,5250,2400,3250,14027,0,17277,-507,4488,1238,-673
50220881,SP2023 ,13500,550,NULL,NULL,14050,5279,2879,2400,13000,7851,0,20851,6199,6199,-6801,-673
50220881,SP2024 ,14750,600,NULL,NULL,15350,5968,3568,2400,20280,5968,0,26248,9382,9382,-10898,-673
50231340,FA2024 ,14750,600,4200,2450,22000,9500,0,9500,2750,9500,0,12250,5850,12500,9750,0
50231340,SP2024 ,14750,600,4200,2450,22000,9500,0,9500,1551,9500,0,11051,5850,12500,10949,0
50203808,FA2021 ,12625,6350,6350,NULL,18975,0,0,0,2711,13625,12625,16336,5350,5350,2639,0
50203808,SP2021 ,12625,500,4830,1080,19035,0,0,0,3750,12625,12625,16375,500,6410,2660,0
50227718,FA2023 ,13500,550,5150,2325,21525,6500,6500,0,2750,6500,0,9250,7550,15025,12275,0
50227718,SP2023 ,13500,550,5150,2325,21525,6500,6500,0,2750,6500,0,9250,7550,15025,12275,0
50201149,FA2021 ,6960,250,NULL,NULL,7210,1240,0,1240,6250,5084,0,11334,2126,2126,-4124,0
50202004,FA2021 ,12625,500,4270,1080,18475,2175,0,2175,3750,6248,0,9998,6877,12227,8477,0
50215094,FA2021 ,12625,500,3740,2110,18975,6425,6425,0,3750,7925,0,11675,5200,11050,7300,0
50215094,FA2022 ,13005,515,3855,2220,19595,6425,6425,0,3750,6425,0,10175,7095,13170,9420,0
50215094,SP2021 ,12625,500,3740,2110,18975,6425,6425,0,0,6425,0,6425,6700,12550,12550,0
50215094,SP2022 ,13005,515,3855,2220,19595,6425,6425,0,3750,6425,0,10175,7095,13170,9420,0
50232221,FA2024 ,14750,600,5410,2450,23210,9400,7500,1900,2750,13898,0,16648,1452,9312,6562,0
50232221,SP2024 ,14750,600,5410,2450,23210,9400,7500,1900,2750,13897,0,16647,1453,9313,6563,0
60001257,FA2024 ,2120,NULL,NULL,NULL,2120,0,0,0,NULL,2120,2120,2120,0,0,0,0
50119420,FA2022 ,13005,515,4810,2220,20550,6500,6500,0,16324,6500,0,22824,7020,14050,-2274,-552
50119420,FA2023 ,13500,550,4560,2325,20935,6500,6500,0,12715,7000,0,19715,7050,13935,1220,-552
50119420,FA2024 ,14750,600,5030,1270,21650,6500,6500,0,16280,6500,0,22780,8850,15150,-1130,-552
50119420,SP2022 ,13005,515,4810,2220,20550,6500,6500,0,16324,6500,0,22824,7020,14050,-2274,-552
50119420,SP2023 ,13500,550,4560,2325,20935,6500,6500,0,12715,7000,0,19715,7050,13935,1220,-552
50119420,SP2024 ,14750,600,5030,1270,21650,6500,6500,0,16280,6500,0,22780,8850,15150,-1130,-552
50216139,FA2021 ,12625,500,4580,2110,19815,9925,9225,700,10596,11425,0,22021,1700,8390,-2206,0
50216139,FA2022 ,13005,515,3855,NULL,17375,9925,9225,700,7788,9925,0,17713,3595,7450,-338,0
50216139,FA2023 ,13500,550,5440,NULL,19490,9925,0,9925,7066,12548,0,19614,1502,6942,-124,0
50216139,SP2021 ,12625,500,4580,1080,18785,9925,9225,700,10366,9925,0,20291,3200,8860,-1506,0
50216139,SP2022 ,13005,515,4810,1140,19470,8425,7725,700,11672,8425,0,20097,5095,11045,-627,0
50216139,SP2023 ,13500,550,5440,NULL,19490,9925,0,9925,8798,12547,0,21345,1503,6943,-1855,0
50222519,FA2021 ,12625,500,4580,2110,19815,8250,8250,0,3250,10500,0,13750,2625,9315,6065,0
50222519,FA2022 ,13005,515,4810,2220,20550,8500,8500,0,4250,9750,0,14000,3770,10800,6550,0
50222519,FA2023 ,13500,550,4790,NULL,18840,9000,6500,2500,5750,9000,0,14750,5050,9840,4090,0
50222519,SP2021 ,12625,500,4580,2110,19815,8250,8250,0,3250,9500,0,12750,3625,10315,7065,0
50222519,SP2022 ,13005,515,4810,2220,20550,8500,8500,0,4250,9750,0,14000,3770,10800,6550,0
50222519,SP2023 ,13500,550,4790,NULL,18840,9000,6500,2500,5750,9000,0,14750,5050,9840,4090,0
50225052,FA2022 ,13005,515,4810,2220,20550,5250,5250,0,2750,5250,0,8000,8270,15300,12550,0
50225052,FA2023 ,13500,550,5150,2325,21525,5250,5250,0,NULL,5250,0,5250,8800,16275,16275,0
50225052,SP2022 ,13005,515,4810,2220,20550,5250,5250,0,2750,5250,0,8000,8270,15300,12550,0
50221703,FA2021 ,12625,500,4050,2110,19285,0,0,0,NULL,13125,12625,13125,0,6160,6160,-883
50221703,FA2022 ,13005,515,3855,2220,19595,0,0,0,NULL,13005,13005,13005,515,6590,6590,-883
50221703,FA2023 ,13500,550,4000,2325,20375,0,0,0,NULL,13500,13500,13500,550,6875,6875,-883
50221703,FA2024 ,14750,600,5030,NULL,20380,0,0,0,NULL,14750,14750,14750,600,5630,5630,-883
50221703,SP2021 ,12625,500,3740,2110,18975,0,0,0,NULL,12625,12625,12625,500,6350,6350,-883
50221703,SP2022 ,13005,515,3855,2220,19595,0,0,0,NULL,13005,13005,13005,515,6590,6590,-883
50221703,SP2023 ,13500,550,4000,2325,20375,0,0,0,NULL,13500,13500,13500,550,6875,6875,-883
50221703,SP2024 ,14750,600,5030,0,20380,0,0,0,NULL,14750,14750,14750,600,5630,5630,-883
50222792,FA2021 ,12625,500,4580,2110,19815,6000,6000,0,2750,6500,0,9250,6625,13315,10565,0
50222792,FA2022 ,13005,515,4810,2220,20550,5500,5500,0,NULL,5500,0,5500,8020,15050,15050,0
50222792,FA2023 ,13500,550,4000,2325,20375,0,0,0,NULL,0,0,0,14050,20375,20375,0
50222792,SP2021 ,12625,500,4580,2110,19815,6000,6000,0,2750,6000,0,8750,7125,13815,11065,0
50222792,SP2022 ,13005,515,4810,2220,20550,5500,5500,0,NULL,5500,0,5500,8020,15050,15050,0
50222792,SP2023 ,13500,550,4000,2325,20375,0,0,0,NULL,0,0,0,14050,20375,20375,0
50229170,FA2023 ,13500,550,5150,2325,21525,8000,8000,0,2750,8000,0,10750,6050,13525,10775,0
50229170,FA2024 ,14750,600,4200,2450,22000,8500,8500,0,NULL,8500,0,8500,6850,13500,13500,0
50229170,SP2023 ,13500,550,5150,2325,21525,8000,8000,0,2750,8000,0,10750,6050,13525,10775,0
50229170,SP2024 ,14750,600,4200,2450,22000,8500,8500,0,NULL,8500,0,8500,6850,13500,13500,0
50209444,FA2021 ,12625,500,4830,NULL,17955,2425,2425,0,3250,3425,0,6675,9700,14530,11280,0
50209444,FA2022 ,13005,515,5080,NULL,18600,2425,2425,0,3750,2425,0,6175,11095,16175,12425,0
50209444,SP2021 ,12625,500,4830,NULL,17955,2425,2425,0,3250,2425,0,5675,10700,15530,12280,0
50209444,SP2022 ,5360,515,5080,NULL,10955,999,999,0,3750,999,0,4749,4876,9956,6206,0
50232103,FA2024 ,14750,600,5410,2680,23440,10500,10500,0,0,17698,0,17698,-2348,5742,5742,0
50204376,FA2021 ,12625,500,4270,1080,18475,7175,7175,0,1900,8675,0,10575,4450,9800,7900,0
50204376,SP2021 ,12625,500,4270,NULL,17395,7175,7175,0,1900,7175,0,9075,5950,10220,8320,0
50224662,FA2022 ,13005,515,4810,2220,20550,5250,5250,0,7971,5250,0,13221,8270,15300,7329,4974
50224662,FA2023 ,13500,550,5150,2535,21735,5250,5250,0,6905,5250,0,12155,8800,16485,9580,4974
50224662,FA2024 ,14750,600,5410,2450,23210,5250,5250,0,8750,5250,0,14000,10100,17960,9210,4974
50224662,SP2022 ,13005,515,4810,2220,20550,5250,5250,0,7971,5250,0,13221,8270,15300,7329,4974
50224662,SP2023 ,13500,550,5150,2535,21735,5250,5250,0,6904,5250,0,12154,8800,16485,9581,4974
50224662,SP2024 ,14750,600,5410,2450,23210,5250,5250,0,8750,5250,0,14000,10100,17960,9210,4974
50221945,FA2021 ,12625,500,4580,2110,19815,7000,7000,0,2750,8000,0,10750,5125,11815,9065,0
50221945,FA2022 ,13005,515,4810,2220,20550,6500,6500,0,0,6500,0,6500,7020,14050,14050,0
50221945,SP2021 ,12625,500,4580,2110,19815,7000,7000,0,2750,7000,0,9750,6125,12815,10065,0
50205295,FA2021 ,12625,6350,6350,NULL,18975,3925,3925,0,NULL,3925,0,3925,15050,15050,15050,0
50205295,SP2021 ,12625,500,4270,1080,18475,3925,3925,0,NULL,3925,0,3925,9200,14550,14550,0
50235834,SP2024 ,14750,600,5410,2450,23210,9300,9300,0,2750,11835,0,14585,3515,11375,8625,0
50209629,FA2021 ,12625,500,4580,2110,19815,0,0,0,3250,14925,12625,18175,-1800,4890,1640,-96.3
50209629,FA2022 ,13005,515,4810,2220,20550,0,0,0,3750,17815,13005,21565,-4295,2735,-1015,-96.3
50209629,FA2023 ,13500,550,5150,2325,21525,0,0,0,3750,14500,13500,18250,-450,7025,3275,-96.3
50209629,FA2024 ,14750,600,4200,2450,22000,0,0,0,3750,15750,14750,19500,-400,6250,2500,-96.3
50209629,SP2021 ,12625,500,4580,2110,19815,0,0,0,3250,12625,12625,15875,500,7190,3940,-96.3
50209629,SP2022 ,13005,515,4810,2220,20550,0,0,0,3750,17815,13005,21565,-4295,2735,-1015,-96.3
50209629,SP2023 ,13500,550,5150,2325,21525,0,0,0,3750,13500,13500,17250,550,8025,4275,-96.3
50209629,SP2024 ,14750,600,4200,2450,22000,0,0,0,3750,14750,14750,18500,600,7250,3500,-96.3
50229306,FA2024 ,8140,300,NULL,NULL,8440,2666,2666,0,NULL,2666,0,2666,5774,5774,5774,2472.4
50229306,SP2023 ,7450,275,NULL,NULL,7725,2665,2665,0,NULL,2665,0,2665,5060,5060,5060,2472.4
50229306,SP2024 ,8140,300,NULL,NULL,8440,2666,2666,0,NULL,2666,0,2666,5774,5774,5774,2472.4
50226988,FA2022 ,13005,515,3855,2220,19595,7500,7500,0,NULL,7500,0,7500,6020,12095,12095,15366.33
50226988,FA2023 ,13500,550,4000,2325,20375,7500,7500,0,NULL,7500,0,7500,6550,12875,12875,15366.33
50226988,FA2024 ,14750,600,5030,1270,21650,7500,7500,0,NULL,7500,0,7500,7850,14150,14150,15366.33
50226988,SP2022 ,13005,515,3855,2220,19595,7500,7500,0,NULL,7500,0,7500,6020,12095,12095,15366.33
50226988,SP2023 ,13500,550,4000,2325,20375,7500,7500,0,NULL,7500,0,7500,6550,12875,12875,15366.33
50226988,SP2024 ,14750,600,5030,1270,21650,7500,7500,0,NULL,7500,0,7500,7850,14150,14150,15366.33
50216209,FA2021 ,19340,860,860,NULL,20200,14000,12125,1875,0,21998,0,21998,-1798,-1798,-1798,0
50216209,FA2022 ,19910,890,890,NULL,20800,14750,9000,5750,0,19998,0,19998,802,802,802,0
50216209,FA2023 ,20670,950,950,NULL,21620,12750,7000,5750,0,18348,0,18348,3272,3272,3272,0
50216209,SP2021 ,19340,860,860,NULL,20200,14000,12125,1875,0,21057,0,21057,-857,-857,-857,0
50216209,SP2022 ,19910,890,890,NULL,20800,14750,9000,5750,0,19997,0,19997,803,803,803,0
50216209,SP2023 ,20670,950,950,NULL,21620,12750,7000,5750,0,18347,0,18347,3273,3273,3273,0
50223838,FA2022 ,13005,515,4810,2220,20550,6750,6750,0,2750,6750,0,9500,6770,13800,11050,-450
50223838,FA2023 ,13500,550,5150,2325,21525,6250,6250,0,3250,6250,0,9500,7800,15275,12025,-450
50223838,FA2024 ,14750,600,5030,1270,21650,6850,6250,600,3750,6850,0,10600,8500,14800,11050,-450
50223838,SP2022 ,13005,515,4810,2220,20550,7150,6750,400,2750,7150,0,9900,6370,13400,10650,-450
50223838,SP2024 ,14750,600,5030,1270,21650,6250,6250,0,3750,6650,0,10400,8700,15000,11250,-450
50222500,FA2021 ,12625,500,3740,2110,18975,5950,5950,0,4750,13048,0,17798,77,5927,1177,0
50222500,FA2022 ,13005,515,3855,1140,18515,5450,5450,0,5250,10073,0,15323,3447,8442,3192,0
50222500,FA2023 ,13500,550,NULL,NULL,14050,5498,2923,2575,6250,8721,0,14971,5329,5329,-921,0
50222500,FA2024 ,14750,600,NULL,NULL,15350,5123,2923,2200,6250,10721,0,16971,4629,4629,-1621,0
50222500,SP2021 ,12625,500,3740,2110,18975,5950,5950,0,4750,12607,0,17357,518,6368,1618,0
50222500,SP2022 ,13005,515,NULL,NULL,13520,3373,3373,0,5250,7995,0,13245,5525,5525,275,0
50222500,SP2023 ,13500,550,NULL,NULL,14050,5498,2923,2575,6250,8720,0,14970,5330,5330,-920,0
50222500,SP2024 ,14750,600,NULL,NULL,15350,5123,2923,2200,6250,10720,0,16970,4630,4630,-1620,0
50209429,FA2021 ,12625,500,4270,1080,18475,5925,5302,623,3750,6925,0,10675,6200,11550,7800,0
50209429,FA2022 ,13005,515,4610,NULL,18130,5975,5875,100,NULL,5975,0,5975,7545,12155,12155,0
50209429,SP2021 ,12625,500,4270,NULL,17395,5925,5303,622,3750,5925,0,9675,7200,11470,7720,0
50228662,FA2023 ,13500,550,4560,2325,20935,8000,8000,0,2750,11500,0,14250,2550,9435,6685,0
50228662,FA2024 ,14750,600,5720,1270,22340,8000,8000,0,NULL,10500,0,10500,4850,11840,11840,0
50228662,SP2023 ,13500,550,4560,2325,20935,8000,8000,0,2750,8000,0,10750,6050,12935,10185,0
50228662,SP2024 ,14750,600,5720,NULL,21070,8000,8000,0,NULL,8000,0,8000,7350,13070,13070,0
50225164,FA2022 ,13005,515,3855,2220,19595,9000,9000,0,2750,9000,0,11750,4520,10595,7845,-5250
50225164,FA2023 ,13500,550,5150,2325,21525,9000,9000,0,NULL,14150,0,14150,-100,7375,7375,-5250
50225164,FA2024 ,14750,600,4200,1270,20820,9000,9000,0,NULL,11600,0,11600,3750,9220,9220,-5250
50225164,SP2022 ,13005,515,3855,2220,19595,9000,9000,0,2750,9000,0,11750,4520,10595,7845,-5250
50225164,SP2023 ,13500,550,5150,2325,21525,9000,9000,0,NULL,14150,0,14150,-100,7375,7375,-5250
50225164,SP2024 ,14750,600,4200,1270,20820,9000,9000,0,NULL,11600,0,11600,3750,9220,9220,-5250
50213257,FA2021 ,12625,500,4050,2110,19285,3925,0,3925,8709,11923,0,20632,1202,7362,-1347,0
50213257,FA2022 ,13005,515,5080,1140,19740,3425,0,3425,9201,10422,0,19623,3098,9318,117,0
50213257,SP2021 ,12625,500,4050,2110,19285,4425,0,4425,8710,11482,0,20192,1643,7803,-907,0
50213257,SP2022 ,13005,515,5080,1140,19740,3425,0,3425,9202,10423,0,19625,3097,9317,115,0
50218993,FA2021 ,12625,500,3740,2110,18975,345,0,345,0,22270,0,22270,-9145,-3295,-3295,0
50218993,FA2022 ,13005,515,3855,2220,19595,9500,0,9500,0,16250,0,16250,-2730,3345,3345,0
50218993,FA2023 ,13500,550,4000,2325,20375,10050,500,9550,3250,18175,0,21425,-4125,2200,-1050,0
50218993,FA2024 ,14750,600,4200,2900,22450,9500,0,9500,0,26700,0,26700,-11350,-4250,-4250,0
50218993,SP2021 ,12625,500,3740,2110,18975,18655,0,18655,0,20405,0,20405,-7280,-1430,-1430,0
50218993,SP2022 ,13005,515,3855,2220,19595,9500,0,9500,0,11250,0,11250,2270,8345,8345,0
50218993,SP2023 ,13500,6825,6825,NULL,20325,10000,10000,0,3250,10000,0,13250,10325,10325,7075,0
50218993,SP2024 ,14750,600,4200,2900,22450,9500,0,9500,0,11500,0,11500,3850,10950,10950,0
50227665,FA2023 ,13500,550,4000,2325,20375,8000,8000,0,2750,15000,0,17750,-950,5375,2625,-1315
50227665,FA2024 ,14750,600,5410,2450,23210,7500,7500,0,3250,16100,0,19350,-750,7110,3860,-1315
50227665,SP2023 ,13500,550,4000,2535,20585,8000,8000,0,2750,8000,0,10750,6050,12585,9835,-1315
50227665,SP2024 ,14750,600,5410,2680,23440,8000,8000,0,3250,10000,0,13250,5350,13440,10190,-1315
50225297,FA2022 ,13005,515,3855,2220,19595,7850,7850,0,2750,11073,0,13823,2447,8522,5772,1851.73
50225297,FA2023 ,13500,550,4000,2325,20375,8100,8100,0,3250,15273,0,18523,-1223,5102,1852,1851.73
50225297,FA2024 ,14750,7250,7250,NULL,22000,7850,750,7100,15750,10805,0,26555,11195,11195,-4555,1851.73
50225297,SP2022 ,13005,515,3855,2220,19595,7850,7850,0,2750,11072,0,13822,2448,8523,5773,1851.73
50225297,SP2023 ,13500,550,4000,2325,20375,7850,7850,0,3250,15022,0,18272,-972,5353,2103,1851.73
50225297,SP2024 ,14750,600,5410,2450,23210,7850,750,7100,8750,10805,0,19555,4545,12405,3655,1851.73
50209459,FA2021 ,12625,500,3740,2110,18975,5725,5375,350,3250,11198,0,14448,1927,7777,4527,0
50209459,SP2021 ,12625,500,3740,2110,18975,5725,5375,350,3250,9197,0,12447,3928,9778,6528,0
50232745,FA2024 ,14750,600,4200,2450,22000,9000,9000,0,NULL,9000,0,9000,6350,13000,13000,-137
50232745,SP2024 ,14750,600,4200,2450,22000,9000,9000,0,NULL,9000,0,9000,6350,13000,13000,-137
50119639,FA2021 ,6960,250,NULL,NULL,7210,0,0,0,NULL,0,0,0,7210,7210,7210,15565.49
50119639,SP2023 ,7450,275,NULL,NULL,7725,2000,0,2000,0,2000,0,2000,5725,5725,5725,15565.49
50235189,FA2024 ,14750,600,4200,2450,22000,11628,9628,2000,2750,16826,0,19576,-1476,5174,2424,75
50223925,FA2021 ,12625,500,3740,2110,18975,6900,6900,0,2750,12523,0,15273,602,6452,3702,0
50223925,FA2022 ,13005,515,3855,2220,19595,7300,6010,1290,3750,14978,0,18728,-1458,4617,867,0
50223925,FA2023 ,13500,550,4000,2325,20375,7300,6000,1300,3750,15223,0,18973,-1173,5152,1402,0
50223925,FA2024 ,14750,600,4200,2450,22000,7300,6000,1300,2750,16198,0,18948,-848,5802,3052,0
50223925,SP2021 ,12625,500,3740,2110,18975,6900,6900,0,2750,11022,0,13772,2103,7953,5203,0
50223925,SP2022 ,13005,515,3855,2220,19595,7300,6010,1290,3750,14977,0,18727,-1457,4618,868,0
50223925,SP2023 ,13500,550,4000,2325,20375,7300,6000,1300,3750,15222,0,18972,-1172,5153,1403,0
50223925,SP2024 ,14750,600,4200,2450,22000,7300,6000,1300,3750,16197,0,19947,-847,5803,2053,0
50231095,FA2023 ,13500,550,5150,2325,21525,6500,6500,0,2750,6500,0,9250,7550,15025,12275,9.7
50231095,FA2024 ,14750,600,5410,2450,23210,6500,6500,0,NULL,6500,0,6500,8850,16710,16710,9.7
50231095,SP2023 ,13500,550,5150,2325,21525,6500,6500,0,2750,6500,0,9250,7550,15025,12275,9.7
50231095,SP2024 ,14750,600,5410,2450,23210,6500,6500,0,NULL,6500,0,6500,8850,16710,16710,9.7
50198629,FA2021 ,12625,500,3740,2110,18975,9425,8425,1000,NULL,10925,0,10925,2200,8050,8050,0
50208965,FA2022 ,13005,515,3855,2220,19595,4213,4213,0,NULL,4213,0,4213,9307,15382,15382,0
50208965,SP2021 ,12625,500,3740,2110,18975,8425,8425,0,NULL,8425,0,8425,4700,10550,10550,0
50209875,FA2022 ,14269,7231,7231,NULL,21500,0,0,0,NULL,0,0,0,21500,21500,21500,0
50230905,FA2023 ,13500,550,4560,2745,21355,6500,6500,0,17389,6500,0,23889,7550,14855,-2534,0
50221349,FA2021 ,12625,500,4580,2110,19815,8500,8500,0,12431,10773,0,23204,2352,9042,-3389,0
50221349,FA2022 ,13005,515,3855,2220,19595,8000,8000,0,10559,8000,0,18559,5520,11595,1036,0
50221349,FA2023 ,13500,550,4000,2325,20375,8300,8300,0,14191,8300,0,22491,5750,12075,-2116,0
50221349,FA2024 ,14750,600,5030,1270,21650,7500,5000,2500,8971,11198,0,20169,4152,10452,1481,0
50221349,SP2021 ,12625,500,4580,2110,19815,8500,8500,0,12432,9022,0,21454,4103,10793,-1639,0
50221349,SP2022 ,13005,515,3855,2220,19595,8000,8000,0,10559,8000,0,18559,5520,11595,1036,0
50221349,SP2023 ,13500,550,4000,2325,20375,8300,8300,0,14192,8300,0,22492,5750,12075,-2117,0
50221349,SP2024 ,14750,600,5030,NULL,20380,8000,5500,2500,8971,11697,0,20668,3653,8683,-288,0
50235007,FA2024 ,14750,600,4200,2450,22000,10100,7000,3100,2750,12858,0,15608,2492,9142,6392,0
50235007,SP2024 ,14750,600,4200,2450,22000,10100,7000,3100,2750,12857,0,15607,2493,9143,6393,0
50231723,FA2024 ,14750,600,4200,2450,22000,5500,5500,0,15600,6000,0,21600,9350,16000,400,5
50231723,SP2024 ,14750,600,4200,2450,22000,5500,5500,0,15600,5500,0,21100,9850,16500,900,5
50195299,FA2021 ,6960,250,NULL,NULL,7210,965,965,0,2750,965,0,3715,6245,6245,3495,0
50228401,FA2023 ,13500,550,4000,2325,20375,10950,8950,2000,3750,12723,0,16473,1327,7652,3902,5433.34
50228401,FA2024 ,14750,600,4200,2450,22000,9050,9050,0,3750,13148,0,16898,2202,8852,5102,5433.34
50228401,SP2023 ,13500,550,4000,2325,20375,8950,8950,0,3750,10722,0,14472,3328,9653,5903,5433.34
50228401,SP2024 ,14750,600,4200,2450,22000,9050,9050,0,3750,13147,0,16897,2203,8853,5103,5433.34
50211384,FA2021 ,12625,500,3740,2110,18975,0,0,0,NULL,0,0,0,13125,18975,18975,0
50222488,FA2021 ,12625,500,4580,2110,19815,8500,8500,0,2500,9500,0,12000,3625,10315,7815,-200
50222488,FA2022 ,13005,515,3855,2220,19595,8000,8000,0,2500,9000,0,11500,4520,10595,8095,-200
50222488,FA2023 ,13500,550,4790,1200,20040,8000,8000,0,3750,9000,0,12750,5050,11040,7290,-200
50222488,SP2021 ,12625,500,4580,2110,19815,8500,8500,0,2500,8500,0,11000,4625,11315,8815,-200
50222488,SP2022 ,13005,515,3855,2220,19595,8000,8000,0,2500,8000,0,10500,5520,11595,9095,-200
50222488,SP2023 ,13500,550,4790,1200,20040,8000,8000,0,3750,8000,0,11750,6050,12040,8290,-200
50221884,FA2021 ,12625,500,3740,2550,19415,5000,5000,0,15545,7800,0,23345,5325,11615,-3930,0
50221884,FA2022 ,13005,515,4810,2690,21020,4500,4500,0,15425,4500,0,19925,9020,16520,1095,0
50221884,FA2023 ,13500,550,4560,2535,21145,4500,4500,0,3750,4500,0,8250,9550,16645,12895,0
50221884,FA2024 ,14750,600,5410,2450,23210,4500,4500,0,20750,4500,0,25250,10850,18710,-2040,0
50221884,SP2021 ,12625,500,3740,2550,19415,5000,5000,0,15544,5000,0,20544,8125,14415,-1129,0
50221884,SP2022 ,13005,515,4810,2690,21020,4500,4500,0,15425,4500,0,19925,9020,16520,1095,0
50221884,SP2023 ,13500,550,4560,2535,21145,4500,4500,0,16750,4500,0,21250,9550,16645,-105,0
50221884,SP2024 ,14750,600,5410,2450,23210,4500,4500,0,18750,4500,0,23250,10850,18710,-40,0
50225818,FA2022 ,13005,515,4810,2220,20550,6750,6750,0,15944,6750,0,22694,6770,13800,-2144,0
50225818,FA2023 ,13500,550,4000,2325,20375,6750,5750,1000,13574,6750,0,20324,7300,13625,51,0
50225818,SP2022 ,13005,515,4810,2220,20550,6750,6750,0,15944,6750,0,22694,6770,13800,-2144,0
50225818,SP2023 ,13500,550,4000,2325,20375,6750,5750,1000,13574,6750,0,20324,7300,13625,51,0
50229071,FA2023 ,13500,550,4560,2325,20935,5150,5150,0,0,8848,0,8848,5202,12087,12087,0
40001037,FA2021 ,12625,500,4580,2110,19815,4675,4675,0,3750,7675,0,11425,5450,12140,8390,0
40001037,FA2022 ,13005,515,5080,NULL,18600,4675,0,4675,NULL,5675,0,5675,7845,12925,12925,0
40001037,SP2021 ,12625,500,4580,2110,19815,4675,4675,0,3750,4675,0,8425,8450,15140,11390,0
40001037,SP2022 ,5360,515,5080,NULL,10955,1927,0,1927,NULL,2927,0,2927,2948,8028,8028,0
50209117,FA2021 ,12625,500,3740,2110,18975,12540,10725,1815,0,17940,0,17940,-4815,1035,1035,0
50209117,FA2022 ,13005,515,3855,NULL,17375,12575,10725,1850,3750,15097,0,18847,-1577,2278,-1472,0
50209117,FA2023 ,13500,550,NULL,NULL,14050,11325,1000,10325,3750,13797,0,17547,253,253,-3497,0
50209117,SP2021 ,12625,500,3740,2110,18975,11825,10725,1100,0,11825,0,11825,1300,7150,7150,0
50209117,SP2022 ,13005,515,3855,NULL,17375,12575,10725,1850,3750,15098,0,18848,-1578,2277,-1473,0
50225166,FA2022 ,13005,515,4810,2220,20550,9500,0,9500,2750,9500,0,12250,4020,11050,8300,2821.32
50225166,FA2023 ,13500,550,5150,2325,21525,9500,0,9500,3250,9500,0,12750,4550,12025,8775,2821.32
50225166,FA2024 ,14750,600,4790,1270,21410,9500,0,9500,3750,9500,0,13250,5850,11910,8160,2821.32
50225166,SP2022 ,13005,515,4810,2220,20550,9500,0,9500,2750,9500,0,12250,4020,11050,8300,2821.32
50225166,SP2023 ,15240,550,5150,2325,23265,9500,0,9500,3250,9500,0,12750,6290,13765,10515,2821.32
50225166,SP2024 ,14750,600,4790,1270,21410,9500,0,9500,3750,9500,0,13250,5850,11910,8160,2821.32
50110104,FA2021 ,6960,500,4270,2110,13840,4369,4369,0,3250,5869,0,9119,1591,7971,4721,0
50110104,FA2022 ,13005,515,3855,2220,19595,7925,0,7925,3750,7925,0,11675,5595,11670,7920,0
50110104,FA2023 ,13500,550,4000,2325,20375,0,0,0,3750,13500,13500,17250,550,6875,3125,0
50110104,FA2024 ,4070,0,NULL,NULL,4070,0,0,0,3000,4070,4070,7070,0,0,-3000,0
50110104,SP2021 ,12625,500,4270,2110,19505,7925,7925,0,3250,7925,0,11175,5200,11580,8330,0
50110104,SP2022 ,7170,515,3855,2220,13760,4369,0,4369,3750,4369,0,8119,3316,9391,5641,0
50110104,SP2023 ,7450,550,4000,2325,14325,0,0,0,3750,7450,7450,11200,550,6875,3125,0
50222070,FA2021 ,12625,500,3740,2110,18975,8000,8000,0,0,19023,0,19023,-5898,-48,-48,0
50222070,FA2022 ,13005,515,3855,2220,19595,7500,5000,2500,3250,9123,0,12373,4397,10472,7222,0
50222070,FA2023 ,13500,550,5181,2325,21556,7500,5000,2500,3750,9373,0,13123,4677,12183,8433,0
50222070,FA2024 ,14750,600,5720,1270,22340,8000,7500,500,3750,12098,0,15848,3252,10242,6492,0
50222070,SP2021 ,12625,500,3740,2110,18975,8000,8000,0,1750,9522,0,11272,3603,9453,7703,0
50222070,SP2022 ,13005,515,3855,2220,19595,7500,5000,2500,3250,9122,0,12372,4398,10473,7223,0
50222070,SP2023 ,13500,550,5440,1200,20690,7500,5000,2500,3750,9372,0,13122,4678,11318,7568,0
50217483,FA2021 ,12625,500,3740,2110,18975,6925,6925,0,3250,12148,0,15398,977,6827,3577,0
50217483,FA2022 ,13005,515,3855,2220,19595,6425,6425,0,3750,10697,0,14447,2823,8898,5148,0
50217483,FA2023 ,13500,550,4550,2325,20925,6925,6925,0,3750,10597,0,14347,3453,10328,6578,0
50217483,SP2021 ,12625,500,3740,2110,18975,6925,6925,0,3250,10147,0,13397,2978,8828,5578,0
50217483,SP2022 ,13005,515,3855,2220,19595,6425,6425,0,3750,10698,0,14448,2822,8897,5147,0
50217483,SP2023 ,13500,550,4550,2325,20925,6925,6925,0,3750,10598,0,14348,3452,10327,6577,0
50216599,FA2021 ,12625,500,4050,2110,19285,7825,7825,0,3250,9325,0,12575,3800,9960,6710,1300
50216599,FA2022 ,13005,515,NULL,1140,14660,6325,6325,0,11250,6325,0,17575,7195,8335,-2915,1300
50216599,FA2023 ,13500,550,NULL,1200,15250,6325,6325,0,11230,6325,0,17555,7725,8925,-2305,1300
50216599,FA2024 ,14750,600,NULL,1270,16620,6325,0,6325,16750,6325,0,23075,9025,10295,-6455,1300
50216599,SP2021 ,12625,500,4050,2110,19285,7825,7825,0,8750,7825,0,16575,5300,11460,2710,1300
50216599,SP2022 ,13005,515,NULL,1140,14660,6325,6325,0,11250,6325,0,17575,7195,8335,-2915,1300
50216599,SP2023 ,13500,550,NULL,1200,15250,6325,6325,0,11230,6325,0,17555,7725,8925,-2305,1300
50216599,SP2024 ,14750,600,NULL,1270,16620,6325,0,6325,16750,6325,0,23075,9025,10295,-6455,1300
60001009,FA2023 ,13500,550,NULL,NULL,14050,0,0,0,NULL,13500,13500,13500,550,550,550,0
60001009,FA2024 ,14750,600,NULL,NULL,15350,0,0,0,NULL,14750,14750,14750,600,600,600,0
60001009,SP2023 ,13500,550,NULL,NULL,14050,0,0,0,NULL,13500,13500,13500,550,550,550,0
60001009,SP2024 ,14750,600,NULL,NULL,15350,0,0,0,NULL,14750,14750,14750,600,600,600,0
50235055,FA2024 ,14750,600,4790,2450,22590,9028,9028,0,NULL,9028,0,9028,6322,13562,13562,0
50235055,SP2024 ,14750,600,4790,2450,22590,9028,9028,0,NULL,9028,0,9028,6322,13562,13562,0
50205401,FA2021 ,12625,500,4830,1080,19035,4175,3175,1000,5750,6925,0,12675,6200,12110,6360,0
50205401,SP2021 ,12625,500,4830,1080,19035,3175,3175,0,5750,4425,0,10175,8700,14610,8860,0
50228494,FA2023 ,13500,550,4000,2325,20375,9000,9000,0,2750,9000,0,11750,5050,11375,8625,3366
50228494,FA2024 ,14750,600,4790,1270,21410,9000,9000,0,3250,9000,0,12250,6350,12410,9160,3366
50228494,SP2023 ,13500,550,4000,2325,20375,9250,9250,0,2750,9250,0,12000,4800,11125,8375,3366
50228494,SP2024 ,14750,600,4790,1270,21410,9000,9000,0,3250,9000,0,12250,6350,12410,9160,3366
50210140,FA2021 ,12625,500,4050,2550,19725,6125,5900,225,3750,7625,0,11375,5500,12100,8350,0
50210140,FA2022 ,13005,6590,6590,NULL,19595,1800,1800,0,NULL,1800,0,1800,17795,17795,17795,0
50210140,SP2021 ,12625,500,4050,2550,19725,6125,5900,225,3750,6125,0,9875,7000,13600,9850,0
50210140,SP2022 ,13005,515,5420,1140,20080,6125,5900,225,NULL,6125,0,6125,7395,13955,13955,0
50209833,FA2021 ,12625,500,NULL,1080,14205,1425,1425,0,11750,2425,0,14175,10700,11780,30,0
50209833,SP2021 ,12625,500,NULL,NULL,13125,1425,1425,0,12900,1425,0,14325,11700,11700,-1200,0
50233440,FA2024 ,14750,600,4200,2680,22230,7050,7050,0,13250,8645,0,21895,6705,13585,335,-1114
50233440,SP2024 ,14750,600,4200,2450,22000,7050,7050,0,13250,8645,0,21895,6705,13355,105,-1114
50204279,FA2021 ,12625,500,3740,1080,17945,1425,25,1400,3750,2925,0,6675,10200,15020,11270,0
50204279,SP2021 ,12625,500,3740,1080,17945,1425,25,1400,3750,1425,0,5175,11700,16520,12770,0
50228416,FA2023 ,13500,550,4990,2535,21575,6000,6000,0,2750,6000,0,8750,8050,15575,12825,0
50228416,FA2024 ,14750,600,4790,2450,22590,6000,6000,0,3250,6000,0,9250,9350,16590,13340,0
50228416,SP2023 ,13500,550,4990,2535,21575,6000,6000,0,2750,6000,0,8750,8050,15575,12825,0
50228416,SP2024 ,14750,600,4790,2450,22590,6000,6000,0,3250,6000,0,9250,9350,16590,13340,0
50227996,FA2023 ,13500,550,5150,2325,21525,6000,6000,0,17282,6000,0,23282,8050,15525,-1757,-3024
50227996,FA2024 ,14750,600,5410,2450,23210,6000,6000,0,18913,6000,0,24913,9350,17210,-1703,-3024
50227996,SP2023 ,13500,550,5150,2325,21525,6000,6000,0,17282,6000,0,23282,8050,15525,-1757,-3024
50227996,SP2024 ,14750,600,5410,2450,23210,6000,6000,0,18912,6000,0,24912,9350,17210,-1702,-3024
50233620,FA2024 ,14750,600,NULL,NULL,15350,5106,5106,0,2750,10304,0,13054,5046,5046,2296,0
50225208,FA2022 ,13005,515,3855,2220,19595,5000,5000,0,2750,5000,0,7750,8520,14595,11845,4969.66
50225208,FA2023 ,13500,550,4000,2325,20375,5000,5000,0,3250,5000,0,8250,9050,15375,12125,4969.66
50225208,FA2024 ,14750,600,5410,2450,23210,5000,5000,0,3750,5000,0,8750,10350,18210,14460,4969.66
50225208,SP2022 ,13005,515,3855,2220,19595,5000,5000,0,2750,5000,0,7750,8520,14595,11845,4969.66
50225208,SP2023 ,13500,550,4000,2325,20375,5000,5000,0,3250,5000,0,8250,9050,15375,12125,4969.66
50225208,SP2024 ,14750,600,5410,2450,23210,5000,5000,0,3750,5000,0,8750,10350,18210,14460,4969.66
50207064,FA2021 ,12625,500,4270,1080,18475,0,0,0,3750,1000,0,4750,12125,17475,13725,0
50207064,SP2021 ,12625,500,4270,1080,18475,0,0,0,3750,0,0,3750,13125,18475,14725,0
50209476,FA2021 ,12625,500,4830,NULL,17955,4175,0,4175,3750,5675,0,9425,7450,12280,8530,0
50232624,FA2024 ,14750,600,4790,2450,22590,7500,7500,0,2750,7500,0,10250,7850,15090,12340,4303
50232624,SP2024 ,14750,600,4790,2450,22590,7500,7500,0,2750,7500,0,10250,7850,15090,12340,4303
50221466,FA2021 ,12625,500,4580,2110,19815,9000,7487,1513,12403,10000,0,22403,3125,9815,-2588,1179
50221466,FA2022 ,13005,515,4810,2220,20550,7250,5750,1500,10552,8500,0,19052,5020,12050,1498,1179
50221466,FA2023 ,13500,550,4790,1200,20040,8750,5750,3000,12567,8750,0,21317,5300,11290,-1277,1179
50221466,FA2024 ,14750,600,5030,2450,22830,9150,6150,3000,15021,9150,0,24171,6200,13680,-1341,1179
50221466,SP2021 ,12625,500,4580,2110,19815,9000,7488,1512,12402,10000,0,22402,3125,9815,-2587,1179
50221466,SP2022 ,13005,515,4810,2220,20550,7250,5750,1500,14409,8500,0,22909,5020,12050,-2359,1179
50221466,SP2023 ,13500,550,4790,2325,21165,8500,5500,3000,10401,8500,0,18901,5550,12665,2264,1179
50221466,SP2024 ,14750,600,5030,2450,22830,8500,5500,3000,13015,8500,0,21515,6850,14330,1315,1179
50223102,FA2021 ,12625,500,NULL,NULL,13125,6400,6400,0,3250,8650,0,11900,4475,4475,1225,0
50223102,FA2022 ,13005,515,3855,3830,21205,7400,7400,0,3750,8650,0,12400,4870,12555,8805,0
50223102,FA2023 ,13500,550,NULL,1200,15250,4900,4900,0,3750,8623,0,12373,5427,6627,2877,0
50223102,FA2024 ,14750,600,NULL,1270,16620,5969,3319,2650,3750,11567,0,15317,3783,5053,1303,0
50223102,SP2021 ,12625,500,NULL,NULL,13125,6400,6400,0,3250,7650,0,10900,5475,5475,2225,0
50223102,SP2022 ,13005,515,NULL,NULL,13520,5900,5900,0,3750,7150,0,10900,6370,6370,2620,0
50223102,SP2023 ,13500,550,NULL,1200,15250,4900,4900,0,3750,8622,0,12372,5428,6628,2878,0
50223102,SP2024 ,14750,600,NULL,1270,16620,5968,3318,2650,3750,11565,0,15315,3785,5055,1305,0
50221741,FA2024 ,14750,600,4790,2450,22590,8028,8028,0,17324,8028,0,25352,7322,14562,-2762,0
50221741,SP2024 ,14750,600,4790,2450,22590,8028,8028,0,17324,8028,0,25352,7322,14562,-2762,0
50231909,FA2024 ,14750,600,4790,2450,22590,8000,8000,0,NULL,8000,0,8000,7350,14590,14590,0
50231909,SP2024 ,14750,600,4790,2450,22590,8000,8000,0,NULL,8000,0,8000,7350,14590,14590,0
50233293,FA2024 ,14750,600,4790,2450,22590,6000,6000,0,NULL,7000,0,7000,8350,15590,15590,0
50232773,FA2024 ,14750,600,4200,2450,22000,6100,6100,0,14250,6100,0,20350,9250,15900,1650,0
50232773,SP2024 ,14750,600,4200,2450,22000,6100,6100,0,14250,6100,0,20350,9250,15900,1650,0
50117876,FA2021 ,12625,500,NULL,NULL,13125,175,0,175,NULL,175,0,175,12950,12950,12950,0
50117876,FA2022 ,13005,515,NULL,NULL,13520,175,0,175,NULL,175,0,175,13345,13345,13345,0
50117876,SP2021 ,12625,500,NULL,NULL,13125,175,0,175,NULL,175,0,175,12950,12950,12950,0
50117876,SP2022 ,7170,257,NULL,NULL,7427,96,0,96,NULL,96,0,96,7331,7331,7331,0
50221061,FA2021 ,12625,500,4050,2110,19285,7500,7500,0,10059,7500,0,17559,5625,11785,1726,1673.33
50221061,FA2022 ,13005,515,4260,2220,20000,7000,7000,0,11603,7000,0,18603,6520,13000,1397,1673.33
50221061,FA2023 ,13500,550,5150,2325,21525,7000,7000,0,11581,7000,0,18581,7050,14525,2944,1673.33
50221061,FA2024 ,14750,600,5720,1270,22340,7000,7000,0,11581,7000,0,18581,8350,15340,3759,1673.33
50221061,SP2021 ,12625,500,4050,2110,19285,7500,7500,0,10059,7500,0,17559,5625,11785,1726,1673.33
50221061,SP2022 ,13005,515,4260,2220,20000,7000,7000,0,11603,7000,0,18603,6520,13000,1397,1673.33
50221061,SP2023 ,13500,550,5150,2325,21525,7000,7000,0,11581,7000,0,18581,7050,14525,2944,1673.33
50221061,SP2024 ,14750,600,5720,1270,22340,7000,7000,0,11582,7000,0,18582,8350,15340,3758,1673.33
50216613,FA2021 ,12625,500,NULL,NULL,13125,175,0,175,13169,1675,0,14844,11450,11450,-1719,0
50216613,FA2022 ,13005,515,NULL,NULL,13520,175,0,175,8971,175,0,9146,13345,13345,4374,0
50216613,FA2023 ,13500,550,NULL,NULL,14050,0,0,0,8971,0,0,8971,14050,14050,5079,0
50216613,SP2021 ,12625,500,NULL,NULL,13125,175,0,175,13170,175,0,13345,12950,12950,-220,0
50216613,SP2022 ,13005,515,NULL,NULL,13520,175,0,175,8971,175,0,9146,13345,13345,4374,0
50216613,SP2023 ,13500,550,NULL,NULL,14050,0,0,0,8971,0,0,8971,14050,14050,5079,0
50222057,FA2021 ,12625,500,4580,2110,19815,4500,4500,0,11625,5500,0,17125,7625,14315,2690,-2972
50222057,FA2022 ,13005,515,3855,2220,19595,4000,4000,0,12647,4000,0,16647,9520,15595,2948,-2972
50222057,FA2023 ,13500,550,4790,1200,20040,4000,4000,0,10015,4000,0,14015,10050,16040,6025,-2972
50222057,FA2024 ,14750,600,NULL,1270,16620,2760,2760,0,16280,2760,0,19040,12590,13860,-2420,-2972
50222057,SP2021 ,12625,500,4580,2110,19815,4500,4500,0,11625,4500,0,16125,8625,15315,3690,-2972
50222057,SP2022 ,13005,515,3855,2220,19595,4000,4000,0,12648,4000,0,16648,9520,15595,2947,-2972
50222057,SP2023 ,13500,550,4790,1200,20040,4000,4000,0,10014,4000,0,14014,10050,16040,6026,-2972
50222057,SP2024 ,14750,600,NULL,1270,16620,2760,2760,0,16280,2760,0,19040,12590,13860,-2420,-2972
50186498,FA2021 ,6960,250,NULL,NULL,7210,269,269,0,0,3770,0,3770,3440,3440,3440,7025
50222043,FA2021 ,12625,500,NULL,NULL,13125,2950,2950,0,12147,3950,0,16097,9175,9175,-2972,0
50222520,FA2021 ,12625,500,4580,1080,18785,9550,9550,0,2750,11800,0,14550,1325,6985,4235,290
50222520,FA2022 ,13005,515,3855,1140,18515,10800,7500,3300,NULL,10800,0,10800,2720,7715,7715,290
50222520,FA2023 ,13500,550,4000,15.5,18065.5,10800,7500,3300,NULL,10800,0,10800,3250,7265.5,7265.5,290
50222520,FA2024 ,14750,600,4200,NULL,19550,10800,7500,3300,NULL,10800,0,10800,4550,8750,8750,290
50222520,SP2021 ,12625,500,4580,2110,19815,9550,9550,0,2750,10800,0,13550,2325,9015,6265,290
50222520,SP2022 ,13005,515,3855,NULL,17375,10800,7500,3300,NULL,10800,0,10800,2720,6575,6575,290
50222520,SP2023 ,13500,550,4000,NULL,18050,10800,7500,3300,NULL,10800,0,10800,3250,7250,7250,290
50222520,SP2024 ,14750,600,4200,NULL,19550,10800,7500,3300,NULL,10800,0,10800,4550,8750,8750,290
50232683,FA2024 ,14750,600,NULL,NULL,15350,5969,5969,0,14750,5969,0,20719,9381,9381,-5369,873
50232683,SP2024 ,14750,600,NULL,NULL,15350,5968,5968,0,2750,5968,0,8718,9382,9382,6632,873
50217864,FA2021 ,12625,500,3740,2110,18975,5925,5925,0,3250,7425,0,10675,5700,11550,8300,0
50217864,FA2022 ,13005,515,5080,1140,19740,5925,5925,0,3750,5925,0,9675,7595,13815,10065,0
50217864,SP2021 ,12625,500,3740,2110,18975,5925,5925,0,3250,5925,0,9175,7200,13050,9800,0
50217864,SP2022 ,13005,515,5080,1140,19740,5925,5925,0,3750,5925,0,9675,7595,13815,10065,0
50121556,FA2021 ,12625,500,3740,2550,19415,7750,7750,0,16926,7750,0,24676,5375,11665,-5261,0
50121556,FA2022 ,13005,515,4810,2220,20550,8250,7250,1000,15243,8250,0,23493,5270,12300,-2943,0
50121556,FA2023 ,13500,550,5150,2535,21735,7250,7250,0,15750,7250,0,23000,6800,14485,-1265,0
50121556,FA2024 ,14750,7250,7250,NULL,22000,7250,7250,0,19412,7250,0,26662,14750,14750,-4662,0
50121556,SP2021 ,12625,500,3740,2550,19415,7750,7750,0,13456,7750,0,21206,5375,11665,-1791,0
50121556,SP2022 ,13005,515,4810,2220,20550,8250,7250,1000,15242,8250,0,23492,5270,12300,-2942,0
50121556,SP2023 ,13500,550,5150,2535,21735,7250,7250,0,15750,7250,0,23000,6800,14485,-1265,0
50121556,SP2024 ,14750,600,5720,NULL,21070,7250,7250,0,16280,7250,0,23530,8100,13820,-2460,0
50232048,FA2024 ,14750,600,5410,2450,23210,11000,9000,2000,2750,12000,0,14750,3350,11210,8460,2280
50232048,SP2024 ,14750,600,5410,2450,23210,9000,9000,0,2750,15250,0,18000,100,7960,5210,2280
50158543,FA2021 ,12625,500,4270,1080,18475,1425,1425,0,NULL,1425,0,1425,11700,17050,17050,0
50158543,FA2022 ,13005,515,NULL,1140,14660,0,0,0,NULL,0,0,0,13520,14660,14660,0
50158543,SP2021 ,12625,6350,6350,NULL,18975,925,925,0,NULL,925,0,925,18050,18050,18050,0
50158543,SP2022 ,13005,515,4610,1140,19270,0,0,0,NULL,0,0,0,13520,19270,19270,0
50231995,FA2024 ,14750,600,5410,2450,23210,11700,9000,2700,9140,12200,0,21340,3150,11010,1870,0
50231995,SP2024 ,14750,600,5410,2450,23210,11700,9000,2700,10890,12200,0,23090,3150,11010,120,0
50222634,FA2021 ,12625,500,NULL,NULL,13125,3105,3105,0,NULL,3105,0,3105,10020,10020,10020,9483.75
50222634,FA2022 ,13005,515,NULL,NULL,13520,2760,2760,0,NULL,2760,0,2760,10760,10760,10760,9483.75
50222634,FA2023 ,13500,550,NULL,2325,16375,2760,2760,0,NULL,2760,0,2760,11290,13615,13615,9483.75
50222634,FA2024 ,14750,600,NULL,NULL,15350,2760,2760,0,NULL,2760,0,2760,12590,12590,12590,9483.75
50222634,SP2021 ,12625,500,NULL,NULL,13125,3105,3105,0,NULL,3105,0,3105,10020,10020,10020,9483.75
50222634,SP2022 ,13005,515,NULL,NULL,13520,2760,2760,0,NULL,2760,0,2760,10760,10760,10760,9483.75
50222634,SP2023 ,13500,550,NULL,NULL,14050,2760,2760,0,NULL,2760,0,2760,11290,11290,11290,9483.75
50222634,SP2024 ,14750,600,NULL,NULL,15350,2760,2760,0,NULL,2760,0,2760,12590,12590,12590,9483.75
50232469,FA2024 ,14750,600,4200,2450,22000,9300,9300,0,11855,12388,0,24243,2962,9612,-2243,14
50232469,SP2024 ,14750,600,4200,2450,22000,9300,9300,0,9558,12387,0,21945,2963,9613,55,14
50229929,FA2023 ,13500,550,5150,2325,21525,7000,7000,0,0,7000,0,7000,7050,14525,14525,0
50229929,FA2024 ,14750,600,4790,2450,22590,7000,7000,0,3250,7000,0,10250,8350,15590,12340,0
50229929,SP2023 ,13500,550,5150,2325,21525,7000,7000,0,0,7000,0,7000,7050,14525,14525,0
50229929,SP2024 ,14750,600,4790,2450,22590,7000,7000,0,3250,7000,0,10250,8350,15590,12340,0
50229930,FA2023 ,13500,550,5150,2325,21525,7000,7000,0,2750,7000,0,9750,7050,14525,11775,0
50229930,FA2024 ,14750,600,4790,2450,22590,7000,7000,0,3750,7000,0,10750,8350,15590,11840,0
50229930,SP2023 ,13500,550,5150,2325,21525,7000,7000,0,2750,7000,0,9750,7050,14525,11775,0
50224988,FA2022 ,13005,515,4810,2220,20550,6500,6500,0,0,6500,0,6500,7020,14050,14050,0
50224988,FA2023 ,13500,550,5150,2325,21525,6500,6500,0,NULL,6500,0,6500,7550,15025,15025,0
50224988,FA2024 ,14750,600,5720,93.23,21163.23,6500,6500,0,NULL,6500,0,6500,8850,14663.23,14663.23,0
50224988,SP2022 ,13005,515,4810,2220,20550,6500,6500,0,0,6500,0,6500,7020,14050,14050,0
50224988,SP2023 ,13500,550,5150,2325,21525,6500,6500,0,NULL,6500,0,6500,7550,15025,15025,0
50224988,SP2024 ,14750,7250,7250,NULL,22000,3450,3450,0,NULL,3450,0,3450,18550,18550,18550,0
50228151,FA2023 ,13500,550,4000,2325,20375,7000,7000,0,13250,7000,0,20250,7050,13375,125,0
50228151,SP2023 ,13500,550,4560,2325,20935,7000,7000,0,13250,7000,0,20250,7050,13935,685,0
50228765,FA2023 ,13500,550,4000,2325,20375,6950,6950,0,2750,8200,0,10950,5850,12175,9425,2365
50228765,FA2024 ,14750,600,4200,2450,22000,8200,6000,2200,3250,12400,0,15650,2950,9600,6350,2365
50228765,SP2023 ,13500,550,4000,2325,20375,6950,6950,0,7750,8200,0,15950,5850,12175,4425,2365
50228765,SP2024 ,14750,600,4200,2450,22000,8200,6000,2200,3250,12400,0,15650,2950,9600,6350,2365
50212088,FA2021 ,12625,500,3740,2110,18975,0,0,0,NULL,12625,12625,12625,500,6350,6350,0
50212088,FA2022 ,13005,515,3855,1140,18515,0,0,0,NULL,13005,13005,13005,515,5510,5510,0
50212088,FA2023 ,13500,550,4790,NULL,18840,0,0,0,NULL,13500,13500,13500,550,5340,5340,0
50212088,SP2021 ,12625,500,3740,2110,18975,0,0,0,NULL,12625,12625,12625,500,6350,6350,0
50212088,SP2022 ,13005,515,3855,1140,18515,0,0,0,NULL,13005,13005,13005,515,5510,5510,0
50212088,SP2023 ,13500,550,4790,NULL,18840,0,0,0,NULL,13500,13500,13500,550,5340,5340,0
50230079,FA2024 ,14750,600,4200,2680,22230,0,0,0,NULL,14750,14750,14750,600,7480,7480,2555
50230079,SP2024 ,14750,600,4200,2450,22000,0,0,0,NULL,14750,14750,14750,600,7250,7250,2555
50154532,FA2022 ,3580,NULL,NULL,NULL,3580,0,0,0,NULL,3580,3580,3580,0,0,0,0
50154532,FA2023 ,3720,NULL,NULL,NULL,3720,0,0,0,NULL,3720,3720,3720,0,0,0,0
50154532,SP2022 ,3580,NULL,NULL,NULL,3580,0,0,0,NULL,3580,3580,3580,0,0,0,0
50218257,FA2021 ,12625,500,4050,2110,19285,6925,4600,2325,2750,9675,0,12425,3450,9610,6860,5711.57
50218257,FA2022 ,13005,515,4810,2220,20550,8625,5850,2775,3750,8625,0,12375,4895,11925,8175,5711.57
50218257,FA2023 ,13500,550,5150,2325,21525,7175,4600,2575,14191,8425,0,22616,5625,13100,-1091,5711.57
50218257,SP2021 ,12625,500,4050,2110,19285,4925,4600,325,2750,6175,0,8925,6950,13110,10360,5711.57
50218257,SP2022 ,13005,515,4810,2220,20550,6175,5850,325,3750,6175,0,9925,7345,14375,10625,5711.57
50218257,SP2023 ,13500,550,5150,2325,21525,4925,4600,325,14192,6175,0,20367,7875,15350,1158,5711.57
50222437,FA2021 ,12625,500,4580,2110,19815,6500,6500,0,2750,12123,0,14873,1002,7692,4942,-50
50222437,FA2022 ,13005,515,3855,1140,18515,6400,6035,365,3250,10673,0,13923,2847,7842,4592,-50
50222437,FA2023 ,13500,550,5800,1200,21050,6900,6535,365,3750,6900,0,10650,7150,14150,10400,-50
50222437,FA2024 ,8140,600,5030,1270,15040,3807,3606,201,NULL,3807,0,3807,4933,11233,11233,-50
50222437,SP2021 ,12625,500,4580,2110,19815,6500,6500,0,2750,11872,0,14622,1253,7943,5193,-50
50222437,SP2022 ,13005,515,3855,1140,18515,6400,6035,365,3250,10672,0,13922,2848,7843,4593,-50
50222437,SP2023 ,13500,550,5800,NULL,19850,6900,6535,365,3750,6900,0,10650,7150,12950,9200,-50
50209993,FA2021 ,12625,500,3740,2110,18975,4425,4425,0,3750,5925,0,9675,7200,13050,9300,0
50209993,FA2022 ,13005,515,5080,NULL,18600,4425,4425,0,NULL,4425,0,4425,9095,14175,14175,0
50209993,SP2021 ,12625,500,3740,2110,18975,4425,4425,0,3750,4425,0,8175,8700,14550,10800,0
50209993,SP2022 ,13005,515,5080,NULL,18600,4425,4425,0,NULL,4425,0,4425,9095,14175,14175,0
50216043,FA2021 ,12625,500,3740,2110,18975,6175,5100,1075,3250,7675,0,10925,5450,11300,8050,0
50216043,FA2022 ,13005,515,5080,NULL,18600,6175,5100,1075,NULL,6175,0,6175,7345,12425,12425,0
50216043,FA2023 ,13500,550,4000,NULL,18050,6175,250,5925,NULL,8175,0,8175,5875,9875,9875,0
50216043,SP2021 ,12625,500,3740,2110,18975,6175,5100,1075,3250,6175,0,9425,6950,12800,9550,0
50216043,SP2022 ,13005,515,5080,NULL,18600,6175,5100,1075,NULL,6175,0,6175,7345,12425,12425,0
50216043,SP2023 ,13500,550,4000,NULL,18050,6175,250,5925,NULL,8175,0,8175,5875,9875,9875,0
50217338,FA2021 ,12625,500,4050,2550,19725,0,0,0,NULL,1500,0,1500,11625,18225,18225,0
50226926,FA2022 ,13005,515,3855,2690,20065,7500,7500,0,13669,8773,0,22442,4747,11292,-2377,0
50226926,FA2023 ,13500,550,4790,2325,21165,7500,7500,0,12625,9073,0,21698,4977,12092,-533,0
50226926,SP2022 ,13005,515,3855,2690,20065,7500,7500,0,13670,8772,0,22442,4748,11293,-2377,0
50226926,SP2023 ,13500,550,4790,2325,21165,7500,7500,0,12625,9072,0,21697,4978,12093,-532,0
50216668,FA2021 ,12625,500,3740,2110,18975,5075,4325,750,2750,6575,0,9325,6550,12400,9650,0
50216668,FA2022 ,13005,515,4810,2220,20550,5075,4325,750,5750,5075,0,10825,8445,15475,9725,0
50216668,FA2023 ,13500,550,5150,2325,21525,5075,4325,750,5750,5075,0,10825,8975,16450,10700,0
50216668,SP2021 ,12625,500,3740,2110,18975,5075,4325,750,2750,5075,0,7825,8050,13900,11150,0
50216668,SP2022 ,13005,515,4810,2220,20550,5075,4325,750,5750,5075,0,10825,8445,15475,9725,0
50216668,SP2023 ,7450,275,NULL,NULL,7725,2801,2387,414,5750,2801,0,8551,4924,4924,-826,0
50227829,FA2023 ,13500,550,4000,2325,20375,10300,8300,2000,2750,10300,0,13050,3750,10075,7325,-130
50227829,FA2024 ,14750,600,5410,2450,23210,10000,8000,2000,NULL,15410,0,15410,-60,7800,7800,-130
50227829,SP2023 ,13500,550,4000,2325,20375,8000,8000,0,2750,8000,0,10750,6050,12375,9625,-130
50227829,SP2024 ,14750,600,5410,2450,23210,8000,8000,0,NULL,13410,0,13410,1940,9800,9800,-130
50211099,FA2021 ,12625,500,4270,NULL,17395,4675,4675,0,3750,6175,0,9925,6950,11220,7470,0
50211099,FA2022 ,13005,515,5024,2220,20764,4675,4675,0,1750,4675,0,6425,8845,16089,14339,0
50211099,SP2021 ,12625,500,4270,1080,18475,4675,4675,0,3750,4675,0,8425,8450,13800,10050,0
50211099,SP2022 ,13005,515,5420,2220,21160,4675,4675,0,1750,4675,0,6425,8845,16485,14735,0
50232224,FA2024 ,14750,600,4790,2450,22590,11500,10500,1000,2750,16698,0,19448,-1348,5892,3142,0
50232224,SP2024 ,14750,600,4790,2450,22590,10500,10500,0,2750,14697,0,17447,653,7893,5143,0
50210704,FA2021 ,12625,500,4580,2110,19815,6625,5850,775,3750,8125,0,11875,5000,11690,7940,0
50210704,FA2022 ,13005,515,5420,1140,20080,6625,5925,700,3750,6625,0,10375,6895,13455,9705,0
50210704,SP2021 ,12625,500,4580,2110,19815,5925,5850,75,3750,5925,0,9675,7200,13890,10140,0
50210704,SP2022 ,13005,515,5420,1140,20080,5925,5925,0,3750,5925,0,9675,7595,14155,10405,0
50222946,FA2021 ,2525,100,475,422,3522,1650,1650,0,0,2650,0,2650,-25,872,872,0
50224873,FA2022 ,13005,515,4260,2690,20470,17000,9000,8000,2750,17000,0,19750,-3480,3470,720,0
50224873,FA2023 ,13500,550,5150,2325,21525,17000,9000,8000,3250,17000,0,20250,-2950,4525,1275,0
50224873,FA2024 ,14750,600,5720,1270,22340,17000,0,17000,3750,17000,0,20750,-1650,5340,1590,0
50224873,SP2022 ,13005,515,4260,2220,20000,17000,9000,8000,2750,17000,0,19750,-3480,3000,250,0
50224873,SP2023 ,13500,550,5150,2325,21525,17000,9000,8000,3250,17000,0,20250,-2950,4525,1275,0
50224873,SP2024 ,14750,600,4790,2450,22590,17000,0,17000,3750,17000,0,20750,-1650,5590,1840,0
50231310,FA2024 ,14750,600,4200,2450,22000,9500,8500,1000,2750,13500,0,16250,1850,8500,5750,-2844
50231310,SP2024 ,14750,600,4200,2450,22000,9500,8500,1000,2750,15250,0,18000,100,6750,4000,-2844
50218425,FA2021 ,12625,500,4580,2110,19815,3925,3925,0,0,5425,0,5425,7700,14390,14390,0
50218425,FA2022 ,7170,515,3855,2690,14230,1082,1082,0,5250,3667,0,8917,4018,10563,5313,0
50218425,SP2021 ,12625,500,4580,2110,19815,3925,3925,0,3250,3925,0,7175,9200,15890,12640,0
50225248,FA2022 ,13005,515,3855,2690,20065,9250,9250,0,2750,10000,0,12750,3520,10065,7315,2847.5
50225248,FA2023 ,13500,550,4000,2745,20795,9250,9250,0,NULL,9250,0,9250,4800,11545,11545,2847.5
50225248,FA2024 ,14750,600,5410,2450,23210,8250,7250,1000,NULL,9250,0,9250,6100,13960,13960,2847.5
50225248,SP2022 ,13005,515,3855,2690,20065,9250,9250,0,2750,10000,0,12750,3520,10065,7315,2847.5
50225248,SP2023 ,13500,550,4000,2745,20795,9250,9250,0,NULL,10250,0,10250,3800,10545,10545,2847.5
50225248,SP2024 ,14750,600,5410,2450,23210,8250,7250,1000,NULL,9250,0,9250,6100,13960,13960,2847.5
50224989,FA2023 ,13500,550,5150,2745,21945,7000,7000,0,NULL,7000,0,7000,7050,14945,14945,0
50224989,FA2024 ,14750,600,5410,2450,23210,7000,7000,0,0,7000,0,7000,8350,16210,16210,0
50224989,SP2023 ,13500,550,5150,2745,21945,7000,7000,0,NULL,7000,0,7000,7050,14945,14945,0
50224989,SP2024 ,14750,600,5410,2450,23210,7000,7000,0,0,7000,0,7000,8350,16210,16210,0
50221562,FA2021 ,12625,500,4580,2110,19815,9250,7250,2000,2750,10250,0,13000,2875,9565,6815,0
50221562,FA2022 ,13005,515,4810,2220,20550,8750,6750,2000,3250,8750,0,12000,4770,11800,8550,0
50221562,FA2023 ,13500,550,5150,2325,21525,8750,6750,2000,3750,8750,0,12500,5300,12775,9025,0
50221562,FA2024 ,14750,600,5720,NULL,21070,8750,6750,2000,0,8750,0,8750,6600,12320,12320,0
50221562,SP2021 ,12625,500,4580,2110,19815,7250,7250,0,2750,8250,0,11000,4875,11565,8815,0
50221562,SP2022 ,13005,515,4810,2220,20550,6750,6750,0,3250,8250,0,11500,5270,12300,9050,0
50221562,SP2023 ,13500,550,5150,1200,20400,6750,6750,0,3750,6750,0,10500,7300,13650,9900,0
50221562,SP2024 ,8140,600,5720,NULL,14460,3725,3725,0,0,3725,0,3725,5015,10735,10735,0
50204908,FA2021 ,12625,500,4800,1080,19005,2425,0,2425,18600,3425,0,22025,9700,15580,-3020,0
50204908,SP2021 ,12625,500,5160,1080,19365,2425,0,2425,3750,2425,0,6175,10700,16940,13190,0
50209034,FA2021 ,12625,500,4830,1080,19035,9925,0,9925,7750,11425,0,19175,1700,7610,-140,0
50209034,FA2022 ,13005,515,5080,1140,19740,10925,0,10925,8750,10925,0,19675,2595,8815,65,0
50209034,SP2021 ,12625,500,4830,1080,19035,9925,0,9925,7750,9925,0,17675,3200,9110,1360,0
50209034,SP2022 ,13005,515,5080,1140,19740,15925,0,15925,3750,15925,0,19675,-2405,3815,65,0
50220841,FA2021 ,12625,500,4580,2110,19815,7950,7950,0,13250,10950,0,24200,2175,8865,-4385,0
50220841,SP2021 ,12625,500,4580,2110,19815,7950,7950,0,13250,7950,0,21200,5175,11865,-1385,0
50216134,FA2021 ,12625,500,3740,2110,18975,10925,10925,0,3250,18573,0,21823,-5448,402,-2848,0
50216134,FA2022 ,13005,515,3855,2220,19595,10925,0,10925,0,17273,0,17273,-3753,2322,2322,0
50216134,SP2021 ,12625,500,3740,2110,18975,12925,10925,2000,3250,17632,0,20882,-4507,1343,-1907,0
50216134,SP2022 ,13005,515,3855,2220,19595,12925,0,12925,0,19272,0,19272,-5752,323,323,0
50229772,FA2023 ,13500,550,5150,2535,21735,10000,8000,2000,8750,10000,0,18750,4050,11735,2985,7465.3
50229772,SP2023 ,13500,550,5150,2535,21735,8000,8000,0,8750,8000,0,16750,6050,13735,4985,7465.3
50235929,SP2024 ,15000,7500,7500,NULL,22500,0,0,0,NULL,0,0,0,22500,22500,22500,0
50209851,FA2021 ,12625,500,4270,NULL,17395,6925,6925,0,3250,12298,0,15548,827,5097,1847,0
50209851,SP2021 ,12625,500,4270,NULL,17395,6925,6925,0,3250,10797,0,14047,2328,6598,3348,0
50227997,FA2023 ,13500,550,4000,2745,20795,6500,6500,0,2750,6500,0,9250,7550,14295,11545,0
50227997,FA2024 ,14750,600,5410,2450,23210,6500,6500,0,NULL,6500,0,6500,8850,16710,16710,0
50227997,SP2023 ,13500,550,4000,2745,20795,6500,6500,0,2750,6500,0,9250,7550,14295,11545,0
50227997,SP2024 ,14750,600,5410,2450,23210,6500,6500,0,NULL,6500,0,6500,8850,16710,16710,0
50228835,FA2023 ,13500,550,4000,2325,20375,9350,9350,0,14111,9350,0,23461,4700,11025,-3086,-5103
50228835,FA2024 ,14750,600,5720,1270,22340,9350,6000,3350,16673,9350,0,26023,6000,12990,-3683,-5103
50228835,SP2023 ,13500,550,4000,2325,20375,9350,9350,0,14112,9350,0,23462,4700,11025,-3087,-5103
50228835,SP2024 ,14750,600,5720,1270,22340,9350,6000,3350,16672,9350,0,26022,6000,12990,-3682,-5103
50225629,FA2022 ,13005,515,4810,2220,20550,5500,5500,0,2750,5500,0,8250,8020,15050,12300,0
50225629,FA2023 ,13500,550,5150,2325,21525,5500,5500,0,3250,5500,0,8750,8550,16025,12775,0
50225629,FA2024 ,14750,600,5720,60.7,21130.7,5500,5500,0,NULL,5500,0,5500,9850,15630.7,15630.7,0
50225629,SP2022 ,13005,515,4810,2220,20550,5500,5500,0,2750,5500,0,8250,8020,15050,12300,0
50225629,SP2023 ,13500,550,5150,2325,21525,5500,5500,0,3250,5500,0,8750,8550,16025,12775,0
50225629,SP2024 ,14750,600,5720,NULL,21070,5500,5500,0,NULL,5500,0,5500,9850,15570,15570,0
50233980,FA2024 ,14750,600,4200,2450,22000,7000,7000,0,0,7000,0,7000,8350,15000,15000,0
50233980,SP2024 ,14750,600,4200,2450,22000,7000,7000,0,0,7000,0,7000,8350,15000,15000,0
50228937,FA2023 ,13500,550,4000,2745,20795,7350,7350,0,11850,9600,0,21450,4450,11195,-655,-1649
50228937,FA2024 ,14750,600,4200,2900,22450,8600,7000,1600,14583,9600,0,24183,5750,12850,-1733,-1649
50228937,SP2023 ,13500,550,4000,2745,20795,7350,7350,0,11850,8600,0,20450,5450,12195,345,-1649
50228937,SP2024 ,14750,600,4200,2900,22450,8600,7000,1600,14582,8600,0,23182,6750,13850,-732,-1649
40001046,FA2021 ,12625,500,4270,NULL,17395,8425,8425,0,3750,9425,0,13175,3700,7970,4220,0
40001046,SP2021 ,12625,500,4270,NULL,17395,8425,8425,0,3750,8425,0,12175,4700,8970,5220,0
50232378,FA2024 ,14750,600,5410,2450,23210,9500,0,9500,2750,9500,0,12250,5850,13710,10960,1878
50232378,SP2024 ,14750,600,5410,2450,23210,9500,0,9500,2750,9500,0,12250,5850,13710,10960,1878
50215127,FA2021 ,12625,500,3740,2110,18975,5675,5250,425,3250,7175,0,10425,5950,11800,8550,0
50215127,FA2022 ,13005,515,3855,2220,19595,5675,5250,425,3750,5675,0,9425,7845,13920,10170,0
50215127,SP2021 ,12625,500,3740,2110,18975,5675,5250,425,3250,5675,0,8925,7450,13300,10050,0
50215127,SP2022 ,13005,515,3855,2220,19595,5675,5250,425,3750,5675,0,9425,7845,13920,10170,0
50222478,FA2021 ,12625,500,NULL,NULL,13125,5478,5478,0,2750,6478,0,9228,6647,6647,3897,0
50222478,FA2022 ,13005,515,NULL,NULL,13520,2467,1767,700,3250,2867,0,6117,10653,10653,7403,0
50222478,FA2023 ,13500,550,NULL,NULL,14050,5700,5000,700,3750,8223,0,11973,5827,5827,2077,0
50222478,FA2024 ,14750,600,NULL,NULL,15350,3933,3233,700,3750,9531,0,13281,5819,5819,2069,0
50222478,SP2021 ,12625,500,NULL,NULL,13125,5478,5478,0,5268,5478,0,10746,7647,7647,2379,0
50222478,SP2022 ,13005,515,NULL,NULL,13520,2467,1767,700,12418,2867,0,15285,10653,10653,-1765,0
50222478,SP2023 ,13500,550,NULL,NULL,14050,3933,3233,700,3750,6455,0,10205,7595,7595,3845,0
50222478,SP2024 ,14750,600,NULL,NULL,15350,3933,3233,700,3750,9530,0,13280,5820,5820,2070,0
50222595,FA2021 ,12625,500,NULL,NULL,13125,3916,3916,0,2750,4916,0,7666,8209,8209,5459,0
50222595,FA2022 ,13005,515,NULL,NULL,13520,4071,3171,900,3250,4471,0,7721,9049,9049,5799,0
50222595,FA2023 ,13500,550,NULL,NULL,14050,5900,5000,900,3750,8523,0,12273,5527,5527,1777,0
50222595,FA2024 ,14750,600,NULL,NULL,15350,5071,0,5071,3750,10669,0,14419,4681,4681,931,0
50222595,SP2021 ,12625,500,NULL,NULL,13125,3916,3916,0,6033,3916,0,9949,9209,9209,3176,0
50222595,SP2022 ,13005,515,NULL,NULL,13520,4071,3171,900,7164,4471,0,11635,9049,9049,1885,0
50222595,SP2023 ,13500,550,NULL,NULL,14050,4071,3171,900,3750,6693,0,10443,7357,7357,3607,0
50222595,SP2024 ,14750,600,NULL,NULL,15350,5071,0,5071,3750,10668,0,14418,4682,4682,932,0
50228032,FA2023 ,13500,550,4000,2325,20375,9000,9000,0,0,9000,0,9000,5050,11375,11375,-2499.67
50228032,FA2024 ,14750,600,5410,2450,23210,9000,9000,0,3250,9000,0,12250,6350,14210,10960,-2499.67
50228032,SP2023 ,13500,550,4000,2325,20375,9000,9000,0,0,9000,0,9000,5050,11375,11375,-2499.67
50228032,SP2024 ,14750,600,5410,2450,23210,9000,9000,0,3250,9000,0,12250,6350,14210,10960,-2499.67
50214401,FA2021 ,12625,500,3740,2110,18975,6425,6425,0,NULL,6925,0,6925,6200,12050,12050,0
50214401,FA2022 ,13005,515,4810,2220,20550,6425,6425,0,NULL,6425,0,6425,7095,14125,14125,0
50214401,FA2023 ,13500,550,5150,2325,21525,6425,6425,0,3750,6425,0,10175,7625,15100,11350,0
50214401,SP2021 ,12625,500,3740,2110,18975,6425,6425,0,NULL,6425,0,6425,6700,12550,12550,0
50214401,SP2022 ,13005,515,4810,2220,20550,6425,6425,0,NULL,6425,0,6425,7095,14125,14125,0
50214401,SP2023 ,13500,550,5150,2325,21525,6425,6425,0,3750,6425,0,10175,7625,15100,11350,0
50205707,FA2021 ,19340,860,5690,NULL,25030,9075,7625,1450,18021,12461,0,30482,7739,12569,-5452,0
50205707,SP2021 ,19340,860,5690,NULL,25030,9076,7626,1450,18021,10962,0,28983,9238,14068,-3953,0
50220872,FA2021 ,12625,500,3740,1080,17945,7500,6500,1000,4750,12248,0,16998,877,5697,947,0
50220872,FA2022 ,7170,515,3855,NULL,11540,3859,3308,551,6250,6666,0,12916,1019,4874,-1376,0
50220872,SP2021 ,12625,500,3740,NULL,16865,7500,6500,1000,4750,11807,0,16557,1318,5058,308,0
50220872,SP2022 ,13005,515,3855,NULL,17375,7000,6000,1000,6250,10847,0,17097,2673,6528,278,0
50225610,FA2022 ,13005,515,3855,2220,19595,6500,6500,0,2750,6500,0,9250,7020,13095,10345,0
50225610,FA2023 ,13500,550,4560,2325,20935,6500,6500,0,3250,6500,0,9750,7550,14435,11185,0
50225610,FA2024 ,14750,600,6090,NULL,21440,6500,6500,0,21750,6500,0,28250,8850,14940,-6810,0
50225610,SP2022 ,13005,515,3855,2220,19595,6500,6500,0,2750,6500,0,9250,7020,13095,10345,0
50225610,SP2023 ,13500,550,5440,NULL,19490,6500,6500,0,3250,6500,0,9750,7550,12990,9740,0
50225610,SP2024 ,14750,7250,7250,NULL,22000,6500,6500,0,3750,6500,0,10250,15500,15500,11750,0
50210251,FA2021 ,12625,500,3740,1080,17945,7300,2350,4950,3750,8800,0,12550,4325,9145,5395,150
50210251,SP2021 ,12625,500,3740,1080,17945,7300,2350,4950,3750,7300,0,11050,5825,10645,6895,150
50216525,FA2021 ,12625,500,4580,2110,19815,0,0,0,NULL,1500,0,1500,11625,18315,18315,15
50216525,FA2022 ,13005,515,4810,2220,20550,0,0,0,NULL,0,0,0,13520,20550,20550,15
50216525,FA2023 ,13500,550,4790,1200,20040,0,0,0,NULL,0,0,0,14050,20040,20040,15
50216525,FA2024 ,14750,600,NULL,NULL,15350,0,0,0,NULL,0,0,0,15350,15350,15350,15
50216525,SP2021 ,12625,500,4580,2110,19815,0,0,0,NULL,0,0,0,13125,19815,19815,15
50216525,SP2022 ,13005,515,4810,2220,20550,0,0,0,NULL,0,0,0,13520,20550,20550,15
50216525,SP2023 ,13500,550,4790,1200,20040,0,0,0,NULL,0,0,0,14050,20040,20040,15
50216525,SP2024 ,8140,300,NULL,NULL,8440,0,0,0,NULL,0,0,0,8440,8440,8440,15
50204603,FA2021 ,12625,500,4270,NULL,17395,6675,0,6675,11754,8175,0,19929,4950,9220,-2534,0
50216563,FA2021 ,12625,500,3740,2110,18975,9675,3887,5788,6800,14198,0,20998,-1073,4777,-2023,5219.64
50216563,FA2022 ,13005,515,4810,2220,20550,9175,3385,5790,3488,17208,0,20696,-3688,3342,-146,5219.64
50216563,FA2023 ,13500,550,4000,2325,20375,9675,0,9675,3750,16948,0,20698,-2898,3427,-323,5219.64
50216563,FA2024 ,4070,NULL,5240,2450,11760,6126,6126,0,0,6889,0,6889,-2819,4871,4871,5219.64
50216563,SP2021 ,12625,500,3740,2110,18975,9675,3888,5787,6800,12197,0,18997,928,6778,-22,5219.64
50216563,SP2022 ,13005,515,4810,2220,20550,9175,3385,5790,3487,17207,0,20694,-3687,3343,-144,5219.64
50216563,SP2023 ,13500,550,4000,2325,20375,9675,0,9675,3750,16947,0,20697,-2897,3428,-322,5219.64
50221553,FA2021 ,12625,500,3740,2110,18975,7500,7500,0,10610,12023,0,22633,1102,6952,-3658,1.3
50221553,FA2022 ,13005,515,3855,1140,18515,7500,7500,0,9609,12098,0,21707,1422,6417,-3192,1.3
50221553,FA2023 ,13500,550,4790,NULL,18840,7650,7650,0,11155,8150,0,19305,5900,10690,-465,1.3
50221553,FA2024 ,14750,600,5720,1270,22340,7500,7500,0,15250,7500,0,22750,7850,14840,-410,1.3
50221553,SP2021 ,12625,500,3740,2110,18975,7500,7500,0,10895,10522,0,21417,2603,8453,-2442,1.3
50221553,SP2022 ,13005,515,3855,1140,18515,7500,7500,0,9608,12097,0,21705,1423,6418,-3190,1.3
50221553,SP2023 ,13500,550,4790,NULL,18840,7650,7650,0,11541,8150,0,19691,5900,10690,-851,1.3
50221553,SP2024 ,14750,600,5720,1270,22340,7500,7500,0,15550,7500,0,23050,7850,14840,-710,1.3
50229709,FA2023 ,13500,550,4000,2325,20375,7100,5500,1600,5221,10073,0,15294,3977,10302,5081,6050.5
50229709,FA2024 ,14750,600,4200,2450,22000,11125,9125,2000,3250,15113,0,18363,237,6887,3637,6050.5
50229709,SP2023 ,13500,550,4000,2325,20375,9000,9000,0,5221,11972,0,17193,2078,8403,3182,6050.5
50229709,SP2024 ,14750,600,4200,2450,22000,9000,9000,0,3250,12987,0,16237,2363,9013,5763,6050.5
50230431,FA2023 ,13500,550,NULL,NULL,14050,7250,7250,0,NULL,7250,0,7250,6800,6800,6800,2279.5
50230431,FA2024 ,8140,300,NULL,NULL,8440,4001,0,4001,NULL,4001,0,4001,4439,4439,4439,2279.5
50230431,SP2023 ,13500,550,NULL,NULL,14050,7250,7250,0,NULL,7250,0,7250,6800,6800,6800,2279.5
50230431,SP2024 ,8140,300,NULL,NULL,8440,4001,0,4001,NULL,4001,0,4001,4439,4439,4439,2279.5
50216637,FA2021 ,12625,500,3740,2550,19415,7925,7925,0,3250,18572,0,21822,-5447,843,-2407,0
50215857,FA2021 ,12625,500,3740,2110,18975,10775,550,10225,3250,12275,0,15525,850,6700,3450,0
50215857,FA2022 ,13005,515,4260,2220,20000,10225,0,10225,3750,10225,0,13975,3295,9775,6025,0
50215857,SP2021 ,12625,500,3740,2110,18975,10225,0,10225,3250,10225,0,13475,2900,8750,5500,0
50215857,SP2022 ,13005,515,4260,2220,20000,10225,0,10225,11150,10225,0,21375,3295,9775,-1375,0
50225225,FA2022 ,13005,515,3855,2690,20065,8900,6900,2000,5987,12000,0,17987,1520,8065,2078,797
50225225,FA2023 ,13500,550,4000,2745,20795,10000,8000,2000,9350,11000,0,20350,3050,9795,445,797
50225225,FA2024 ,14750,600,5240,2900,23490,9500,6500,3000,12029,12865,0,24894,2485,10625,-1404,797
50225225,SP2022 ,13005,515,3855,2690,20065,6900,6900,0,10999,7500,0,18499,6020,12565,1566,797
50225225,SP2023 ,13500,550,4000,2745,20795,8000,8000,0,10694,9000,0,19694,5050,11795,1101,797
50225225,SP2024 ,14750,600,5240,2900,23490,7500,6500,1000,12029,10865,0,22894,4485,12625,596,797
9506825,FA2023 ,7450,275,NULL,NULL,7725,2665,2665,0,0,2665,0,2665,5060,5060,5060,0
9506825,FA2024 ,8140,300,NULL,NULL,8440,3863,3863,0,10992,4577,0,15569,3863,3863,-7129,0
9506825,SP2023 ,13500,550,NULL,NULL,14050,4830,4830,0,14589,4830,0,19419,9220,9220,-5369,0
9506825,SP2024 ,4070,NULL,NULL,NULL,4070,0,0,0,10992,351,0,11343,3719,3719,-7273,0
50228548,FA2023 ,13500,550,5150,2325,21525,8100,8100,0,13362,11798,0,25160,2252,9727,-3635,0
50228548,FA2024 ,14750,600,5410,2680,23440,8100,7500,600,13579,11798,0,25377,3552,11642,-1937,0
50228548,SP2023 ,13500,550,5150,2325,21525,8100,8100,0,13362,11797,0,25159,2253,9728,-3634,0
50228548,SP2024 ,14750,600,5410,2450,23210,8100,7500,600,13579,11797,0,25376,3553,11413,-2166,0
50204117,FA2021 ,12625,500,4830,2110,20065,925,925,0,3750,2425,0,6175,10700,17640,13890,0
50204117,SP2021 ,12625,500,4830,2110,20065,925,925,0,3750,925,0,4675,12200,19140,15390,0
50221382,FA2021 ,12625,500,3740,2110,18975,6500,6500,0,NULL,7500,0,7500,5625,11475,11475,0
50221382,FA2022 ,13005,515,3855,2220,19595,6000,6000,0,NULL,9855,0,9855,3665,9740,9740,0
50221382,SP2021 ,12625,500,3740,2110,18975,6500,6500,0,NULL,6500,0,6500,6625,12475,12475,0
50232684,FA2024 ,14750,600,5410,2450,23210,8000,8000,0,NULL,8000,0,8000,7350,15210,15210,9620
50232684,SP2024 ,14750,600,5410,2450,23210,8000,8000,0,NULL,8000,0,8000,7350,15210,15210,9620
50233214,FA2024 ,14750,600,5410,2450,23210,8000,8000,0,NULL,8000,0,8000,7350,15210,15210,0
50233214,SP2024 ,14750,600,5410,2450,23210,8000,8000,0,NULL,8000,0,8000,7350,15210,15210,0
50232014,FA2024 ,14750,600,4200,2900,22450,7500,7500,0,2750,10000,0,12750,5350,12450,9700,2000
50232014,SP2024 ,14750,600,4200,2450,22000,7500,7500,0,2750,7500,0,10250,7850,14500,11750,2000
50218736,FA2021 ,15944,5556,5556,NULL,21500,0,0,0,NULL,0,0,0,21500,21500,21500,0
50216048,FA2021 ,12625,500,4580,2110,19815,4425,0,4425,3250,8625,0,11875,4500,11190,7940,0
50216048,SP2021 ,12625,500,4580,2110,19815,4425,0,4425,3250,4425,0,7675,8700,15390,12140,0
50227130,FA2022 ,13005,515,4260,2220,20000,6500,6500,0,3250,6500,0,9750,7020,13500,10250,2472
50227130,FA2023 ,13500,550,NULL,NULL,14050,4485,4485,0,3750,4485,0,8235,9565,9565,5815,2472
50227130,FA2024 ,14750,600,NULL,NULL,15350,4485,0,4485,20750,8183,0,28933,7167,7167,-13583,2472
50227130,SP2022 ,13005,515,4260,2220,20000,6500,6500,0,3250,6500,0,9750,7020,13500,10250,2472
50227130,SP2023 ,13500,550,NULL,NULL,14050,4485,4485,0,3750,4485,0,8235,9565,9565,5815,2472
50227130,SP2024 ,4070,NULL,NULL,NULL,4070,0,0,0,0,924,0,924,3146,3146,3146,2472
50228688,FA2023 ,13500,550,4000,2325,20375,6500,6500,0,2750,6500,0,9250,7550,13875,11125,30
50228688,FA2024 ,14750,600,4200,2450,22000,6500,6500,0,5250,6500,0,11750,8850,15500,10250,30
50228688,SP2023 ,13500,550,4000,2325,20375,6500,6500,0,2750,6500,0,9250,7550,13875,11125,30
50228688,SP2024 ,14750,600,4200,2450,22000,6500,6500,0,5250,6500,0,11750,8850,15500,10250,30
40000707,FA2024 ,8140,300,NULL,NULL,8440,0,0,0,NULL,8140,8140,8140,300,300,300,0
40000707,SP2024 ,4070,NULL,NULL,NULL,4070,0,0,0,NULL,4070,4070,4070,0,0,0,0
50129876,FA2021 ,12625,500,4270,NULL,17395,8925,8925,0,NULL,22807,0,22807,-9682,-5412,-5412,0
50129876,FA2022 ,13005,515,NULL,NULL,13520,7425,0,7425,2750,16873,0,19623,-3353,-3353,-6103,0
50129876,SP2021 ,12625,500,4270,NULL,17395,8925,8925,0,NULL,8925,0,8925,4200,8470,8470,0
50129876,SP2022 ,13005,515,NULL,NULL,13520,7425,0,7425,2750,16872,0,19622,-3352,-3352,-6102,0
50210298,FA2021 ,12625,500,3740,1080,17945,8425,8425,0,3250,9925,0,13175,3200,8020,4770,0
50210298,FA2022 ,13005,515,NULL,NULL,13520,6925,0,6925,6250,9898,0,16148,3622,3622,-2628,0
50210298,SP2021 ,12625,500,3740,1080,17945,8425,8425,0,3250,8425,0,11675,4700,9520,6270,0
50210298,SP2022 ,13005,515,NULL,NULL,13520,6925,0,6925,6250,9897,0,16147,3623,3623,-2627,0
50219033,FA2021 ,12625,500,NULL,NULL,13125,3350,3350,0,6750,5600,0,12350,7525,7525,775,0
50219033,FA2022 ,13005,515,NULL,NULL,13520,4243,4243,0,8250,4243,0,12493,9277,9277,1027,0
50219033,SP2021 ,12625,500,NULL,NULL,13125,3350,3350,0,6750,4600,0,11350,8525,8525,1775,0
50219033,SP2022 ,13005,515,NULL,NULL,13520,4244,4244,0,8250,4244,0,12494,9276,9276,1026,0
50218331,FA2021 ,12625,500,4580,2110,19815,3525,3525,0,3250,5025,0,8275,8100,14790,11540,6519
50218331,FA2022 ,13005,515,NULL,NULL,13520,2025,2025,0,3750,2025,0,5775,11495,11495,7745,6519
50218331,FA2023 ,13500,550,NULL,NULL,14050,3525,3525,0,3750,3525,0,7275,10525,10525,6775,6519
50218331,FA2024 ,14750,600,NULL,NULL,15350,2025,2025,0,2000,2025,0,4025,13325,13325,11325,6519
50218331,SP2021 ,12625,500,4580,2110,19815,3525,3525,0,3250,3525,0,6775,9600,16290,13040,6519
50218331,SP2022 ,13005,515,NULL,NULL,13520,2025,2025,0,3750,2025,0,5775,11495,11495,7745,6519
50218331,SP2023 ,13500,550,NULL,NULL,14050,2025,2025,0,3750,2025,0,5775,12025,12025,8275,6519
50218331,SP2024 ,14750,600,NULL,NULL,15350,2025,2025,0,2000,2025,0,4025,13325,13325,11325,6519
50228674,FA2023 ,13500,550,5150,2325,21525,8450,8450,0,8937,17148,0,26085,-3098,4377,-4560,-3442.38
50228674,FA2024 ,14750,600,5410,2450,23210,8450,8450,0,12125,12898,0,25023,2452,10312,-1813,-3442.38
50228674,SP2023 ,13500,550,5150,2325,21525,8450,8450,0,8938,12147,0,21085,1903,9378,440,-3442.38
50228674,SP2024 ,14750,600,5410,2450,23210,8450,8450,0,12126,12897,0,25023,2453,10313,-1813,-3442.38
50234688,FA2024 ,14750,600,5410,2450,23210,7000,7000,0,NULL,7000,0,7000,8350,16210,16210,2803.58
50234688,SP2024 ,14750,600,5410,2450,23210,7000,7000,0,NULL,7000,0,7000,8350,16210,16210,2803.58
50225280,FA2022 ,13005,515,4260,2220,20000,7000,7000,0,2750,7000,0,9750,6520,13000,10250,0
50225280,FA2023 ,13500,550,5150,2325,21525,7000,7000,0,3250,12150,0,15400,1900,9375,6125,0
50225280,FA2024 ,14750,7250,7250,NULL,22000,1550,1550,0,3250,1550,0,4800,20450,20450,17200,0
50225280,SP2022 ,13005,515,4260,2220,20000,7000,7000,0,2750,7000,0,9750,6520,13000,10250,0
50225280,SP2023 ,13500,550,5150,2325,21525,7000,7000,0,3250,12150,0,15400,1900,9375,6125,0
50225280,SP2024 ,14750,600,5720,NULL,21070,7000,6000,1000,3250,7000,0,10250,8350,14070,10820,0
50231724,FA2024 ,14750,600,4200,2450,22000,9000,9000,0,2750,12000,0,14750,3350,10000,7250,4331.64
50231724,SP2024 ,14750,600,4200,2450,22000,9000,9000,0,2750,9000,0,11750,6350,13000,10250,4331.64
50222044,FA2021 ,12625,500,3740,2110,18975,6500,6500,0,2750,7500,0,10250,5625,11475,8725,0
50222044,FA2022 ,13005,515,3855,2220,19595,6000,6000,0,3250,6000,0,9250,7520,13595,10345,0
50222044,FA2023 ,13500,6825,6825,NULL,20325,6000,6000,0,3750,6000,0,9750,14325,14325,10575,0
50222044,FA2024 ,14750,600,4200,NULL,19550,6500,6500,0,NULL,6500,0,6500,8850,13050,13050,0
50222044,SP2021 ,12625,500,3740,2110,18975,6500,6500,0,2750,6500,0,9250,6625,12475,9725,0
50222044,SP2022 ,13005,515,4810,2220,20550,6000,6000,0,3250,6000,0,9250,7520,14550,11300,0
50222044,SP2023 ,13500,550,4000,NULL,18050,6000,6000,0,3750,6000,0,9750,8050,12050,8300,0
50222044,SP2024 ,14750,600,4200,NULL,19550,6500,6500,0,NULL,6500,0,6500,8850,13050,13050,0
50216373,FA2021 ,12625,500,4580,2110,19815,3675,3675,0,0,5175,0,5175,7950,14640,14640,0
50216373,FA2022 ,13005,515,4610,1140,19270,3675,3675,0,16250,3675,0,19925,9845,15595,-655,0
50216373,SP2021 ,12625,500,4580,2110,19815,3675,3675,0,0,3675,0,3675,9450,16140,16140,0
50210964,FA2021 ,12625,500,3740,1080,17945,1775,1775,0,15000,2275,0,17275,10850,15670,670,0
50210964,FA2022 ,13005,515,4610,NULL,18130,1425,1425,0,8400,1425,0,9825,12095,16705,8305,0
50210964,SP2021 ,12625,500,3740,1080,17945,1425,1425,0,7474,1425,0,8899,11700,16520,9046,0
50210964,SP2022 ,13005,515,4610,NULL,18130,1425,1425,0,12875,1425,0,14300,12095,16705,3830,0
50217781,FA2021 ,12625,500,4050,2110,19285,4925,4050,875,3250,6425,0,9675,6700,12860,9610,0
50217781,FA2022 ,13005,515,5420,1140,20080,5925,4050,1875,3750,5925,0,9675,7595,14155,10405,0
50217781,FA2023 ,13500,550,5440,1200,20690,5925,0,5925,3750,5925,0,9675,8125,14765,11015,0
50217781,SP2021 ,12625,500,4050,2110,19285,4925,4050,875,3250,4925,0,8175,8200,14360,11110,0
50217781,SP2022 ,13005,6590,8635,NULL,21640,5925,4050,1875,3750,5925,0,9675,13670,15715,11965,0
50217050,FA2021 ,12625,500,3740,2110,18975,8425,8425,0,10250,9925,0,20175,3200,9050,-1200,0
50217050,FA2022 ,13005,515,4610,1140,19270,9425,9425,0,10500,9425,0,19925,4095,9845,-655,0
50217050,FA2023 ,13500,550,4790,1200,20040,11425,8425,3000,10250,11425,0,21675,2625,8615,-1635,0
50217050,SP2021 ,12625,500,3740,2110,18975,8425,8425,0,10250,8425,0,18675,4700,10550,300,0
50217050,SP2022 ,13005,515,4610,1140,19270,9425,9425,0,10500,9425,0,19925,4095,9845,-655,0
50217050,SP2023 ,13500,550,4790,1200,20040,9425,8425,1000,10250,9425,0,19675,4625,10615,365,0
50232104,FA2024 ,14750,600,4200,2450,22000,8000,8000,0,2750,8000,0,10750,7350,14000,11250,0
50232104,SP2024 ,14750,600,4200,2450,22000,8000,8000,0,13750,8000,0,21750,7350,14000,250,0
50228933,FA2023 ,13500,550,4000,2325,20375,8500,8500,0,2750,8500,0,11250,5550,11875,9125,100
50228933,FA2024 ,14750,600,4200,2450,22000,8500,7000,1500,3750,12198,0,15948,3152,9802,6052,100
50228933,SP2023 ,13500,550,4000,2325,20375,8500,8500,0,2750,8500,0,11250,5550,11875,9125,100
50228933,SP2024 ,14750,600,4200,2450,22000,8500,7000,1500,3750,12197,0,15947,3153,9803,6053,100
50235044,FA2024 ,14750,600,4200,2450,22000,12528,12528,0,3250,17528,0,20778,-2178,4472,1222,1694.73
50235044,SP2024 ,14750,600,4200,2450,22000,12528,12528,0,3250,12528,0,15778,2822,9472,6222,1694.73
50235080,FA2024 ,14750,600,4200,2900,22450,9028,8028,1000,NULL,9028,0,9028,6322,13422,13422,-619
50235080,SP2024 ,8140,600,4200,2900,15840,4982,4430,552,NULL,4982,0,4982,3758,10858,10858,-619
50235446,SP2024 ,14750,600,4200,2450,22000,6500,6000,500,3250,10197,0,13447,5153,11803,8553,3324.06
50186805,SP2023 ,7450,275,NULL,NULL,7725,2250,0,2250,NULL,2250,0,2250,5475,5475,5475,5157
50196414,FA2021 ,12625,500,4050,2110,19285,2925,2925,0,10000,2925,0,12925,10200,16360,6360,0
50196414,SP2021 ,3470,NULL,NULL,NULL,3470,0,0,0,3917,0,0,3917,3470,3470,-447,0
50209967,FA2021 ,19340,860,4910,1080,25330,15000,0,15000,NULL,15500,0,15500,4700,9830,9830,0
50209967,FA2022 ,19910,890,5700,1140,26750,15500,500,15000,NULL,15500,0,15500,5300,11250,11250,0
50209967,SP2021 ,12625,6350,6350,NULL,18975,5000,0,5000,NULL,5000,0,5000,13975,13975,13975,0
50215190,FA2021 ,12625,500,4580,2110,19815,5425,4800,625,2750,6425,0,9175,6700,13390,10640,0
50215190,SP2021 ,12625,500,4580,2110,19815,5425,4800,625,2750,5425,0,8175,7700,14390,11640,0
50209570,FA2021 ,12625,500,4580,2110,19815,2425,2425,0,NULL,2425,0,2425,10700,17390,17390,0
50209570,FA2022 ,13005,515,4610,NULL,18130,2425,2425,0,NULL,2425,0,2425,11095,15705,15705,0
50209570,SP2021 ,12625,500,4580,2110,19815,2425,2425,0,NULL,2425,0,2425,10700,17390,17390,0
50209570,SP2022 ,13005,515,4610,NULL,18130,2425,2425,0,NULL,2425,0,2425,11095,15705,15705,0
50228550,FA2023 ,13500,550,4000,2325,20375,10500,7500,3000,2750,10500,0,13250,3550,9875,7125,-750
50228550,FA2024 ,14750,600,4200,2450,22000,10500,500,10000,1505,11500,0,13005,3850,10500,8995,-750
50228550,SP2023 ,13500,550,4000,2325,20375,8500,7500,1000,2750,8500,0,11250,5550,11875,9125,-750
50228550,SP2024 ,14750,600,4200,2450,22000,8500,500,8000,1505,8500,0,10005,6850,13500,11995,-750
50226148,FA2022 ,13005,515,3855,2220,19595,7000,6500,500,2750,7000,0,9750,6520,12595,9845,5889.99
50226148,FA2023 ,13500,550,4000,2325,20375,7000,500,6500,0,7000,0,7000,7050,13375,13375,5889.99
50226148,FA2024 ,14750,600,5030,1270,21650,8000,6500,1500,NULL,8000,0,8000,7350,13650,13650,5889.99
50226148,SP2022 ,13005,515,3855,2220,19595,7000,6500,500,2750,7000,0,9750,6520,12595,9845,5889.99
50226148,SP2023 ,13500,550,4000,2325,20375,7000,500,6500,0,7000,0,7000,7050,13375,13375,5889.99
50226148,SP2024 ,14750,600,5030,1270,21650,8000,6500,1500,NULL,8000,0,8000,7350,13650,13650,5889.99
50209233,FA2021 ,12625,500,4830,1080,19035,5125,0,5125,3750,11873,0,15623,1252,7162,3412,1015
50209233,FA2022 ,13005,515,5080,1140,19740,5125,0,5125,3750,7398,0,11148,6122,12342,8592,1015
50209233,FA2023 ,7450,275,NULL,NULL,7725,2001,0,2001,NULL,2001,0,2001,5724,5724,5724,1015
50209233,FA2024 ,8140,300,NULL,NULL,8440,2000,621,1379,2000,2000,0,4000,6440,6440,4440,1015
50209233,SP2021 ,12625,500,4830,1080,19035,5125,0,5125,3750,10932,0,14682,2193,8103,4353,1015
50209233,SP2022 ,7170,515,5080,1140,13905,2825,0,2825,3750,5200,0,8950,2485,8705,4955,1015
50231044,FA2023 ,2700,110,418,465,3693,1600,1600,0,0,1600,0,1600,1210,2093,2093,2579.1
50231044,FA2024 ,14750,600,4200,2900,22450,8000,8000,0,0,8000,0,8000,7350,14450,14450,2579.1
50225444,FA2022 ,13005,515,3855,2220,19595,7900,5400,2500,6000,12223,0,18223,1297,7372,1372,0
50218743,FA2021 ,12625,500,NULL,NULL,13125,6425,6425,0,NULL,6425,0,6425,6700,6700,6700,0
50218743,FA2022 ,13005,515,NULL,NULL,13520,6425,6425,0,NULL,6425,0,6425,7095,7095,7095,0
50218743,FA2023 ,13500,550,NULL,NULL,14050,4925,1100,3825,NULL,4925,0,4925,9125,9125,9125,0
50218743,SP2021 ,12625,500,NULL,NULL,13125,6425,6425,0,NULL,6425,0,6425,6700,6700,6700,0
50218743,SP2022 ,13005,515,NULL,NULL,13520,6425,6425,0,NULL,6425,0,6425,7095,7095,7095,0
50218743,SP2023 ,13500,550,NULL,NULL,14050,4925,1100,3825,NULL,4925,0,4925,9125,9125,9125,0
50206436,FA2021 ,12625,6350,6350,NULL,18975,5825,5825,0,8250,11098,0,19348,7877,7877,-373,0
50206436,SP2021 ,12625,500,4830,NULL,17955,5825,5825,0,8750,7347,0,16097,5778,10608,1858,0
50232457,FA2024 ,14750,600,4200,2900,22450,11800,11800,0,2750,15998,0,18748,-648,6452,3702,15
50232457,SP2024 ,14750,600,5240,2680,23270,11800,11800,0,2750,15997,0,18747,-647,7273,4523,15
50216781,FA2021 ,12625,500,4050,2110,19285,8675,3875,4800,3750,10175,0,13925,2950,9110,5360,812.32
50216781,FA2022 ,13005,6590,6590,NULL,19595,6675,6675,0,3750,6675,0,10425,12920,12920,9170,812.32
50216781,FA2023 ,13500,550,5800,1200,21050,6675,3338,3337,8750,6675,0,15425,7375,14375,5625,812.32
50216781,FA2024 ,14750,600,6090,NULL,21440,8674,1337,7337,11875,8674,0,20549,6676,12766,891,812.32
50216781,SP2021 ,12625,500,4050,2110,19285,8675,3875,4800,3750,8675,0,12425,4450,10610,6860,812.32
50216781,SP2022 ,13005,515,5080,1140,19740,8675,0,8675,9250,8675,0,17925,4845,11065,1815,812.32
50216781,SP2023 ,13500,6825,6825,NULL,20325,6675,3337,3338,13750,6675,0,20425,13650,13650,-100,812.32
50204870,FA2021 ,12625,500,NULL,1080,14205,0,0,0,NULL,0,0,0,13125,14205,14205,0
50204870,SP2021 ,12625,500,NULL,1080,14205,0,0,0,NULL,0,0,0,13125,14205,14205,0
50210094,FA2021 ,12625,500,4050,2110,19285,3625,3625,0,11000,11623,0,22623,1502,7662,-3338,0
50210094,FA2022 ,13005,515,5080,1140,19740,5125,3125,2000,12000,12123,0,24123,1397,7617,-4383,0
50210094,SP2021 ,12625,500,4050,2110,19285,5625,3625,2000,9500,12682,0,22182,443,6603,-2897,0
50210094,SP2022 ,13005,515,5080,1140,19740,3125,3125,0,12000,10122,0,22122,3398,9618,-2382,0
50120127,FA2023 ,13500,550,4000,2325,20375,8050,8050,0,2750,8550,0,11300,5500,11825,9075,5391.67
50120127,FA2024 ,14750,600,5410,2450,23210,8250,8250,0,NULL,8250,0,8250,7100,14960,14960,5391.67
50120127,SP2023 ,13500,550,4000,2325,20375,7500,7500,0,2750,7500,0,10250,6550,12875,10125,5391.67
50120127,SP2024 ,14750,600,5410,2450,23210,7500,7500,0,NULL,7500,0,7500,7850,15710,15710,5391.67
50220930,FA2021 ,12625,500,3740,2110,18975,8500,8500,0,10250,13500,0,23750,-375,5475,-4775,0
50220930,SP2021 ,12625,500,3740,2110,18975,8500,8500,0,10250,8500,0,18750,4625,10475,225,0
50235031,FA2024 ,14750,600,4200,2450,22000,9400,9400,0,7750,17633,0,25383,-2283,4367,-3383,-739
50235031,SP2024 ,14750,600,4200,2450,22000,9400,9400,0,7750,13382,0,21132,1968,8618,868,-739
50216548,FA2021 ,12625,500,4580,2110,19815,7425,0,7425,3250,17928,0,21178,-4803,1887,-1363,0
50216548,FA2022 ,13005,515,4810,2220,20550,7425,0,7425,3750,17308,0,21058,-3788,3242,-508,0
50216548,FA2023 ,13500,550,4790,NULL,18840,7425,0,7425,3750,15023,0,18773,-973,3817,67,0
50216548,SP2021 ,12625,500,4580,2110,19815,7425,0,7425,3250,15927,0,19177,-2802,3888,638,0
50216548,SP2022 ,13005,515,4810,2220,20550,7425,0,7425,3750,17788,0,21538,-4268,2762,-988,0
50216548,SP2023 ,13500,550,4790,NULL,18840,7425,0,7425,3750,15022,0,18772,-972,3818,68,0
50226186,FA2022 ,13005,515,4810,2220,20550,5850,5850,0,2750,11223,0,13973,2297,9327,6577,-15
50226186,FA2023 ,13500,550,4560,2325,20935,7100,5500,1600,3250,11198,0,14448,2852,9737,6487,-15
50226186,SP2022 ,13005,515,4810,2220,20550,5850,5850,0,2750,11222,0,13972,2298,9328,6578,-15
50226186,SP2023 ,13500,550,4560,2325,20935,7100,5500,1600,3250,11197,0,14447,2853,9738,6488,-15
50226657,FA2022 ,13005,515,3855,2220,19595,8500,8500,0,NULL,8500,0,8500,5020,11095,11095,4628.66
50226657,FA2023 ,13500,550,4000,1200,19250,8500,8500,0,NULL,8500,0,8500,5550,10750,10750,4628.66
50226657,FA2024 ,14750,600,4200,2450,22000,8500,8500,0,NULL,8500,0,8500,6850,13500,13500,4628.66
50226657,SP2022 ,13005,515,3855,2220,19595,8500,8500,0,NULL,8500,0,8500,5020,11095,11095,4628.66
50226657,SP2023 ,13500,550,4000,1200,19250,8500,8500,0,NULL,8500,0,8500,5550,10750,10750,4628.66
50226657,SP2024 ,14750,600,4200,2450,22000,8500,8500,0,NULL,8500,0,8500,6850,13500,13500,4628.66
50222060,FA2021 ,12625,500,4580,2110,19815,8838,6748,2090,NULL,9838,0,9838,3287,9977,9977,0
50222060,FA2022 ,13005,515,3855,2220,19595,12664,5664,7000,NULL,12664,0,12664,856,6931,6931,0
50222060,FA2023 ,13500,550,4000,2325,20375,13579,5579,8000,NULL,14079,0,14079,-29,6296,6296,0
50222060,SP2021 ,12625,500,4580,2110,19815,6589,6589,0,NULL,6589,0,6589,6536,13226,13226,0
50222060,SP2022 ,13005,515,3855,2220,19595,13263,5763,7500,NULL,13263,0,13263,257,6332,6332,0
50222060,SP2023 ,13500,550,4000,2325,20375,11800,5800,6000,NULL,12800,0,12800,1250,7575,7575,0
9579789,FA2021 ,12625,500,NULL,NULL,13125,3500,3500,0,6250,6673,0,12923,6452,6452,202,0
50193419,SP2022 ,13005,515,NULL,NULL,13520,0,0,0,NULL,0,0,0,13520,13520,13520,18526
50221328,FA2021 ,12625,500,4580,2110,19815,7750,5750,2000,2750,8250,0,11000,4875,11565,8815,0
50221328,FA2022 ,13005,515,4810,2220,20550,5250,5250,0,0,5250,0,5250,8270,15300,15300,0
50221328,FA2023 ,13500,550,4560,2325,20935,5250,5250,0,NULL,5250,0,5250,8800,15685,15685,0
50221328,FA2024 ,14750,600,5030,1270,21650,5250,5250,0,NULL,5250,0,5250,10100,16400,16400,0
50221328,SP2021 ,12625,500,4580,2110,19815,5750,5750,0,2750,5750,0,8500,7375,14065,11315,0
50221328,SP2022 ,13005,515,4810,2220,20550,5250,5250,0,0,5250,0,5250,8270,15300,15300,0
50221328,SP2023 ,13500,550,5440,1200,20690,5250,5250,0,NULL,5250,0,5250,8800,15440,15440,0
50221329,FA2021 ,12625,500,4580,2110,19815,6750,4750,2000,2750,7250,0,10000,5875,12565,9815,0
50221329,FA2022 ,13005,515,NULL,NULL,13520,2933,2933,0,0,2933,0,2933,10587,10587,10587,0
50221329,FA2023 ,13500,550,NULL,NULL,14050,2933,2933,0,NULL,2933,0,2933,11117,11117,11117,0
50221329,FA2024 ,14750,600,NULL,NULL,15350,2933,2933,0,NULL,2933,0,2933,12417,12417,12417,0
50221329,SP2021 ,12625,500,4580,2110,19815,4750,4750,0,2750,4750,0,7500,8375,15065,12315,0
50221329,SP2022 ,13005,515,NULL,NULL,13520,2932,2932,0,0,2932,0,2932,10588,10588,10588,0
50221329,SP2023 ,13500,550,NULL,NULL,14050,2932,2932,0,NULL,2932,0,2932,11118,11118,11118,0
50221329,SP2024 ,14750,600,NULL,NULL,15350,2932,2932,0,NULL,2932,0,2932,12418,12418,12418,0
50224329,FA2023 ,13500,550,5150,2325,21525,6500,6500,0,NULL,6500,0,6500,7550,15025,15025,90
50224329,FA2024 ,14750,600,6090,1270,22710,6500,0,6500,NULL,6500,0,6500,8850,16210,16210,90
50224329,SP2023 ,13500,550,5150,2325,21525,6500,6500,0,NULL,6500,0,6500,7550,15025,15025,90
50224329,SP2024 ,14750,600,6090,1270,22710,6500,0,6500,NULL,6500,0,6500,8850,16210,16210,90
50221385,FA2021 ,12625,500,4580,2110,19815,8100,8100,0,2750,13100,0,15850,25,6715,3965,0
50221385,FA2022 ,13005,515,4610,1140,19270,8600,7600,1000,3750,10600,0,14350,2920,8670,4920,0
50221385,FA2023 ,13500,550,NULL,NULL,14050,5244,4644,600,3750,6367,0,10117,7683,7683,3933,0
50221385,SP2021 ,12625,500,4580,2110,19815,8100,8100,0,2750,8100,0,10850,5025,11715,8965,0
50221385,SP2022 ,13005,515,4610,NULL,18130,8600,7600,1000,3750,8600,0,12350,4920,9530,5780,0
50232052,FA2024 ,14750,600,4790,2450,22590,6000,6000,0,NULL,6000,0,6000,9350,16590,16590,10
50232052,SP2024 ,14750,600,4790,2450,22590,6000,6000,0,NULL,6000,0,6000,9350,16590,16590,10
50216656,FA2021 ,12625,500,4580,1080,18785,5675,4850,825,3250,12022,0,15272,1103,6763,3513,5144
50216656,FA2022 ,13005,515,4810,2220,20550,5675,0,5675,5750,10523,0,16273,2997,10027,4277,5144
50216656,FA2023 ,13500,550,4790,1200,20040,5675,0,5675,14134,11272,0,25406,2778,8768,-5366,5144
50216656,FA2024 ,14750,600,5030,1270,21650,5675,0,5675,4000,11173,0,15173,4177,10477,6477,5144
50216656,SP2021 ,12625,500,4580,1080,18785,5675,4850,825,3250,11083,0,14333,2042,7702,4452,5144
50216656,SP2022 ,13005,515,4810,2220,20550,5675,0,5675,5750,10522,0,16272,2998,10028,4278,5144
50216656,SP2023 ,13500,550,4790,2325,21165,5675,0,5675,14134,11273,0,25407,2777,9892,-4242,5144
50216656,SP2024 ,16660,600,5030,NULL,22290,5675,0,5675,4000,11172,0,15172,6088,11118,7118,5144
50231887,FA2024 ,14750,600,4200,2450,22000,9500,0,9500,2750,9500,0,12250,5850,12500,9750,3638
50231887,SP2024 ,14750,600,4790,2450,22590,9500,0,9500,2750,9500,0,12250,5850,13090,10340,3638
50226685,FA2022 ,14269,7231,7231,NULL,21500,0,0,0,NULL,0,0,0,21500,21500,21500,0
50216983,FA2021 ,12625,500,3740,2110,18975,0,0,0,2750,14748,12625,17498,-1623,4227,1477,0
50216983,FA2022 ,13005,515,4610,1140,19270,0,0,0,0,15605,13005,15605,-2085,3665,3665,0
50216983,SP2021 ,12625,500,3740,2110,18975,0,0,0,2750,13247,12625,15997,-122,5728,2978,0
50216983,SP2022 ,13005,515,4610,1140,19270,0,0,0,3250,15605,13005,18855,-2085,3665,415,0
50224929,SP2021 ,13867,6974,6974,NULL,20841,0,0,0,NULL,0,0,0,20841,20841,20841,0
50205655,FA2021 ,12625,500,4830,NULL,17955,3425,0,3425,12155,4925,0,17080,8200,13030,875,0
50220944,FA2021 ,12625,500,4580,2110,19815,6000,6000,0,13197,11100,0,24297,2025,8715,-4482,-1164
50220944,FA2022 ,13005,515,4810,2220,20550,5500,5500,0,16302,5500,0,21802,8020,15050,-1252,-1164
50220944,FA2023 ,13500,550,5440,2325,21815,5500,5500,0,16288,7123,0,23411,6927,14692,-1596,-1164
50220944,FA2024 ,14750,600,5030,2450,22830,6750,5500,1250,14473,9910,0,24383,5440,12920,-1553,-1164
50220944,SP2021 ,12625,500,4580,2110,19815,6000,6000,0,13196,6000,0,19196,7125,13815,619,-1164
50220944,SP2022 ,13005,515,4810,2220,20550,5500,5500,0,16302,5500,0,21802,8020,15050,-1252,-1164
50220944,SP2023 ,13500,550,5440,2325,21815,5500,5500,0,16288,7122,0,23410,6928,14693,-1595,-1164
50220944,SP2024 ,14750,600,5030,2450,22830,6750,5500,1250,14474,9910,0,24384,5440,12920,-1554,-1164
50221625,FA2021 ,12625,500,4580,2110,19815,6750,6750,0,11858,7750,0,19608,5375,12065,207,0
50221625,FA2022 ,13005,515,4810,2220,20550,9000,7500,1500,6816,9000,0,15816,4520,11550,4734,0
50221625,FA2023 ,13500,550,5150,2325,21525,8250,6750,1500,10813,8250,0,19063,5800,13275,2462,0
50221625,FA2024 ,14750,600,5720,NULL,21070,8250,6750,1500,12981,8250,0,21231,7100,12820,-161,0
50221625,SP2021 ,12625,500,4580,2110,19815,9750,6750,3000,7551,9750,0,17301,3375,10065,2514,0
50221625,SP2022 ,13005,515,4810,2220,20550,9000,7500,1500,9822,9000,0,18822,4520,11550,1728,0
50221625,SP2023 ,13500,550,5150,2325,21525,8250,6750,1500,13109,8250,0,21359,5800,13275,166,0
50221625,SP2024 ,8140,600,5720,NULL,14460,5225,3725,1500,3750,5225,0,8975,3515,9235,5485,0
50226961,FA2022 ,13005,515,4260,2220,20000,7400,7400,0,2750,11073,0,13823,2447,8927,6177,2967.73
50226961,FA2023 ,13500,550,4000,2325,20375,7400,6000,1400,0,7400,0,7400,6650,12975,12975,2967.73
50226961,FA2024 ,14750,600,5030,12,20392,7400,7400,0,3750,7400,0,11150,7950,12992,9242,2967.73
50226961,SP2022 ,13005,515,4260,2220,20000,7650,7650,0,2750,10822,0,13572,2698,9178,6428,2967.73
50226961,SP2023 ,13500,550,4000,2325,20375,7400,6000,1400,0,7400,0,7400,6650,12975,12975,2967.73
50226961,SP2024 ,14750,600,5030,NULL,20380,7400,7400,0,3750,7400,0,11150,7950,12980,9230,2967.73
50203405,FA2021 ,12625,500,NULL,NULL,13125,0,0,0,NULL,0,0,0,13125,13125,13125,0
50203405,SP2021 ,12625,500,NULL,NULL,13125,0,0,0,NULL,0,0,0,13125,13125,13125,0
50217183,FA2021 ,12625,500,4050,2110,19285,7325,7325,0,10873,10075,0,20948,3050,9210,-1663,0
50217183,FA2023 ,13500,550,NULL,NULL,14050,7075,7075,0,NULL,7075,0,7075,6975,6975,6975,0
50217183,FA2024 ,14750,600,NULL,NULL,15350,7075,7075,0,NULL,7075,0,7075,8275,8275,8275,0
50217183,SP2021 ,12625,500,4050,2110,19285,7325,7325,0,2750,8575,0,11325,4550,10710,7960,0
50217183,SP2022 ,13005,515,4260,2220,20000,7075,7075,0,NULL,7075,0,7075,6445,12925,12925,0
50217183,SP2023 ,13500,550,NULL,NULL,14050,7075,7075,0,NULL,7075,0,7075,6975,6975,6975,0
60001023,FA2024 ,14750,600,NULL,NULL,15350,0,0,0,NULL,14750,14750,14750,600,600,600,15
60001023,SP2024 ,14750,600,NULL,NULL,15350,0,0,0,NULL,14750,14750,14750,600,600,600,15
50226863,FA2022 ,13005,515,3855,2220,19595,8000,8000,0,NULL,8000,0,8000,5520,11595,11595,0
50226863,SP2022 ,13005,515,3855,2220,19595,12500,8000,4500,NULL,12500,0,12500,1020,7095,7095,0
50221493,FA2021 ,12625,500,3740,2110,18975,5000,5000,0,NULL,5000,0,5000,8125,13975,13975,0
50224930,SP2021 ,12625,6350,6350,NULL,18975,0,0,0,NULL,0,0,0,18975,18975,18975,0
50231401,FA2024 ,14750,600,4200,2450,22000,8500,8500,0,14575,8500,0,23075,6850,13500,-1075,-417
50231401,SP2024 ,14750,600,4200,2450,22000,8500,8500,0,14575,8500,0,23075,6850,13500,-1075,-417
50221330,FA2021 ,12625,500,4580,2110,19815,7200,7200,0,2750,8200,0,10950,4925,11615,8865,0
50221330,FA2022 ,13005,515,4610,1140,19270,6700,6000,700,14153,6700,0,20853,6820,12570,-1583,0
50221330,FA2023 ,13500,6825,6825,NULL,20325,6700,0,6700,17599,6700,0,24299,13625,13625,-3974,0
50221330,SP2021 ,12625,500,4580,2110,19815,7200,7200,0,2750,7200,0,9950,5925,12615,9865,0
50221330,SP2022 ,13005,515,4610,1140,19270,6700,6000,700,14152,6700,0,20852,6820,12570,-1582,0
50221330,SP2023 ,13500,550,4790,NULL,18840,6700,0,6700,14901,6700,0,21601,7350,12140,-2761,0
50224931,SP2021 ,15944,5556,5556,NULL,21500,0,0,0,NULL,0,0,0,21500,21500,21500,0
50129279,FA2021 ,12625,500,NULL,NULL,13125,0,0,0,NULL,0,0,0,13125,13125,13125,0
50129279,SP2021 ,12625,500,NULL,NULL,13125,0,0,0,NULL,0,0,0,13125,13125,13125,0
50218567,FA2021 ,12625,500,3740,2110,18975,14175,6175,8000,3750,15675,0,19425,-2550,3300,-450,0
50218567,FA2022 ,13005,515,4610,1140,19270,13425,5925,7500,3750,13425,0,17175,95,5845,2095,0
50218567,SP2021 ,12625,500,3740,2110,18975,10225,6225,4000,3750,10225,0,13975,2900,8750,5000,0
50218567,SP2022 ,13005,515,4610,1140,19270,10925,5925,5000,3750,10925,0,14675,2595,8345,4595,0
50221959,FA2021 ,12625,500,4580,2110,19815,6800,6800,0,10750,8300,0,19050,4825,11515,765,0
50221959,FA2022 ,13005,515,4810,2220,20550,6300,6300,0,3250,6300,0,9550,7220,14250,11000,0
50221959,FA2023 ,13500,6825,6825,NULL,20325,6700,6300,400,3750,6700,0,10450,13625,13625,9875,0
50221959,FA2024 ,14750,600,5030,NULL,20380,5900,5500,400,3750,5900,0,9650,9450,14480,10730,0
50221959,SP2021 ,12625,500,4580,2110,19815,6800,6800,0,10750,6800,0,17550,6325,13015,2265,0
50221959,SP2022 ,13005,515,4810,2220,20550,6300,6300,0,3250,6300,0,9550,7220,14250,11000,0
50221959,SP2023 ,13500,550,4790,1200,20040,5900,5500,400,3750,5900,0,9650,8150,14140,10390,0
50221959,SP2024 ,14750,600,5030,NULL,20380,5900,5500,400,3750,5900,0,9650,9450,14480,10730,0
50227281,FA2022 ,13005,515,4810,2220,20550,8300,8300,0,3250,10023,0,13273,3497,10527,7277,3637
50227281,FA2023 ,13500,550,5150,2325,21525,8300,5000,3300,10037,9623,0,19660,4427,11902,1865,3637
50227281,FA2024 ,14750,600,5410,2450,23210,8300,5000,3300,3750,12398,0,16148,2952,10812,7062,3637
50227281,SP2022 ,13005,515,4810,2220,20550,8300,8300,0,3250,10022,0,13272,3498,10528,7278,3637
50227281,SP2023 ,13500,550,5150,2325,21525,8300,5000,3300,10037,9622,0,19659,4428,11903,1866,3637
50227281,SP2024 ,14750,600,5410,2450,23210,8300,5000,3300,3750,12397,0,16147,2953,10813,7063,3637
50224951,FA2022 ,13005,515,3855,2220,19595,8150,8150,0,4750,11598,0,16348,1922,7997,3247,1721.67
50224951,FA2023 ,13500,550,4000,2325,20375,8150,6500,1650,5250,12248,0,17498,1802,8127,2877,1721.67
50224951,FA2024 ,14750,600,4200,2450,22000,8150,6500,1650,6250,12248,0,18498,3102,9752,3502,1721.67
50224951,SP2022 ,13005,515,3855,2220,19595,8150,8150,0,4750,11597,0,16347,1923,7998,3248,1721.67
50224951,SP2023 ,13500,550,4000,2325,20375,8150,6500,1650,5250,12247,0,17497,1803,8128,2878,1721.67
50224951,SP2024 ,14750,600,4780,2450,22580,8150,6500,1650,6250,12247,0,18497,3103,10333,4083,1721.67
50225589,FA2022 ,13005,515,4260,2220,20000,5500,5500,0,2750,11448,0,14198,2072,8552,5802,0
50226686,FA2022 ,14269,7231,7231,NULL,21500,0,0,0,NULL,0,0,0,21500,21500,21500,0
50232555,FA2024 ,14750,600,4790,2450,22590,6000,6000,0,2750,7300,0,10050,8050,15290,12540,205
50232555,SP2024 ,14750,600,4790,2450,22590,6000,6000,0,2750,6000,0,8750,9350,16590,13840,205
50225169,FA2022 ,13005,515,4800,2220,20540,6500,6500,0,15789,8000,0,23789,5520,12540,-3249,1051
50225169,FA2023 ,13500,550,5150,2325,21525,6500,6500,0,14126,6500,0,20626,7550,15025,899,1051
50225169,FA2024 ,14750,600,5030,1270,21650,6500,6500,0,18362,6500,0,24862,8850,15150,-3212,1051
50225169,SP2022 ,13005,515,4800,2220,20540,6500,6500,0,15789,6500,0,22289,7020,14040,-1749,1051
50225169,SP2023 ,13500,550,4560,2325,20935,6500,6500,0,14126,6500,0,20626,7550,14435,309,1051
50225169,SP2024 ,14750,600,5030,1270,21650,6500,6500,0,13138,6500,0,19638,8850,15150,2012,1051
50229274,FA2023 ,13500,550,4000,2325,20375,9350,8350,1000,2750,15173,0,17923,-1123,5202,2452,0
50229274,FA2024 ,14750,600,4200,2450,22000,10000,7150,2850,5250,13698,0,18948,1652,8302,3052,0
50229274,SP2023 ,13500,550,4000,2325,20375,9600,8600,1000,2750,10422,0,13172,3628,9953,7203,0
50229274,SP2024 ,14750,600,4200,2450,22000,9350,6500,2850,5250,13047,0,18297,2303,8953,3703,0
50217157,FA2021 ,12625,500,4050,2110,19285,3175,3175,0,13750,4675,0,18425,8450,14610,860,0
50217157,FA2022 ,13005,515,4610,1140,19270,4175,3175,1000,3750,4175,0,7925,9345,15095,11345,0
50217157,FA2023 ,13500,550,4790,NULL,18840,0,0,0,3750,13500,13500,17250,550,5340,1590,0
50217157,SP2021 ,12625,500,4050,2110,19285,3175,3175,0,13750,3175,0,16925,9950,16110,2360,0
50217157,SP2022 ,13005,515,4610,NULL,18130,4175,3175,1000,3750,4175,0,7925,9345,13955,10205,0
50217157,SP2023 ,13500,550,4790,NULL,18840,0,0,0,3750,13500,13500,17250,550,5340,1590,0
50231002,FA2023 ,13500,550,4560,2325,20935,6500,6500,0,3750,6500,0,10250,7550,14435,10685,0
50231002,FA2024 ,14750,600,NULL,NULL,15350,4485,4485,0,NULL,4485,0,4485,10865,10865,10865,0
50231002,SP2023 ,13500,550,5440,2325,21815,6500,6500,0,3750,6500,0,10250,7550,15315,11565,0
50231002,SP2024 ,14750,600,NULL,NULL,15350,4485,4485,0,NULL,4485,0,4485,10865,10865,10865,0
50228938,FA2023 ,13500,550,5150,2325,21525,7550,0,7550,0,9173,0,9173,4877,12352,12352,0
50228938,FA2024 ,14750,600,4200,2450,22000,7550,6000,1550,2250,14523,0,16773,827,7477,5227,0
50228938,SP2023 ,13500,550,5150,2325,21525,7550,0,7550,0,9172,0,9172,4878,12353,12353,0
50228938,SP2024 ,14750,600,4200,2450,22000,7550,6000,1550,2250,14522,0,16772,828,7478,5228,0
50231821,FA2024 ,14750,600,4200,2450,22000,9000,9000,0,2750,12698,0,15448,2652,9302,6552,0
50215714,FA2021 ,12625,500,4580,2110,19815,6000,6000,0,0,6000,0,6000,7125,13815,13815,0
50225249,FA2022 ,13005,515,3855,2220,19595,7500,7500,0,2750,7500,0,10250,6020,12095,9345,0
50225249,SP2022 ,13005,515,3855,2220,19595,7500,7500,0,2750,7500,0,10250,6020,12095,9345,0
50233883,FA2024 ,14750,600,4780,2450,22580,7500,7500,0,17750,7500,0,25250,7850,15080,-2670,-2000
50233883,SP2024 ,14750,600,4780,2450,22580,7500,7500,0,17750,7500,0,25250,7850,15080,-2670,-2000
50117907,FA2021 ,12625,500,4270,NULL,17395,9675,6750,2925,3750,11175,0,14925,1950,6220,2470,0
50117907,FA2022 ,13005,515,4610,NULL,18130,9675,6750,2925,3750,9675,0,13425,3845,8455,4705,0
50117907,SP2021 ,12625,500,4270,NULL,17395,7675,6750,925,3750,7675,0,11425,5450,9720,5970,0
50222122,FA2021 ,12625,500,3740,2110,18975,8100,8100,0,9163,10573,0,19736,2552,8402,-761,0
50212329,FA2021 ,19340,860,4910,1080,25330,10000,10000,0,NULL,10000,0,10000,10200,15330,15330,0
50212329,FA2022 ,10970,445,445,NULL,11415,4686,4686,0,3750,6631,0,10381,4784,4784,1034,0
50212329,FA2023 ,20670,950,950,NULL,21620,8500,8500,0,0,8500,0,8500,13120,13120,13120,0
50212329,SP2021 ,19340,860,4910,1080,25330,10000,10000,0,NULL,10000,0,10000,10200,15330,15330,0
50212329,SP2022 ,10970,445,445,NULL,11415,4686,4686,0,3750,7492,0,11242,3923,3923,173,0
50212329,SP2023 ,20670,950,950,NULL,21620,8500,8500,0,0,8500,0,8500,13120,13120,13120,0
50213394,FA2021 ,12625,500,4580,2110,19815,4475,4475,0,9250,5975,0,15225,7150,13840,4590,0
50213394,SP2021 ,12625,500,4580,2110,19815,4475,4475,0,12250,4475,0,16725,8650,15340,3090,0
50221062,FA2021 ,12625,500,4580,2110,19815,9500,7500,2000,0,14900,0,14900,-1775,4915,4915,0
50221062,FA2022 ,13005,515,4810,2220,20550,9000,7000,2000,NULL,9000,0,9000,4520,11550,11550,0
50221062,FA2023 ,13500,550,5150,2325,21525,9000,7000,2000,NULL,9000,0,9000,5050,12525,12525,0
50221062,FA2024 ,14750,600,5720,1270,22340,8000,6000,2000,3750,8000,0,11750,7350,14340,10590,0
50221062,SP2021 ,12625,500,4580,2110,19815,7500,7500,0,0,7500,0,7500,5625,12315,12315,0
50221062,SP2022 ,13005,515,4810,2220,20550,7000,7000,0,NULL,7000,0,7000,6520,13550,13550,0
50221062,SP2023 ,13500,550,5150,2325,21525,7000,7000,0,NULL,7000,0,7000,7050,14525,14525,0
50232327,FA2024 ,14750,600,5410,2450,23210,7500,6500,1000,2750,7500,0,10250,7850,15710,12960,0
50232327,SP2024 ,14750,600,5410,2450,23210,6500,6500,0,2750,6500,0,9250,8850,16710,13960,0
50216046,FA2021 ,19340,860,5440,2110,26890,11500,10500,1000,8250,13000,0,21250,7200,13890,5640,0
50228403,FA2023 ,13500,550,4550,2325,20925,7500,7500,0,NULL,7500,0,7500,6550,13425,13425,0
50228403,SP2023 ,13500,550,4550,2325,20925,7500,7500,0,NULL,7500,0,7500,6550,13425,13425,0
50216054,FA2021 ,12625,500,3740,2550,19415,3925,2675,1250,NULL,3925,0,3925,9200,15490,15490,0
50216054,FA2022 ,13005,515,4610,2220,20350,3925,2675,1250,NULL,3925,0,3925,9595,16425,16425,0
50216054,FA2023 ,13500,6825,6825,NULL,20325,3925,3925,0,NULL,3925,0,3925,16400,16400,16400,0
50216054,SP2021 ,12625,500,3740,2550,19415,3925,2675,1250,NULL,3925,0,3925,9200,15490,15490,0
50216054,SP2022 ,13005,515,4610,2220,20350,4175,2925,1250,NULL,4175,0,4175,9345,16175,16175,0
50216054,SP2023 ,13500,550,4000,2325,20375,3925,3300,625,NULL,3925,0,3925,10125,16450,16450,0
50228496,FA2023 ,13500,550,4000,2325,20375,8000,8000,0,NULL,11000,0,11000,3050,9375,9375,0
50228496,FA2024 ,14750,600,4200,2450,22000,8000,8000,0,NULL,12200,0,12200,3150,9800,9800,0
50228496,SP2023 ,13500,550,4000,2325,20375,8000,8000,0,NULL,8000,0,8000,6050,12375,12375,0
50228496,SP2024 ,14750,600,4200,2450,22000,8000,8000,0,NULL,12200,0,12200,3150,9800,9800,0
50205331,FA2021 ,12625,6350,6350,NULL,18975,3525,3525,0,3750,8848,0,12598,10127,10127,6377,0
50205331,SP2021 ,12625,500,NULL,NULL,13125,4611,1775,2836,3750,7933,0,11683,5192,5192,1442,0
50216517,FA2021 ,12625,500,3740,2110,18975,9425,9425,0,7240,13298,0,20538,-173,5677,-1563,0
50216517,FA2022 ,13005,515,4610,1140,19270,8925,8925,0,7500,11848,0,19348,1672,7422,-78,0
50216517,FA2023 ,13500,550,5440,2325,21815,9425,9425,0,9361,12298,0,21659,1752,9517,156,0
50216517,SP2021 ,12625,500,3740,2110,18975,9425,9425,0,7240,11297,0,18537,1828,7678,438,0
50216517,SP2022 ,13005,515,4610,1140,19270,8925,8925,0,7500,11847,0,19347,1673,7423,-77,0
50216517,SP2023 ,13500,550,5440,2325,21815,9425,9425,0,9362,12297,0,21659,1753,9518,156,0
50217203,FA2021 ,12625,500,4050,2110,19285,5425,5425,0,3250,6925,0,10175,6200,12360,9110,15108.33
50217203,FA2022 ,13005,515,4260,2220,20000,5425,5425,0,3750,5425,0,9175,8095,14575,10825,15108.33
50217203,FA2023 ,13500,550,4000,2325,20375,5425,0,5425,3750,5425,0,9175,8625,14950,11200,15108.33
50217203,SP2021 ,12625,500,4050,2110,19285,5425,5425,0,3250,5425,0,8675,7700,13860,10610,15108.33
50217203,SP2022 ,7170,515,4260,2220,14165,2991,2991,0,3750,2991,0,6741,4694,11174,7424,15108.33
50217203,SP2023 ,13500,550,4000,2325,20375,5425,0,5425,3750,5425,0,9175,8625,14950,11200,15108.33
50225060,FA2022 ,13005,515,4810,2220,20550,7650,7650,0,9927,10523,0,20450,2997,10027,100,500
50225060,FA2023 ,13500,550,NULL,NULL,14050,6141,3991,2150,3250,6141,0,9391,7909,7909,4659,500
50225060,FA2024 ,14750,600,NULL,NULL,15350,6141,3991,2150,3250,11339,0,14589,4011,4011,761,500
50225060,SP2022 ,13005,515,NULL,NULL,13520,4891,4891,0,7078,7763,0,14841,5757,5757,-1321,500
50225060,SP2023 ,13500,550,NULL,NULL,14050,6141,3991,2150,3250,6141,0,9391,7909,7909,4659,500
50225060,SP2024 ,14750,600,NULL,NULL,15350,6141,3991,2150,3250,11338,0,14588,4012,4012,762,500
50225061,FA2022 ,13005,515,4810,2220,20550,7300,7300,0,9927,10523,0,20450,2997,10027,100,446
50225061,FA2023 ,13500,550,NULL,NULL,14050,4149,4149,0,3250,11497,0,14747,2553,2553,-697,446
50225061,FA2024 ,14750,600,NULL,NULL,15350,5899,3849,2050,3750,9997,0,13747,5353,5353,1603,446
50225061,SP2022 ,13005,515,NULL,NULL,13520,4650,4650,0,7934,7872,0,15806,5648,5648,-2286,446
50225061,SP2023 ,13500,550,NULL,NULL,14050,4150,4150,0,3250,11497,0,14747,2553,2553,-697,446
50225061,SP2024 ,8140,300,NULL,NULL,8440,3255,2124,1131,3750,6544,0,10294,1896,1896,-1854,446
50233372,FA2024 ,14750,600,4790,2450,22590,6500,6500,0,12750,6500,0,19250,8850,16090,3340,0
50233372,SP2024 ,14750,600,4790,2450,22590,6500,6500,0,12750,6500,0,19250,8850,16090,3340,0
50211252,FA2021 ,19340,860,5510,2110,26960,6500,6500,0,NULL,6500,0,6500,13700,20460,20460,0
50211252,FA2022 ,19910,890,4745,2220,26875,6500,6500,0,NULL,6500,0,6500,14300,20375,20375,0
50211252,SP2021 ,19340,860,5510,2110,26960,6500,6500,0,NULL,6500,0,6500,13700,20460,20460,0
50211252,SP2022 ,19910,890,4745,2220,26875,6500,6500,0,NULL,6500,0,6500,14300,20375,20375,0
50227729,FA2022 ,13005,515,4810,2220,20550,8350,8350,0,2750,9600,0,12350,3920,10950,8200,0
50120946,FA2021 ,12625,500,4830,NULL,17955,0,0,0,NULL,12625,12625,12625,500,5330,5330,0
50120946,SP2021 ,12625,500,4830,1080,19035,0,0,0,NULL,12625,12625,12625,500,6410,6410,0
50235930,SP2024 ,15000,7500,7500,NULL,22500,0,0,0,NULL,0,0,0,22500,22500,22500,-323.61
50203723,FA2021 ,19340,860,5690,NULL,25030,16000,11000,5000,4600,17800,0,22400,2400,7230,2630,0
50220703,FA2021 ,12625,500,3740,2110,18975,8750,8750,0,2750,13323,0,16073,-198,5652,2902,0
50220703,SP2021 ,12625,500,3740,2110,18975,8750,8750,0,2750,11822,0,14572,1303,7153,4403,0
50223014,FA2024 ,14750,600,NULL,NULL,15350,5760,0,5760,9325,8230,0,17555,7120,7120,-2205,475
50223014,SP2021 ,12625,500,NULL,NULL,13125,4500,4500,0,0,6673,0,6673,6452,6452,6452,475
50223014,SP2023 ,13500,550,NULL,NULL,14050,2760,2760,0,12900,2760,0,15660,11290,11290,-1610,475
50223014,SP2024 ,14750,600,NULL,NULL,15350,2760,0,2760,9325,5230,0,14555,10120,10120,795,475
50120130,FA2024 ,14750,600,4200,2900,22450,9000,0,9000,2750,12500,0,15250,2850,9950,7200,3576.32
50120130,SP2024 ,14750,600,4200,2900,22450,9000,0,9000,2750,9000,0,11750,6350,13450,10700,3576.32
50220927,FA2021 ,12625,500,4050,2110,19285,7750,7750,0,2750,7750,0,10500,5375,11535,8785,0
50220927,FA2022 ,13005,515,4260,2220,20000,8250,6750,1500,NULL,8250,0,8250,5270,11750,11750,0
50220927,FA2023 ,13500,550,4560,1200,19810,8250,6750,1500,NULL,8250,0,8250,5800,11560,11560,0
50220927,FA2024 ,14750,7250,7250,NULL,22000,2800,2800,0,NULL,2800,0,2800,19200,19200,19200,0
50220927,SP2021 ,12625,500,4050,2110,19285,7750,7750,0,2750,7750,0,10500,5375,11535,8785,0
50220927,SP2022 ,13005,515,4260,2690,20470,8250,6750,1500,NULL,8250,0,8250,5270,12220,12220,0
50220927,SP2023 ,13500,550,4560,1200,19810,6750,6750,0,NULL,6750,0,6750,7300,13060,13060,0
50232247,SP2023 ,12500,4300,4300,NULL,16800,0,0,0,NULL,0,0,0,16800,16800,16800,0
50209778,FA2021 ,12625,500,4270,1080,18475,1425,0,1425,3750,2925,0,6675,10200,15550,11800,0
50209778,FA2022 ,13005,515,4610,1140,19270,1425,0,1425,3750,1425,0,5175,12095,17845,14095,0
50209778,SP2021 ,12625,500,4270,1080,18475,1425,0,1425,3750,1425,0,5175,11700,17050,13300,0
50120131,FA2024 ,14750,600,5410,2450,23210,5500,5500,0,NULL,5500,0,5500,9850,17710,17710,8988.99
50120131,SP2024 ,14750,600,5410,2450,23210,5500,5500,0,NULL,5500,0,5500,9850,17710,17710,8988.99
50205399,FA2022 ,13005,515,4800,2220,20540,4425,4425,0,NULL,7873,0,7873,5647,12667,12667,0
50205399,FA2023 ,7450,550,5800,NULL,13800,2442,942,1500,3750,2442,0,6192,5558,11358,7608,0
50205399,SP2022 ,7170,515,4800,2220,14705,2440,2440,0,NULL,4164,0,4164,3521,10541,10541,0
50205399,SP2023 ,7450,550,5800,NULL,13800,2442,942,1500,1214,2442,0,3656,5558,11358,10144,0
50234999,FA2024 ,14750,600,4200,2450,22000,8028,8028,0,NULL,8028,0,8028,7322,13972,13972,0
50234999,SP2024 ,14750,600,4200,2450,22000,8028,8028,0,NULL,8028,0,8028,7322,13972,13972,0
50217039,FA2021 ,12625,500,5160,2110,20395,0,0,0,3750,1500,0,5250,11625,18895,15145,0
50217039,SP2021 ,6960,500,5160,2110,14730,0,0,0,3750,0,0,3750,7460,14730,10980,0
50226281,FA2022 ,13005,515,3855,2220,19595,9500,9500,0,NULL,9500,0,9500,4020,10095,10095,0
50226281,FA2023 ,13500,550,4000,2325,20375,9500,7000,2500,NULL,9500,0,9500,4550,10875,10875,0
50226281,SP2022 ,13005,515,3855,2220,19595,9500,9500,0,NULL,9500,0,9500,4020,10095,10095,0
50226281,SP2023 ,13500,550,4000,2325,20375,9500,7000,2500,NULL,9500,0,9500,4550,10875,10875,0
50228551,FA2023 ,13500,550,4000,2325,20375,7500,7500,0,2750,7500,0,10250,6550,12875,10125,0
50228551,FA2024 ,14750,600,4200,2450,22000,8500,7500,1000,0,12700,0,12700,2650,9300,9300,0
50228551,SP2023 ,13500,550,4000,2325,20375,7500,7500,0,2750,7500,0,10250,6550,12875,10125,0
50228551,SP2024 ,14750,600,4200,2450,22000,8500,7500,1000,0,12700,0,12700,2650,9300,9300,0
50223248,FA2022 ,13005,515,3855,2220,19595,9556,5056,4500,NULL,9556,0,9556,3964,10039,10039,270
50223248,FA2023 ,13500,550,4000,2325,20375,11630,4130,7500,NULL,11630,0,11630,2420,8745,8745,270
50223248,FA2024 ,14750,600,4200,2450,22000,11500,4000,7500,NULL,11500,0,11500,3850,10500,10500,270
50223248,SP2021 ,6960,250,NULL,NULL,7210,5381,2349,3032,NULL,5381,0,5381,1829,1829,1829,270
50223248,SP2022 ,13005,515,3855,2220,19595,6572,5072,1500,NULL,6572,0,6572,6948,13023,13023,270
50223248,SP2023 ,13500,550,4000,2325,20375,11596,4096,7500,NULL,11596,0,11596,2454,8779,8779,270
50223248,SP2024 ,14750,600,4200,2450,22000,11500,4000,7500,NULL,11500,0,11500,3850,10500,10500,270
50236639,SP2024 ,14750,600,4200,2450,22000,5500,5500,0,13296,5500,0,18796,9850,16500,3204,1669.33
50209172,FA2021 ,12625,500,4580,2110,19815,2425,0,2425,3750,3425,0,7175,9700,16390,12640,0
50209172,FA2022 ,13005,515,4610,1140,19270,2425,2425,0,3750,2425,0,6175,11095,16845,13095,0
50209172,SP2021 ,12625,500,4580,2110,19815,2425,0,2425,3750,2425,0,6175,10700,17390,13640,0
50209172,SP2022 ,13005,515,4610,1140,19270,2425,2425,0,17500,2425,0,19925,11095,16845,-655,0
50209173,FA2021 ,12625,500,4270,1080,18475,1425,1425,0,3750,2425,0,6175,10700,16050,12300,0
50209173,SP2021 ,6960,250,NULL,NULL,7210,0,0,0,3750,0,0,3750,7210,7210,3460,0
50209573,FA2021 ,12625,6350,6350,NULL,18975,588,588,0,18500,588,0,19088,18387,18387,-113,0
50116557,FA2021 ,12625,500,4830,1080,19035,715,0,715,3250,14840,12625,18090,-1715,4195,945,0
50116557,FA2022 ,13005,515,5080,1140,19740,0,0,0,3750,13005,13005,16755,515,6735,2985,0
50116557,SP2021 ,12625,500,4830,1080,19035,0,0,0,3250,12625,12625,15875,500,6410,3160,0
50116557,SP2022 ,7170,515,5080,1140,13905,0,0,0,3750,7170,7170,10920,515,6735,2985,0
50216132,FA2021 ,12625,500,3740,2110,18975,11975,0,11975,0,23348,0,23348,-10223,-4373,-4373,-5250
50216132,FA2022 ,13005,515,3855,2220,19595,11975,0,11975,0,19348,0,19348,-5828,247,247,-5250
50216132,FA2023 ,13500,550,4790,1200,20040,13475,0,13475,3750,21847,0,25597,-7797,-1807,-5557,-5250
50216132,FA2024 ,14750,600,4200,1270,20820,15975,0,15975,0,22692,0,22692,-7342,-1872,-1872,-5250
50216132,SP2021 ,12625,500,3740,2110,18975,11975,0,11975,0,16847,0,16847,-3722,2128,2128,-5250
50216132,SP2022 ,13005,515,3855,2220,19595,11975,0,11975,0,16847,0,16847,-3327,2748,2748,-5250
50216132,SP2023 ,13500,550,4790,1200,20040,13475,0,13475,3750,19348,0,23098,-5298,692,-3058,-5250
50216132,SP2024 ,14750,600,4200,1270,20820,13975,0,13975,0,22693,0,22693,-7343,-1873,-1873,-5250
50110316,FA2021 ,12625,500,4270,1080,18475,1675,1675,0,NULL,1675,0,1675,11450,16800,16800,0
50110316,FA2022 ,13005,515,4610,NULL,18130,1675,1675,0,NULL,1675,0,1675,11845,16455,16455,0
50110316,FA2023 ,13500,550,4790,NULL,18840,1675,1675,0,NULL,1675,0,1675,12375,17165,17165,0
50110316,SP2021 ,12625,500,4270,1080,18475,1675,1675,0,NULL,1675,0,1675,11450,16800,16800,0
50110316,SP2022 ,13005,515,4610,NULL,18130,1675,1675,0,NULL,1675,0,1675,11845,16455,16455,0
50110316,SP2023 ,13500,550,4790,NULL,18840,1675,1675,0,NULL,1675,0,1675,12375,17165,17165,0
50118810,FA2021 ,12625,500,4580,2110,19815,8425,8425,0,NULL,9425,0,9425,3700,10390,10390,0
50118810,FA2022 ,13005,515,4810,2220,20550,8425,0,8425,NULL,9425,0,9425,4095,11125,11125,0
50118810,FA2023 ,13500,550,5440,2325,21815,8425,0,8425,NULL,18425,0,18425,-4375,3390,3390,0
50118810,SP2021 ,12625,500,4580,2110,19815,8425,8425,0,NULL,8425,0,8425,4700,11390,11390,0
50118810,SP2022 ,13005,515,4810,2220,20550,8425,0,8425,NULL,8425,0,8425,5095,12125,12125,0
50118810,SP2023 ,13500,550,5440,1200,20690,8425,0,8425,NULL,17425,0,17425,-3375,3265,3265,0
50119297,FA2022 ,13005,515,4810,2220,20550,9500,7500,2000,0,13400,0,13400,120,7150,7150,0
50119297,FA2023 ,13500,550,4000,2325,20375,11000,7000,4000,3250,12000,0,15250,2050,8375,5125,0
50119297,FA2024 ,14750,7250,7250,NULL,22000,6150,3150,3000,NULL,7150,0,7150,14850,14850,14850,0
50119297,SP2022 ,13005,515,4810,2220,20550,7500,7500,0,0,9250,0,9250,4270,11300,11300,0
50119297,SP2023 ,13500,550,4560,2325,20935,8500,7000,1500,3250,8500,0,11750,5550,12435,9185,0
50119297,SP2024 ,14750,600,5720,1270,22340,6000,6000,0,NULL,8000,0,8000,7350,14340,14340,0
50222154,FA2021 ,12625,500,3740,2110,18975,7250,7250,0,2750,7750,0,10500,5375,11225,8475,220
50222154,FA2022 ,13005,515,3855,2220,19595,6750,6750,0,NULL,6750,0,6750,6770,12845,12845,220
50222154,FA2023 ,13500,550,4550,2325,20925,6750,6750,0,NULL,6750,0,6750,7300,14175,14175,220
50222154,FA2024 ,14750,600,4200,2450,22000,6750,6750,0,NULL,6750,0,6750,8600,15250,15250,220
50222154,SP2021 ,12625,500,3740,2110,18975,7250,7250,0,2750,7250,0,10000,5875,11725,8975,220
50222154,SP2022 ,13005,515,3855,2220,19595,6750,6750,0,NULL,6750,0,6750,6770,12845,12845,220
50222154,SP2023 ,13500,550,4550,2325,20925,6750,6750,0,NULL,6750,0,6750,7300,14175,14175,220
50222154,SP2024 ,14750,600,4200,2450,22000,6750,6750,0,NULL,6750,0,6750,8600,15250,15250,220
50232685,FA2024 ,14750,600,5410,2450,23210,10500,8500,2000,2750,10500,0,13250,4850,12710,9960,125
50232685,SP2024 ,14750,600,5410,2450,23210,8500,8500,0,2750,8500,0,11250,6850,14710,11960,125
50204963,FA2021 ,12625,500,4270,1080,18475,3325,3325,0,14453,6948,0,21401,6177,11527,-2926,0
50204963,FA2022 ,13005,515,5420,27.9,18967.9,2825,2825,0,14756,6248,0,21004,7272,12719.9,-2036.1,0
50204963,SP2021 ,12625,500,4270,1080,18475,3325,3325,0,14714,4947,0,19661,8178,13528,-1186,0
50204963,SP2022 ,13005,515,5420,NULL,18940,2825,2825,0,13486,6247,0,19733,7273,12693,-793,0
50215424,FA2021 ,12625,500,3740,2110,18975,0,0,0,3250,17865,12625,21115,-4740,1110,-2140,0
50215424,FA2022 ,13005,515,5080,1140,19740,0,0,0,3750,18231,13005,21981,-4711,1509,-2241,0
50215424,SP2021 ,12625,500,3740,2110,18975,0,0,0,3250,16365,12625,19615,-3240,2610,-640,0
50215424,SP2022 ,13005,6590,6590,NULL,19595,7425,6425,1000,0,16898,0,16898,2697,2697,2697,0
50225784,FA2022 ,13005,515,4810,2220,20550,0,0,0,NULL,13005,13005,13005,515,7545,7545,-15
50225784,FA2023 ,13500,550,4560,2325,20935,0,0,0,NULL,13500,13500,13500,550,7435,7435,-15
50225784,FA2024 ,14750,600,5030,1270,21650,0,0,0,NULL,14750,14750,14750,600,6900,6900,-15
50225784,SP2022 ,13005,515,4810,2220,20550,0,0,0,NULL,13005,13005,13005,515,7545,7545,-15
50225784,SP2023 ,13500,550,4560,2325,20935,0,0,0,NULL,13500,13500,13500,550,7435,7435,-15
50225784,SP2024 ,14750,600,5030,1270,21650,0,0,0,NULL,14750,14750,14750,600,6900,6900,-15
50228751,FA2023 ,13500,550,4000,2325,20375,0,0,0,NULL,13500,13500,13500,550,6875,6875,0
50228751,FA2024 ,14750,600,4200,2450,22000,0,0,0,NULL,14750,14750,14750,600,7250,7250,0
50228751,SP2023 ,13500,550,4000,2325,20375,0,0,0,NULL,13500,13500,13500,550,6875,6875,0
50228751,SP2024 ,14750,600,4200,2450,22000,0,0,0,NULL,14750,14750,14750,600,7250,7250,0
50204211,FA2021 ,12625,500,NULL,NULL,13125,575,0,575,8750,2075,0,10825,11050,11050,2300,0
50204211,SP2021 ,12625,500,NULL,NULL,13125,575,0,575,8750,575,0,9325,12550,12550,3800,0
50198055,FA2021 ,12625,500,4830,NULL,17955,6425,0,6425,NULL,7925,0,7925,5200,10030,10030,0
50217604,FA2021 ,12625,500,3740,2110,18975,12425,0,12425,2750,13925,0,16675,-800,5050,2300,0
50217604,FA2022 ,13005,515,3855,NULL,17375,12425,12425,0,3750,12425,0,16175,1095,4950,1200,0
50217604,FA2023 ,13500,550,4790,NULL,18840,12425,0,12425,3750,12425,0,16175,1625,6415,2665,0
50217604,SP2021 ,12625,500,3740,2110,18975,12425,0,12425,2750,12425,0,15175,700,6550,3800,0
50217604,SP2022 ,13005,515,3855,NULL,17375,12425,12425,0,3750,12425,0,16175,1095,4950,1200,0
50217604,SP2023 ,13500,550,4790,NULL,18840,12425,0,12425,3750,12425,0,16175,1625,6415,2665,0
50231393,FA2024 ,14750,600,5410,2900,23660,7000,7000,0,NULL,7500,0,7500,7850,16160,16160,0
50231393,SP2024 ,14750,600,5410,2680,23440,7000,7000,0,NULL,7500,0,7500,7850,15940,15940,0
50229355,FA2023 ,13500,550,5150,2325,21525,9000,9000,0,NULL,9000,0,9000,5050,12525,12525,0
50229355,FA2024 ,14750,600,5410,2450,23210,9000,9000,0,NULL,9000,0,9000,6350,14210,14210,0
50229355,SP2023 ,13500,550,5150,2325,21525,9000,9000,0,NULL,9000,0,9000,5050,12525,12525,0
50229355,SP2024 ,14750,600,5410,2450,23210,9000,9000,0,NULL,9000,0,9000,6350,14210,14210,0
50229463,FA2023 ,13500,550,4560,2325,20935,7000,7000,0,15250,7000,0,22250,7050,13935,-1315,0
50229463,FA2024 ,14750,600,5720,NULL,21070,7000,7000,0,12500,7000,0,19500,8350,14070,1570,0
50229463,SP2023 ,13500,550,4560,2325,20935,7000,7000,0,15250,7000,0,22250,7050,13935,-1315,0
50229463,SP2024 ,14750,600,5720,NULL,21070,7000,7000,0,12500,7000,0,19500,8350,14070,1570,0
50221617,FA2021 ,12625,500,3740,2110,18975,6750,6750,0,2750,6750,0,9500,6375,12225,9475,100
50221617,FA2022 ,13005,515,3855,2220,19595,6250,6250,0,3250,6250,0,9500,7270,13345,10095,100
50221617,FA2023 ,13500,550,4000,1200,19250,6250,6250,0,3750,6250,0,10000,7800,13000,9250,100
50221617,FA2024 ,14750,600,5030,NULL,20380,6250,6250,0,3750,6250,0,10000,9100,14130,10380,100
50221617,SP2021 ,12625,500,3740,2110,18975,6750,6750,0,2750,6750,0,9500,6375,12225,9475,100
50221617,SP2022 ,13005,515,3855,2220,19595,6250,6250,0,3250,6250,0,9500,7270,13345,10095,100
50221617,SP2023 ,13500,6825,6825,NULL,20325,3100,3100,0,3750,3100,0,6850,17225,17225,13475,100
50221617,SP2024 ,14750,600,5030,NULL,20380,6250,6250,0,3750,6250,0,10000,9100,14130,10380,100
50120830,FA2021 ,12625,500,4270,NULL,17395,2975,250,2725,15393,4475,0,19868,8650,12920,-2473,0
50120830,SP2021 ,12625,500,4270,NULL,17395,2725,0,2725,15394,2725,0,18119,10400,14670,-724,0
50221926,FA2021 ,12625,500,3740,2110,18975,7750,5750,2000,2750,16698,0,19448,-3573,2277,-473,0
50221926,FA2022 ,13005,515,3855,2220,19595,5600,5000,600,3250,5600,0,8850,7920,13995,10745,0
50221926,SP2021 ,12625,500,3740,2110,18975,5750,5750,0,2750,11757,0,14507,1368,7218,4468,0
50225117,FA2022 ,13005,515,4810,2220,20550,6750,6750,0,2750,9250,0,12000,4270,11300,8550,-428.4
50225117,FA2023 ,13500,550,5150,2325,21525,7000,7000,0,NULL,12150,0,12150,1900,9375,9375,-428.4
50225117,FA2024 ,14750,600,5410,2450,23210,7500,500,7000,NULL,7500,0,7500,7850,15710,15710,-428.4
50225117,SP2022 ,13005,515,4810,2220,20550,6800,6800,0,2750,7800,0,10550,5720,12750,10000,-428.4
50225117,SP2023 ,13500,550,5150,2325,21525,7000,7000,0,NULL,12150,0,12150,1900,9375,9375,-428.4
50225117,SP2024 ,14750,7250,7250,NULL,22000,7500,500,7000,NULL,7500,0,7500,14500,14500,14500,-428.4
50231452,FA2024 ,14750,600,5410,2450,23210,8000,8000,0,16475,8000,0,24475,7350,15210,-1265,0
50231452,SP2024 ,14750,600,5410,2450,23210,8000,8000,0,16474,8000,0,24474,7350,15210,-1264,0
50209179,FA2021 ,12625,500,3740,1080,17945,2425,0,2425,0,3925,0,3925,9200,14020,14020,0
50209179,FA2022 ,13005,515,4610,NULL,18130,2425,2425,0,3750,2425,0,6175,11095,15705,11955,0
50209179,SP2022 ,13005,515,4610,NULL,18130,2425,2425,0,3750,2425,0,6175,11095,15705,11955,0
50213293,FA2021 ,12625,500,3740,2110,18975,7175,7175,0,NULL,10915,0,10915,2210,8060,8060,0
50213293,FA2022 ,13005,515,4610,NULL,18130,6675,6675,0,3750,6675,0,10425,6845,11455,7705,0
50213293,FA2023 ,13500,550,5800,NULL,19850,6675,0,6675,NULL,9175,0,9175,4875,10675,10675,0
50213293,SP2021 ,12625,500,3740,2110,18975,7175,7175,0,NULL,10915,0,10915,2210,8060,8060,0
50213293,SP2022 ,13005,6590,6590,NULL,19595,6675,6675,0,3750,6675,0,10425,12920,12920,9170,0
50213293,SP2023 ,13500,550,5800,1200,21050,6675,0,6675,NULL,9175,0,9175,4875,11875,11875,0
50235057,FA2024 ,14750,600,5240,1270,21860,13178,13178,0,NULL,13178,0,13178,2172,8682,8682,6787
50235057,SP2024 ,14750,600,4200,2450,22000,13178,13178,0,NULL,13178,0,13178,2172,8822,8822,6787
50216549,FA2021 ,12625,500,4580,2110,19815,1425,1425,0,3250,2425,0,5675,10700,17390,14140,0
50221471,FA2021 ,12625,500,4580,2110,19815,6750,6750,0,2750,7750,0,10500,5375,12065,9315,0
50221471,FA2022 ,13005,515,4260,2220,20000,6250,6250,0,NULL,6250,0,6250,7270,13750,13750,0
50221471,FA2023 ,13500,550,4560,2325,20935,6250,6250,0,3750,6250,0,10000,7800,14685,10935,0
50221471,SP2021 ,12625,500,4580,2110,19815,6750,6750,0,2750,6750,0,9500,6375,13065,10315,0
50221471,SP2022 ,13005,515,4260,2220,20000,6250,6250,0,NULL,6250,0,6250,7270,13750,13750,0
50221471,SP2023 ,13500,550,NULL,NULL,14050,4313,4313,0,3750,4313,0,8063,9737,9737,5987,0
50226697,FA2022 ,13005,515,3855,2220,19595,7000,7000,0,2750,7000,0,9750,6520,12595,9845,-1065
50226697,FA2023 ,13500,550,4000,2325,20375,8500,7000,1500,NULL,8500,0,8500,5550,11875,11875,-1065
50226697,FA2024 ,14750,600,4200,2450,22000,7000,7000,0,NULL,7000,0,7000,8350,15000,15000,-1065
50226697,SP2022 ,13005,515,3855,2220,19595,7000,7000,0,2750,7000,0,9750,6520,12595,9845,-1065
50226697,SP2023 ,13500,550,4000,2325,20375,8500,7000,1500,NULL,8500,0,8500,5550,11875,11875,-1065
50226697,SP2024 ,14750,600,4200,1270,20820,7000,7000,0,NULL,7000,0,7000,8350,13820,13820,-1065
50204997,FA2021 ,12625,500,4270,1080,18475,6725,6725,0,11050,8525,0,19575,4600,9950,-1100,0
50204997,FA2022 ,13005,515,4610,NULL,18130,6725,6725,0,11198,7025,0,18223,6495,11105,-93,0
50204997,SP2021 ,12625,500,4270,NULL,17395,6725,6725,0,11050,7025,0,18075,6100,10370,-680,0
50204997,SP2022 ,13005,515,4610,NULL,18130,6725,6725,0,11198,7025,0,18223,6495,11105,-93,0
50221847,FA2021 ,12625,500,4580,2110,19815,0,0,0,2750,12625,12625,15375,500,7190,4440,-330
50221847,FA2022 ,13005,515,3855,1140,18515,0,0,0,3250,13005,13005,16255,515,5510,2260,-330
50221847,FA2023 ,13500,550,NULL,NULL,14050,0,0,0,NULL,13500,13500,13500,550,550,550,-330
50221847,FA2024 ,14750,600,NULL,NULL,15350,0,0,0,NULL,14750,14750,14750,600,600,600,-330
50221847,SP2021 ,12625,500,4580,2110,19815,0,0,0,2750,12625,12625,15375,500,7190,4440,-330
50221847,SP2022 ,13005,515,3855,1140,18515,0,0,0,3250,13005,13005,16255,515,5510,2260,-330
50221847,SP2023 ,3720,NULL,NULL,NULL,3720,174,174,0,NULL,3894,3720,3894,-174,-174,-174,-330
50221847,SP2024 ,14750,600,NULL,NULL,15350,0,0,0,NULL,14750,14750,14750,600,600,600,-330
50222833,FA2021 ,12625,500,3740,2110,18975,7500,7500,0,2750,10573,0,13323,2552,8402,5652,0
50222833,FA2022 ,13005,515,3855,2220,19595,7900,7900,0,3250,7900,0,11150,5620,11695,8445,0
50222833,FA2023 ,13500,550,4000,2325,20375,8400,6950,1450,10701,8400,0,19101,5650,11975,1274,0
50222833,FA2024 ,14750,600,5410,2450,23210,8400,5500,2900,3750,8400,0,12150,6950,14810,11060,0
50222833,SP2021 ,12625,500,3740,2110,18975,7500,7500,0,2750,9072,0,11822,4053,9903,7153,0
50222833,SP2022 ,13005,515,3855,2220,19595,7900,7900,0,3250,7900,0,11150,5620,11695,8445,0
50222833,SP2023 ,13500,550,4000,2325,20375,8400,6950,1450,10701,8400,0,19101,5650,11975,1274,0
50224684,FA2022 ,13005,515,4260,2220,20000,9000,9000,0,2750,9000,0,11750,4520,11000,8250,0
50224684,FA2023 ,13500,550,4790,1200,20040,9000,9000,0,3250,9000,0,12250,5050,11040,7790,0
50224684,FA2024 ,14750,600,5030,1270,21650,9000,7500,1500,17053,9000,0,26053,6350,12650,-4403,0
50224684,SP2022 ,13005,515,4260,2220,20000,9000,9000,0,2750,9000,0,11750,4520,11000,8250,0
50224684,SP2023 ,13500,550,4790,1200,20040,9000,9000,0,3250,9000,0,12250,5050,11040,7790,0
50224684,SP2024 ,14750,600,5030,1270,21650,9000,7500,1500,13517,9000,0,22517,6350,12650,-867,0
50233071,FA2024 ,14750,600,5410,2450,23210,8000,8000,0,2750,8000,0,10750,7350,15210,12460,6387.49
50233071,SP2024 ,14750,600,5410,2450,23210,8000,8000,0,2750,8000,0,10750,7350,15210,12460,6387.49
50213259,FA2021 ,12625,500,4580,2110,19815,2775,0,2775,6250,11628,0,17878,1497,8187,1937,0
50221913,FA2021 ,12625,500,3740,2110,18975,5500,5500,0,NULL,5500,0,5500,7625,13475,13475,0
50221913,FA2022 ,13005,515,4810,2220,20550,5500,5500,0,NULL,5500,0,5500,8020,15050,15050,0
50221913,FA2023 ,13500,550,4790,2325,21165,5500,5500,0,NULL,5500,0,5500,8550,15665,15665,0
50221913,FA2024 ,14750,600,NULL,NULL,15350,3795,3795,0,NULL,3795,0,3795,11555,11555,11555,0
50221913,SP2021 ,12625,500,3740,2110,18975,5500,5500,0,NULL,6500,0,6500,6625,12475,12475,0
50221913,SP2022 ,13005,515,4810,2220,20550,5500,5500,0,NULL,5500,0,5500,8020,15050,15050,0
50221913,SP2023 ,13500,550,NULL,NULL,14050,3795,3795,0,NULL,3795,0,3795,10255,10255,10255,0
50221913,SP2024 ,14750,600,NULL,NULL,15350,3795,3795,0,NULL,3795,0,3795,11555,11555,11555,0
50228381,SP2022 ,14269,7231,7231,NULL,21500,0,0,0,NULL,0,0,0,21500,21500,21500,0
50234375,FA2024 ,15000,7500,7500,NULL,22500,0,0,0,NULL,0,0,0,22500,22500,22500,0
50204836,FA2021 ,12625,6350,6350,NULL,18975,4175,2675,1500,NULL,4675,0,4675,14300,14300,14300,0
50204836,SP2021 ,12625,500,4580,2110,19815,10175,4100,6075,NULL,10175,0,10175,2950,9640,9640,0
50204368,FA2021 ,12625,500,4270,NULL,17395,0,0,0,3750,13625,12625,17375,-500,3770,20,0
50204368,SP2021 ,12625,500,4270,NULL,17395,0,0,0,3750,12625,12625,16375,500,4770,1020,0
50224920,FA2022 ,13005,515,4810,2220,20550,6500,6500,0,2750,6500,0,9250,7020,14050,11300,0
50224920,FA2023 ,13500,550,5150,2325,21525,6500,6500,0,3250,11650,0,14900,2400,9875,6625,0
50224920,FA2024 ,14750,600,5410,2450,23210,6500,6500,0,NULL,12510,0,12510,2840,10700,10700,0
50224920,SP2022 ,13005,515,4810,2220,20550,6500,6500,0,2750,6500,0,9250,7020,14050,11300,0
50224920,SP2023 ,13500,550,5150,2325,21525,6500,6500,0,3250,11650,0,14900,2400,9875,6625,0
50224920,SP2024 ,14750,600,5410,2450,23210,6500,6500,0,NULL,12510,0,12510,2840,10700,10700,0
50209924,FA2021 ,12625,500,4270,1080,18475,8175,8175,0,3750,9975,0,13725,3150,8500,4750,0
50209924,FA2022 ,13005,515,3855,2220,19595,8175,0,8175,3750,10747,0,14497,2773,8848,5098,0
50209924,SP2021 ,12625,500,4270,1080,18475,8175,8175,0,3750,8475,0,12225,4650,10000,6250,0
50209924,SP2022 ,13005,515,3855,1140,18515,8175,0,8175,3750,10748,0,14498,2772,7767,4017,0
50213145,FA2021 ,12625,500,NULL,NULL,13125,0,0,0,3250,1500,0,4750,11625,11625,8375,0
50213145,FA2022 ,13005,515,NULL,NULL,13520,0,0,0,3750,0,0,3750,13520,13520,9770,0
50213145,FA2023 ,13500,550,NULL,NULL,14050,0,0,0,3750,0,0,3750,14050,14050,10300,0
50213145,SP2021 ,12625,500,NULL,NULL,13125,0,0,0,3250,0,0,3250,13125,13125,9875,0
50213145,SP2022 ,13005,515,NULL,NULL,13520,0,0,0,3750,0,0,3750,13520,13520,9770,0
50213145,SP2023 ,13500,550,NULL,NULL,14050,0,0,0,3750,0,0,3750,14050,14050,10300,0
50216541,FA2021 ,12625,500,4050,2110,19285,10925,8925,2000,3250,17917,0,21167,-4792,1368,-1882,0
50216541,FA2022 ,13005,515,4610,1140,19270,8925,0,8925,3750,14674,0,18424,-1154,4596,846,0
50216541,FA2023 ,13500,550,5440,NULL,19490,10925,0,10925,3750,14498,0,18248,-448,4992,1242,0
50216541,SP2021 ,12625,500,4050,2110,19285,8925,8925,0,3250,13918,0,17168,-793,5367,2117,0
50216541,SP2022 ,13005,515,4610,1140,19270,8925,0,8925,3750,14676,0,18426,-1156,4594,844,0
50216541,SP2023 ,13500,550,5440,NULL,19490,10925,0,10925,3750,14497,0,18247,-447,4993,1243,0
50226783,FA2022 ,13005,515,3855,2690,20065,7000,7000,0,3250,7000,0,10250,6520,13065,9815,0
50226783,FA2023 ,13500,550,5150,2325,21525,7500,7500,0,3750,7500,0,11250,6550,14025,10275,0
50226783,SP2022 ,13005,515,3855,2690,20065,7000,7000,0,3250,7000,0,10250,6520,13065,9815,0
50226783,SP2023 ,13500,550,4550,2325,20925,7500,7500,0,3750,7500,0,11250,6550,13425,9675,0
50228634,FA2023 ,13500,550,4560,2325,20935,7500,7500,0,2750,7500,0,10250,6550,13435,10685,0
50228634,FA2024 ,14750,600,4790,2450,22590,7500,7500,0,0,7500,0,7500,7850,15090,15090,0
50228634,SP2023 ,13500,550,4560,2325,20935,7500,7500,0,2750,7500,0,10250,6550,13435,10685,0
50231628,FA2024 ,14750,600,4200,2900,22450,8500,8500,0,2750,8800,0,11550,6550,13650,10900,5496.88
50231628,SP2024 ,14750,600,4200,2900,22450,8500,8500,0,2750,8800,0,11550,6550,13650,10900,5496.88
50176975,FA2021 ,5200,250,NULL,2550,8000,0,0,0,NULL,1500,0,1500,3950,6500,6500,0
50176975,FA2022 ,7170,257,NULL,2690,10117,750,0,750,NULL,750,0,750,6677,9367,9367,0
50176975,FA2023 ,3720,NULL,NULL,2535,6255,750,750,0,NULL,750,0,750,2970,5505,5505,0
50176975,FA2024 ,8140,300,NULL,2680,11120,750,0,750,NULL,750,0,750,7690,10370,10370,0
50176975,SP2021 ,6960,250,NULL,2550,9760,0,0,0,NULL,0,0,0,7210,9760,9760,0
50176975,SP2022 ,3580,NULL,NULL,2690,6270,750,0,750,NULL,750,0,750,2830,5520,5520,0
50176975,SP2023 ,3720,NULL,NULL,2535,6255,750,750,0,NULL,750,0,750,2970,5505,5505,0
50176975,SP2024 ,8140,300,NULL,2680,11120,750,0,750,NULL,750,0,750,7690,10370,10370,0
50203501,FA2021 ,12625,500,4830,1080,19035,8425,8425,0,3750,11795,0,15545,1330,7240,3490,0
50203501,SP2021 ,12625,500,4830,1080,19035,8425,8425,0,3750,10295,0,14045,2830,8740,4990,0
50233949,FA2024 ,14750,600,5410,2450,23210,10300,10300,0,19082,10300,0,29382,5050,12910,-6172,-2476.15
50233949,SP2024 ,14750,600,5410,2450,23210,10300,10300,0,14955,10300,0,25255,5050,12910,-2045,-2476.15
50233852,FA2024 ,14750,600,4200,2450,22000,7000,7000,0,2750,8500,0,11250,6850,13500,10750,-250
50233852,SP2024 ,14750,600,4200,2450,22000,7250,7250,0,12750,7250,0,20000,8100,14750,2000,-250
9376336,SP2021 ,3470,NULL,NULL,NULL,3470,0,0,0,NULL,3470,3470,3470,0,0,0,0
50225118,FA2022 ,13005,515,4810,2220,20550,9000,9000,0,2750,9000,0,11750,4520,11550,8800,0
50225118,SP2022 ,13005,515,4810,2220,20550,9000,9000,0,2750,9000,0,11750,4520,11550,8800,0
50221435,FA2021 ,12625,500,4580,2110,19815,8000,8000,0,2750,8000,0,10750,5125,11815,9065,100
50221435,FA2022 ,13005,515,4260,2220,20000,7000,7000,0,NULL,7000,0,7000,6520,13000,13000,100
50221435,FA2023 ,13500,550,4560,2325,20935,7000,7000,0,NULL,7000,0,7000,7050,13935,13935,100
50221435,FA2024 ,14750,600,5720,1270,22340,7000,7000,0,NULL,7000,0,7000,8350,15340,15340,100
50221435,SP2021 ,12625,500,4580,2110,19815,8000,8000,0,2750,8000,0,10750,5125,11815,9065,100
50221435,SP2022 ,13005,515,4260,2220,20000,7000,7000,0,NULL,7000,0,7000,6520,13000,13000,100
50221435,SP2023 ,13500,6825,6825,NULL,20325,7000,7000,0,NULL,7000,0,7000,13325,13325,13325,100
50221435,SP2024 ,14750,600,5720,NULL,21070,7000,7000,0,NULL,7000,0,7000,8350,14070,14070,100
50209572,FA2021 ,12625,500,4270,210,17605,1425,0,1425,3750,2425,0,6175,10700,15180,11430,0
50209572,FA2022 ,13005,515,4610,NULL,18130,1425,0,1425,3750,1425,0,5175,12095,16705,12955,0
50209572,SP2021 ,12625,500,4270,NULL,17395,1425,0,1425,3750,1425,0,5175,11700,15970,12220,0
50209572,SP2022 ,13005,515,4610,NULL,18130,1425,0,1425,3750,1425,0,5175,12095,16705,12955,0
50226879,FA2022 ,13005,515,4810,2220,20550,8000,7000,1000,2750,9260,0,12010,4260,11290,8540,0
50226879,FA2023 ,13500,550,4790,1200,20040,9785,5500,4285,3750,9785,0,13535,4265,10255,6505,0
50226879,FA2024 ,14750,600,5720,1270,22340,7000,5500,1500,NULL,7000,0,7000,8350,15340,15340,0
50226879,SP2022 ,13005,515,4810,2220,20550,7000,7000,0,2750,7000,0,9750,6520,13550,10800,0
50226879,SP2023 ,13500,550,4790,1200,20040,7000,5500,1500,0,8260,0,8260,5790,11780,11780,0
50204288,FA2021 ,12625,500,4270,1080,18475,6675,4850,1825,3750,10045,0,13795,3080,8430,4680,0
50204288,SP2021 ,12625,500,4270,1080,18475,6675,4850,1825,3750,8545,0,12295,4580,9930,6180,0
50231402,FA2024 ,14750,600,5410,2680,23440,7000,7000,0,19457,7000,0,26457,8350,16440,-3017,-122
50231402,SP2024 ,14750,600,5410,2680,23440,7000,7000,0,17369,7000,0,24369,8350,16440,-929,-122
50225153,FA2022 ,13005,515,4800,2220,20540,7900,7900,0,8474,7900,0,16374,5620,12640,4166,0
50225153,FA2023 ,13500,550,4000,2325,20375,7900,7900,0,8842,7900,0,16742,6150,12475,3633,0
50225153,SP2022 ,13005,515,4800,2220,20540,7900,7900,0,8474,7900,0,16374,5620,12640,4166,0
50225153,SP2023 ,13500,550,4000,2325,20375,7900,7900,0,4475,7900,0,12375,6150,12475,8000,0
50226625,FA2022 ,13005,515,4810,2220,20550,13000,9000,4000,NULL,13000,0,13000,520,7550,7550,11225
50226625,FA2023 ,13500,550,4550,2325,20925,12000,9000,3000,NULL,12000,0,12000,2050,8925,8925,11225
50226625,FA2024 ,14750,600,5720,1270,22340,8500,6500,2000,NULL,8500,0,8500,6850,13840,13840,11225
50226625,SP2022 ,13005,515,4810,2220,20550,9000,9000,0,NULL,9000,0,9000,4520,11550,11550,11225
50226625,SP2023 ,13500,550,4550,2325,20925,9000,9000,0,NULL,9000,0,9000,5050,11925,11925,11225
50226625,SP2024 ,14750,600,5720,1270,22340,9000,7000,2000,NULL,9000,0,9000,6350,13340,13340,11225
50211212,FA2021 ,19340,860,4600,2110,26050,14500,14500,0,3250,16000,0,19250,4200,10050,6800,0
50211212,FA2022 ,19910,890,4745,2220,26875,14500,14500,0,3750,14500,0,18250,6300,12375,8625,0
50211212,SP2021 ,19340,860,4600,2110,26050,14500,14500,0,3250,14500,0,17750,5700,11550,8300,0
50211212,SP2022 ,19910,890,4745,2220,26875,14500,14500,0,3750,14500,0,18250,6300,12375,8625,0
50207621,FA2021 ,6960,250,NULL,NULL,7210,1420,1420,0,NULL,3044,0,3044,4166,4166,4166,0
50207621,SP2021 ,3470,NULL,NULL,NULL,3470,0,0,0,NULL,1872,0,1872,1598,1598,1598,0
50222705,FA2021 ,12625,500,4580,2110,19815,6000,6000,0,NULL,6000,0,6000,7125,13815,13815,0
50222705,FA2022 ,13005,515,4810,2220,20550,5500,5500,0,NULL,5500,0,5500,8020,15050,15050,0
50222705,FA2023 ,13500,550,5250,2325,21625,5500,5500,0,NULL,5500,0,5500,8550,16125,16125,0
50222705,SP2021 ,12625,500,4580,2110,19815,6000,6000,0,NULL,6000,0,6000,7125,13815,13815,0
50222705,SP2022 ,13005,515,4810,2220,20550,5500,5500,0,NULL,5500,0,5500,8020,15050,15050,0
50222705,SP2023 ,13500,550,5150,2325,21525,5500,5500,0,NULL,5500,0,5500,8550,16025,16025,0
50223832,FA2021 ,12625,500,4580,2110,19815,7250,7250,0,2750,10923,0,13673,2202,8892,6142,51.42
50223832,FA2022 ,13005,515,3855,2220,19595,7650,7650,0,10298,9823,0,20121,3697,9772,-526,51.42
50223832,SP2021 ,12625,500,4580,2110,19815,7436,7436,0,2750,9608,0,12358,3517,10207,7457,51.42
50225745,FA2022 ,13005,515,3810,2220,19550,9000,9000,0,2750,9000,0,11750,4520,10550,7800,0
50225745,FA2023 ,13500,550,5150,2325,21525,9500,9500,0,0,12923,0,12923,1127,8602,8602,0
50225745,FA2024 ,14750,600,5410,2450,23210,9000,9000,0,0,12698,0,12698,2652,10512,10512,0
50225745,SP2022 ,13005,515,4810,2220,20550,9000,9000,0,2750,9000,0,11750,4520,11550,8800,0
50225745,SP2023 ,13500,550,5150,2325,21525,9500,9500,0,0,12922,0,12922,1128,8603,8603,0
50225745,SP2024 ,14750,600,5410,2450,23210,9000,9000,0,0,12697,0,12697,2653,10513,10513,0
50228553,FA2023 ,13500,550,4000,2325,20375,9700,9200,500,2750,15723,0,18473,-1673,4652,1902,0
50228553,FA2024 ,14750,600,4200,2450,22000,11200,8000,3200,0,20098,0,20098,-4748,1902,1902,0
50228553,SP2023 ,13500,550,4000,2325,20375,9200,9200,0,2750,12222,0,14972,1828,8153,5403,0
50228553,SP2024 ,14750,600,4200,2450,22000,11200,8000,3200,0,20097,0,20097,-4747,1903,1903,0
50202865,FA2021 ,12625,500,NULL,NULL,13125,3425,3425,0,14192,4925,0,19117,8200,8200,-5992,0
50202865,SP2021 ,12625,500,NULL,NULL,13125,3425,3425,0,10277,7925,0,18202,5200,5200,-5077,0
50209361,FA2021 ,12625,500,4050,2110,19285,4925,0,4925,3750,10475,0,14225,2650,8810,5060,0
50209361,FA2022 ,13005,515,5080,1140,19740,4925,0,4925,7750,4925,0,12675,8595,14815,7065,0
50209361,SP2021 ,12625,500,4050,2110,19285,4925,0,4925,3750,8975,0,12725,4150,10310,6560,0
50209361,SP2022 ,13005,515,5080,1140,19740,4925,0,4925,3750,4925,0,8675,8595,14815,11065,0
50119535,FA2021 ,12625,500,4580,2110,19815,5250,5250,0,2750,5250,0,8000,7875,14565,11815,5082
50119535,FA2022 ,13005,515,4810,2220,20550,4750,4750,0,2750,4750,0,7500,8770,15800,13050,5082
50119535,FA2023 ,13500,550,5440,1200,20690,4750,4750,0,3750,4750,0,8500,9300,15940,12190,5082
50119535,FA2024 ,14750,600,6090,1270,22710,4750,4750,0,3750,4750,0,8500,10600,17960,14210,5082
50119535,SP2021 ,12625,500,4580,2110,19815,5250,5250,0,2750,5250,0,8000,7875,14565,11815,5082
50119535,SP2022 ,13005,515,4810,2220,20550,4750,4750,0,2750,4750,0,7500,8770,15800,13050,5082
50119535,SP2023 ,13500,550,5440,1200,20690,4750,4750,0,3750,4750,0,8500,9300,15940,12190,5082
50119535,SP2024 ,14750,600,6090,1270,22710,4750,4750,0,3750,4750,0,8500,10600,17960,14210,5082
50231596,FA2024 ,14750,600,5410,2450,23210,7500,7500,0,15060,11000,0,26060,4350,12210,-2850,-1672
50231596,SP2024 ,14750,600,5410,2450,23210,7500,7500,0,16940,7500,0,24440,7850,15710,-1230,-1672
50224835,FA2022 ,13005,515,4810,2220,20550,7250,7250,0,NULL,7250,0,7250,6270,13300,13300,0
50224835,FA2023 ,13500,550,5150,2325,21525,7250,7250,0,NULL,7250,0,7250,6800,14275,14275,0
50224835,SP2022 ,13005,515,4810,2220,20550,7250,7250,0,NULL,7250,0,7250,6270,13300,13300,0
50224835,SP2023 ,13500,6825,6825,NULL,20325,7250,7250,0,NULL,7250,0,7250,13075,13075,13075,0
50232149,FA2024 ,14750,600,4200,2450,22000,11350,6500,4850,2750,13768,0,16518,1582,8232,5482,2651
50232149,SP2024 ,14750,600,4200,2450,22000,9350,6500,2850,2750,11767,0,14517,3583,10233,7483,2651
50226085,FA2022 ,13005,515,4810,2220,20550,9050,9050,0,12697,12550,0,25247,970,8000,-4697,1776.68
50226085,FA2023 ,13500,550,4560,2325,20935,8500,7500,1000,3250,10386,0,13636,3664,10549,7299,1776.68
50226085,FA2024 ,14750,600,5720,1270,22340,10000,3000,7000,12871,11886,0,24757,3464,10454,-2417,1776.68
50226085,SP2022 ,13005,515,4810,2220,20550,8500,8500,0,12698,8500,0,21198,5020,12050,-648,1776.68
50226085,SP2023 ,13500,550,4560,2325,20935,8500,7500,1000,13250,10386,0,23636,3664,10549,-2701,1776.68
50226085,SP2024 ,14750,600,5720,1270,22340,10000,3000,7000,3250,11886,0,15136,3464,10454,7204,1776.68
50229648,FA2023 ,13500,550,4000,2325,20375,8750,0,8750,13345,11573,0,24918,2477,8802,-4543,-450
50229648,FA2024 ,14750,600,4200,2450,22000,8750,0,8750,10938,12265,0,23203,3085,9735,-1203,-450
50229648,SP2023 ,13500,550,4000,2325,20375,8750,0,8750,10150,11572,0,21722,2478,8803,-1347,-450
50229648,SP2024 ,14750,600,4200,2450,22000,8750,0,8750,10396,12265,0,22661,3085,9735,-661,-450
50225119,FA2022 ,13005,515,4260,2690,20470,7250,7250,0,NULL,7250,0,7250,6270,13220,13220,-1395
50225119,FA2023 ,13500,550,4000,2535,20585,9000,7000,2000,NULL,9000,0,9000,5050,11585,11585,-1395
50225119,FA2024 ,14750,7250,7250,NULL,22000,9250,7000,2250,NULL,9250,0,9250,12750,12750,12750,-1395
50225119,SP2022 ,13005,515,4260,2690,20470,7000,7000,0,NULL,7000,0,7000,6520,13470,13470,-1395
50225119,SP2023 ,13500,550,4000,2535,20585,7000,7000,0,NULL,7000,0,7000,7050,13585,13585,-1395
50225119,SP2024 ,14750,600,5030,1270,21650,7000,7000,0,NULL,7000,0,7000,8350,14650,14650,-1395
50226843,FA2024 ,14750,600,4200,2450,22000,10300,9800,500,11680,13760,0,25440,1590,8240,-3440,0
50226843,SP2024 ,14750,600,4200,2450,22000,9800,9800,0,10420,13260,0,23680,2090,8740,-1680,0
50229073,FA2023 ,13500,550,4000,2325,20375,7000,7000,0,14960,7000,0,21960,7050,13375,-1585,0
50229073,FA2024 ,14750,600,4200,2450,22000,7000,7000,0,15169,7000,0,22169,8350,15000,-169,0
50229073,SP2023 ,13500,550,4000,2325,20375,7000,7000,0,13814,7000,0,20814,7050,13375,-439,0
50229073,SP2024 ,14750,600,4200,2450,22000,7000,7000,0,11050,7000,0,18050,8350,15000,3950,0
50224764,FA2022 ,13005,515,3855,2220,19595,4000,4000,0,36566,7448,0,44014,6072,12147,-24419,125
50224764,FA2023 ,13500,550,4052,2325,20427,4000,4000,0,9250,8098,0,17348,5952,12329,3079,125
50224764,FA2024 ,14750,600,4200,2450,22000,4000,4000,0,16617,8098,0,24715,7252,13902,-2715,125
50224764,SP2021 ,12625,500,3740,2110,18975,4500,4500,0,NULL,4500,0,4500,8625,14475,14475,125
50224764,SP2022 ,13005,515,3855,2220,19595,4000,4000,0,5171,7447,0,12618,6073,12148,6977,125
50224764,SP2023 ,13500,550,4000,2325,20375,4000,4000,0,12050,8097,0,20147,5953,12278,228,125
50224764,SP2024 ,14750,600,4200,2450,22000,4000,4000,0,14502,8097,0,22599,7253,13903,-599,125
50231769,SP2023 ,13500,550,4000,2325,20375,5000,5000,0,0,8698,0,8698,5352,11677,11677,1422
50205582,FA2021 ,14250,500,4270,NULL,19020,7175,400,6775,3750,8675,0,12425,6075,10345,6595,0
50224952,FA2022 ,13005,515,NULL,NULL,13520,7348,7348,0,2750,7721,0,10471,5799,5799,3049,0
50224952,FA2023 ,13500,550,NULL,NULL,14050,5788,3088,2700,3250,7038,0,10288,7012,7012,3762,0
50224952,FA2024 ,14750,600,NULL,NULL,15350,7038,2338,4700,3750,10986,0,14736,4364,4364,614,0
50224952,SP2022 ,13005,515,NULL,NULL,13520,7348,7348,0,2750,7720,0,10470,5800,5800,3050,0
50224952,SP2023 ,13500,550,NULL,NULL,14050,5788,3088,2700,3250,7038,0,10288,7012,7012,3762,0
50224952,SP2024 ,14750,600,NULL,NULL,15350,7038,2338,4700,3750,10985,0,14735,4365,4365,615,0
50228675,FA2023 ,13500,550,5150,2325,21525,9500,500,9000,2750,9500,0,12250,4550,12025,9275,669.65
50228675,FA2024 ,14750,600,5410,2450,23210,9500,500,9000,3250,14910,0,18160,440,8300,5050,669.65
50228675,SP2023 ,13500,550,5150,2325,21525,9500,500,9000,2750,9500,0,12250,4550,12025,9275,669.65
50228675,SP2024 ,14750,600,5410,2450,23210,9500,500,9000,3250,14910,0,18160,440,8300,5050,669.65
50234713,FA2024 ,14750,600,4790,2450,22590,10000,10000,0,NULL,16000,0,16000,-650,6590,6590,4480
50234713,SP2024 ,14750,600,4790,2450,22590,10000,10000,0,NULL,16000,0,16000,-650,6590,6590,4480
50221592,FA2024 ,14750,600,4790,1270,21410,0,0,0,3750,17205,14750,20955,-1855,4205,455,120
50221592,SP2024 ,14750,600,4790,1270,21410,0,0,0,3750,17205,14750,20955,-1855,4205,455,120
50232296,FA2024 ,14750,600,5410,2680,23440,10000,8500,1500,2750,14498,0,17248,852,8942,6192,0
50232296,SP2024 ,14750,600,5410,2450,23210,10000,8500,1500,2750,14497,0,17247,853,8713,5963,0
50225282,FA2022 ,13005,515,3855,2220,19595,9200,9200,0,2750,11423,0,14173,2097,8172,5422,0
50225282,FA2023 ,13500,550,4000,2325,20375,9200,9200,0,2250,16423,0,18673,-2373,3952,1702,0
50225282,FA2024 ,14750,600,4200,2450,22000,9200,8500,700,3750,14000,0,17750,1350,8000,4250,0
50225282,SP2022 ,13005,515,3855,2220,19595,9200,9200,0,2750,11422,0,14172,2098,8173,5423,0
50225282,SP2023 ,13500,550,4000,2325,20375,9200,9200,0,2250,16422,0,18672,-2372,3953,1703,0
50225282,SP2024 ,14750,600,4200,2450,22000,9200,8500,700,3750,14000,0,17750,1350,8000,4250,0
50228383,SP2022 ,14269,7231,7231,NULL,21500,0,0,0,NULL,0,0,0,21500,21500,21500,0
50204216,FA2021 ,12625,500,NULL,NULL,13125,925,0,925,0,2925,0,2925,10200,10200,10200,0
50213156,FA2021 ,12625,500,3740,2110,18975,8790,8075,715,3750,14290,0,18040,-1165,4685,935,0
50213156,SP2021 ,12625,500,3740,2110,18975,8075,8075,0,3750,8075,0,11825,5050,10900,7150,0
50212603,FA2021 ,19340,860,860,NULL,20200,9965,7500,2465,6250,13988,0,20238,6212,6212,-38,220
50212603,SP2021 ,19340,860,860,NULL,20200,9250,7500,1750,6250,11272,0,17522,8928,8928,2678,220
50214052,FA2021 ,12625,500,3740,1080,17945,3925,3925,0,NULL,4425,0,4425,8700,13520,13520,0
50214052,FA2022 ,13005,515,4810,2220,20550,3425,3425,0,6250,7773,0,14023,5747,12777,6527,0
50214052,SP2021 ,12625,500,3740,1080,17945,3925,3925,0,NULL,3925,0,3925,9200,14020,14020,0
50214052,SP2022 ,13005,515,4810,2220,20550,3425,3425,0,6250,7772,0,14022,5748,12778,6528,0
50210942,FA2021 ,12625,500,4270,NULL,17395,1000,0,1000,16250,2500,0,18750,10625,14895,-1355,0
50210942,FA2022 ,13005,515,4610,NULL,18130,600,0,600,17750,600,0,18350,12920,17530,-220,0
50210942,SP2021 ,12625,500,4270,NULL,17395,0,0,0,17630,0,0,17630,13125,17395,-235,0
50118815,FA2021 ,12625,500,4580,2110,19815,3925,3925,0,16750,10997,0,27747,2128,8818,-7932,0
50118815,FA2022 ,13005,515,4810,2220,20550,3789,3789,0,12250,7748,0,19998,5772,12802,552,0
50118815,FA2023 ,3720,NULL,NULL,NULL,3720,0,0,0,8830,0,0,8830,3720,3720,-5110,0
50118815,SP2021 ,12625,500,4580,2110,19815,3925,3925,0,15050,8998,0,24048,4127,10817,-4233,0
50118815,SP2022 ,13005,515,4810,2220,20550,3790,3790,0,12250,7747,0,19997,5773,12803,553,0
50228393,FA2023 ,13500,550,4000,2535,20585,7500,6500,1000,2750,7500,0,10250,6550,13085,10335,0
50228393,FA2024 ,14750,600,5410,2450,23210,7500,0,7500,3250,7500,0,10750,7850,15710,12460,0
50228393,SP2023 ,13500,550,4000,2325,20375,7500,6500,1000,2750,7500,0,10250,6550,12875,10125,0
50228393,SP2024 ,14750,600,5410,2450,23210,7500,0,7500,3250,7500,0,10750,7850,15710,12460,0
50226780,FA2023 ,13500,550,4000,2325,20375,9500,0,9500,NULL,9500,0,9500,4550,10875,10875,0
50226780,FA2024 ,14750,600,4200,2450,22000,9500,0,9500,NULL,9500,0,9500,5850,12500,12500,0
50226780,SP2023 ,13500,550,4000,2325,20375,9500,0,9500,NULL,9500,0,9500,4550,10875,10875,0
50226780,SP2024 ,14750,600,4200,2450,22000,9500,0,9500,NULL,9500,0,9500,5850,12500,12500,0
50228127,FA2023 ,13500,550,4000,2325,20375,7000,7000,0,NULL,7000,0,7000,7050,13375,13375,0
50228127,FA2024 ,14750,600,5410,2450,23210,7000,7000,0,NULL,7000,0,7000,8350,16210,16210,0
50228127,SP2023 ,13500,550,4000,2325,20375,7000,7000,0,NULL,7000,0,7000,7050,13375,13375,0
50228127,SP2024 ,14750,600,5410,2450,23210,7000,7000,0,NULL,7000,0,7000,8350,16210,16210,0
50121008,FA2021 ,12625,500,3740,2550,19415,5500,5500,0,0,5500,0,5500,7625,13915,13915,0
50121008,FA2022 ,13005,515,3855,2220,19595,5000,5000,0,3250,5000,0,8250,8520,14595,11345,0
50121008,SP2021 ,12625,500,3740,2550,19415,5500,5500,0,0,5500,0,5500,7625,13915,13915,0
50121008,SP2022 ,7170,515,3855,2220,13760,2757,2757,0,3250,2757,0,6007,4928,11003,7753,0
50222183,FA2021 ,12625,500,4580,2550,20255,5500,5500,0,0,5500,0,5500,7625,14755,14755,0
50222183,FA2022 ,13005,515,4260,2220,20000,5000,5000,0,3250,5000,0,8250,8520,15000,11750,0
50222183,FA2023 ,13500,550,NULL,NULL,14050,3450,3450,0,3750,3450,0,7200,10600,10600,6850,0
50222183,FA2024 ,14750,600,NULL,NULL,15350,3450,3450,0,3750,3450,0,7200,11900,11900,8150,0
50222183,SP2021 ,12625,500,4580,2550,20255,5500,5500,0,0,5500,0,5500,7625,14755,14755,0
50222183,SP2022 ,13005,515,4260,2220,20000,5000,5000,0,3250,5000,0,8250,8520,15000,11750,0
50222183,SP2023 ,13500,550,NULL,NULL,14050,3450,3450,0,3750,3450,0,7200,10600,10600,6850,0
50222183,SP2024 ,14750,600,NULL,NULL,15350,3450,3450,0,3750,3450,0,7200,11900,11900,8150,0
50209437,FA2021 ,12625,500,4830,NULL,17955,925,925,0,NULL,925,0,925,12200,17030,17030,0
50209437,SP2021 ,12625,500,4830,NULL,17955,925,925,0,NULL,925,0,925,12200,17030,17030,0
50228527,FA2023 ,13500,550,4560,2325,20935,11000,9000,2000,2750,11000,0,13750,3050,9935,7185,0
50228527,FA2024 ,14750,600,4200,2450,22000,11500,9500,2000,NULL,15700,0,15700,-350,6300,6300,0
50228527,SP2023 ,13500,550,4560,2325,20935,9000,9000,0,0,9000,0,9000,5050,11935,11935,0
50228527,SP2024 ,14750,600,4200,2450,22000,9500,9500,0,NULL,13700,0,13700,1650,8300,8300,0
50120136,FA2023 ,13500,550,5150,2325,21525,7500,7500,0,2750,7500,0,10250,6550,14025,11275,0
50120136,FA2024 ,14750,600,5410,2450,23210,7500,7500,0,3750,7500,0,11250,7850,15710,11960,0
50120136,SP2023 ,13500,550,5150,2325,21525,7500,7500,0,2750,7500,0,10250,6550,14025,11275,0
50120136,SP2024 ,14750,600,5410,2450,23210,7500,7500,0,3750,7500,0,11250,7850,15710,11960,0
50230337,FA2024 ,14750,600,5410,2450,23210,9250,9250,0,15984,9250,0,25234,6100,13960,-2024,-3123
50230337,SP2024 ,14750,600,4200,NULL,19550,9000,9000,0,14324,9000,0,23324,6350,10550,-3774,-3123
50203248,FA2021 ,12625,500,5160,NULL,18285,5175,0,5175,12750,8098,0,20848,5027,10187,-2563,0
50203248,SP2021 ,5200,500,5160,NULL,10860,0,0,0,9000,0,0,9000,5700,10860,1860,0
50222731,FA2021 ,12625,500,3740,2110,18975,7100,7100,0,2750,12173,0,14923,952,6802,4052,3816
50222731,FA2022 ,13005,515,3855,2220,19595,7000,7000,0,3250,10423,0,13673,3097,9172,5922,3816
50222731,FA2023 ,13500,550,4000,1200,19250,7500,7500,0,0,10523,0,10523,3527,8727,8727,3816
50222731,FA2024 ,14750,600,5030,1270,21650,7000,5500,1500,3750,9795,0,13545,5555,11855,8105,3816
50222731,SP2021 ,12625,500,3740,2110,18975,7100,7100,0,2750,10672,0,13422,2453,8303,5553,3816
50222731,SP2022 ,13005,515,3855,2220,19595,7000,7000,0,3250,10422,0,13672,3098,9173,5923,3816
50222731,SP2023 ,13500,550,4000,1200,19250,7000,7000,0,0,10022,0,10022,4028,9228,9228,3816
50222731,SP2024 ,14750,600,5030,1270,21650,7000,5500,1500,3750,9795,0,13545,5555,11855,8105,3816
50232298,FA2024 ,14750,600,5410,2680,23440,7000,7000,0,1750,24975,0,26725,-9625,-1535,-3285,0
50232298,SP2024 ,14750,600,5410,2450,23210,11000,11000,0,1750,14475,0,16225,875,8735,6985,0
50225174,FA2022 ,13005,515,4810,2220,20550,9650,9650,0,16842,9650,0,26492,3870,10900,-5942,0
50225174,FA2023 ,13500,550,4560,2325,20935,11150,6750,4400,9250,11150,0,20400,2900,9785,535,0
50225174,FA2024 ,14750,600,5030,1270,21650,12150,750,11400,5250,16038,0,21288,-688,5612,362,0
50225174,SP2022 ,13005,515,4810,2220,20550,9650,9650,0,12521,9650,0,22171,3870,10900,-1621,0
50225174,SP2023 ,13500,550,4560,2325,20935,11150,6750,4400,9250,11150,0,20400,2900,9785,535,0
50225174,SP2024 ,14750,600,5030,1270,21650,12150,750,11400,6172,16038,0,22210,-688,5612,-560,0
50233360,FA2024 ,14750,600,4200,2450,22000,6000,6000,0,NULL,6000,0,6000,9350,16000,16000,0
50206678,FA2021 ,12625,500,4270,NULL,17395,3425,3425,0,NULL,3925,0,3925,9200,13470,13470,0
50214085,FA2021 ,12625,500,3740,2110,18975,3225,3225,0,NULL,3225,0,3225,9900,15750,15750,0
50214085,FA2022 ,13005,515,4260,2220,20000,3325,3325,0,NULL,3325,0,3325,10195,16675,16675,0
50214085,FA2023 ,13500,550,4000,2325,20375,2925,2925,0,NULL,2925,0,2925,11125,17450,17450,0
50214085,SP2021 ,12625,500,3740,2110,18975,3275,3275,0,NULL,3275,0,3275,9850,15700,15700,0
50214085,SP2022 ,13005,515,4260,2220,20000,2925,2925,0,NULL,2925,0,2925,10595,17075,17075,0
50214085,SP2023 ,13500,550,4000,2325,20375,2925,2925,0,NULL,2925,0,2925,11125,17450,17450,0
50228677,FA2023 ,13500,550,4000,2325,20375,6500,6500,0,2750,6500,0,9250,7550,13875,11125,0
50228677,FA2024 ,14750,600,4200,2450,22000,6500,6500,0,NULL,6500,0,6500,8850,15500,15500,0
50228677,SP2023 ,13500,550,4000,2325,20375,6500,6500,0,2750,6500,0,9250,7550,13875,11125,0
50204446,FA2021 ,12625,500,4830,1080,19035,5425,4825,600,0,7425,0,7425,5700,11610,11610,0
50204446,SP2021 ,12625,500,4830,NULL,17955,5425,4825,600,3750,5925,0,9675,7200,12030,8280,0
50232471,FA2024 ,14750,600,4200,2450,22000,10150,10150,0,2750,13238,0,15988,2112,8762,6012,2061
50232471,SP2024 ,14750,600,4200,2450,22000,10150,10150,0,2750,13237,0,15987,2113,8763,6013,2061
50204033,FA2021 ,12625,500,5160,1080,19365,0,0,0,3750,13625,12625,17375,-500,5740,1990,0
50204033,SP2021 ,12625,500,5160,1080,19365,0,0,0,3750,12625,12625,16375,500,6740,2990,0
50204816,FA2021 ,12625,500,4830,1080,19035,0,0,0,3750,14125,12625,17875,-1000,4910,1160,0
50204816,SP2021 ,12625,500,4830,1080,19035,0,0,0,3750,12625,12625,16375,500,6410,2660,0
50230711,FA2023 ,13500,550,4000,2325,20375,7000,5750,1250,3750,7000,0,10750,7050,13375,9625,0
50230711,FA2024 ,14750,600,4200,2450,22000,7000,7000,0,3750,7000,0,10750,8350,15000,11250,0
50230711,SP2023 ,13500,550,4000,2325,20375,7000,5750,1250,3750,7000,0,10750,7050,13375,9625,0
50221398,FA2022 ,13005,515,3999,2220,19739,9300,9300,0,1750,12748,0,14498,772,6991,5241,0
50225591,FA2022 ,13005,515,3855,2220,19595,10000,10000,0,NULL,10000,0,10000,3520,9595,9595,-3049.26
50225591,FA2023 ,13500,550,4000,2325,20375,10000,10000,0,NULL,14000,0,14000,50,6375,6375,-3049.26
50225591,FA2024 ,14750,7250,7250,NULL,22000,10000,10000,0,NULL,10000,0,10000,12000,12000,12000,-3049.26
50225591,SP2022 ,13005,515,3855,2220,19595,10000,10000,0,NULL,10000,0,10000,3520,9595,9595,-3049.26
50225591,SP2023 ,13500,550,4000,2325,20375,10000,10000,0,NULL,14000,0,14000,50,6375,6375,-3049.26
50225591,SP2024 ,14750,600,5720,NULL,21070,10000,10000,0,NULL,10000,0,10000,5350,11070,11070,-3049.26
50221522,FA2021 ,12625,500,4050,2110,19285,6000,6000,0,NULL,7000,0,7000,6125,12285,12285,0
50221522,FA2022 ,13005,515,4260,2220,20000,5500,5500,0,NULL,5500,0,5500,8020,14500,14500,0
50221522,FA2023 ,13500,550,4560,1200,19810,5500,5500,0,NULL,5500,0,5500,8550,14310,14310,0
50221522,FA2024 ,14750,600,5720,NULL,21070,5500,5500,0,NULL,5500,0,5500,9850,15570,15570,0
50221522,SP2021 ,12625,500,4050,2110,19285,6000,6000,0,NULL,6000,0,6000,7125,13285,13285,0
50221522,SP2022 ,13005,515,4260,2220,20000,5500,5500,0,NULL,5500,0,5500,8020,14500,14500,0
50221522,SP2023 ,13500,550,4560,1200,19810,5500,5500,0,NULL,5500,0,5500,8550,14310,14310,0
50221522,SP2024 ,14750,600,5720,NULL,21070,5500,5500,0,NULL,5500,0,5500,9850,15570,15570,0
50223103,FA2021 ,12625,500,3740,2110,18975,9750,7750,2000,NULL,10750,0,10750,2375,8225,8225,0
50223103,FA2022 ,13005,515,3855,2220,19595,7250,7250,0,NULL,7250,0,7250,6270,12345,12345,0
50223103,FA2023 ,13500,550,4560,2325,20935,7250,6500,750,NULL,7250,0,7250,6800,13685,13685,0
50223103,FA2024 ,14750,600,4790,2450,22590,7250,6500,750,NULL,7250,0,7250,8100,15340,15340,0
50223103,SP2021 ,12625,500,3740,2110,18975,7750,7750,0,NULL,7750,0,7750,5375,11225,11225,0
50223103,SP2022 ,13005,515,3855,2220,19595,7250,7250,0,NULL,7250,0,7250,6270,12345,12345,0
50223103,SP2023 ,13500,550,4560,2325,20935,7250,6500,750,NULL,7250,0,7250,6800,13685,13685,0
50223103,SP2024 ,14750,600,4790,2450,22590,7250,6500,750,NULL,7250,0,7250,8100,15340,15340,0
50230454,FA2023 ,13500,550,4000,2325,20375,9000,9000,0,NULL,9000,0,9000,5050,11375,11375,-135
50230454,FA2024 ,14750,600,4200,2450,22000,9000,7500,1500,NULL,9000,0,9000,6350,13000,13000,-135
50230454,SP2023 ,13500,550,4000,2325,20375,9000,9000,0,NULL,9000,0,9000,5050,11375,11375,-135
50230454,SP2024 ,14750,600,4200,2450,22000,9000,7500,1500,NULL,9000,0,9000,6350,13000,13000,-135
50225828,FA2022 ,13005,515,4810,2220,20550,0,0,0,0,13005,13005,13005,515,7545,7545,0
50225828,FA2023 ,13500,550,4000,2325,20375,0,0,0,2750,13500,13500,16250,550,6875,4125,0
50225828,SP2023 ,13500,550,4000,2325,20375,0,0,0,2750,13500,13500,16250,550,6875,4125,0
50226839,FA2023 ,13500,550,5150,2325,21525,9000,9000,0,2750,9000,0,11750,5050,12525,9775,0
50226839,FA2024 ,14750,600,5410,2450,23210,9000,9000,0,3250,11500,0,14750,3850,11710,8460,0
50226839,SP2023 ,13500,550,5150,2325,21525,9000,9000,0,2750,9000,0,11750,5050,12525,9775,0
50226839,SP2024 ,5900,240,5410,980,12530,4600,4600,0,0,4600,0,4600,1540,7930,7930,0
50217966,FA2021 ,12625,500,3740,2110,18975,9525,9525,0,3250,12898,0,16148,227,6077,2827,0
50217966,FA2022 ,13005,515,4610,NULL,18130,9525,9525,0,3250,12048,0,15298,1472,6082,2832,0
50217966,FA2023 ,13500,550,4790,1200,20040,9525,7600,1925,3750,13198,0,16948,852,6842,3092,0
50217966,SP2021 ,12625,500,3740,2110,18975,9525,9525,0,3250,10897,0,14147,2228,8078,4828,0
50217966,SP2022 ,13005,515,4610,NULL,18130,9525,9525,0,3250,12047,0,15297,1473,6083,2833,0
50217966,SP2023 ,13500,550,4790,1200,20040,9525,7600,1925,3750,13197,0,16947,853,6843,3093,0
50226282,FA2022 ,13005,515,4260,2220,20000,8800,8800,0,2750,11173,0,13923,2347,8827,6077,0
50226282,FA2023 ,13500,550,4560,2325,20935,7800,7800,0,3250,12772,0,16022,1278,8163,4913,0
50226282,FA2024 ,14750,600,5030,1270,21650,8800,6000,2800,3750,12898,0,16648,2452,8752,5002,0
50226282,SP2022 ,13005,515,4260,2220,20000,8800,8800,0,2750,11172,0,13922,2348,8828,6078,0
50226282,SP2023 ,13500,550,4560,2325,20935,7800,7800,0,3250,12773,0,16023,1277,8162,4912,0
50226282,SP2024 ,14750,600,5030,1270,21650,8800,6000,2800,3750,12898,0,16648,2452,8752,5002,0
50234102,FA2024 ,14750,600,4790,2450,22590,8800,7000,1800,2750,12498,0,15248,2852,10092,7342,0
50234102,SP2024 ,14750,600,4790,2450,22590,8800,7000,1800,2750,12497,0,15247,2853,10093,7343,0
50221680,FA2021 ,19340,860,5440,2110,26890,12400,9000,3400,3250,16450,0,19700,3750,10440,7190,0
50216912,FA2021 ,12625,500,4050,2110,19285,9675,9675,0,3250,13698,0,16948,-573,5587,2337,0
50216912,FA2022 ,13005,515,3855,2220,19595,9675,9675,0,3750,13522,0,17272,-2,6073,2323,0
50216912,FA2023 ,13500,550,4790,2325,21165,9675,9675,0,3750,13773,0,17523,277,7392,3642,0
50216912,SP2021 ,12625,500,4050,2110,19285,9675,9675,0,3250,11697,0,14947,1428,7588,4338,0
50216912,SP2022 ,13005,515,3855,2220,19595,9675,9675,0,3750,13523,0,17273,-3,6072,2322,0
50216912,SP2023 ,13500,550,4790,1200,20040,9675,9675,0,3750,13772,0,17522,278,6268,2518,0
50216073,FA2022 ,13005,515,4260,2220,20000,0,0,0,NULL,13005,13005,13005,515,6995,6995,0
50216073,FA2023 ,13500,550,5800,1200,21050,0,0,0,NULL,13500,13500,13500,550,7550,7550,0
50216073,SP2021 ,12625,500,4050,2110,19285,0,0,0,NULL,12625,12625,12625,500,6660,6660,0
50216073,SP2022 ,13005,515,4260,2220,20000,0,0,0,NULL,13005,13005,13005,515,6995,6995,0
50216073,SP2023 ,13500,550,5800,1200,21050,0,0,0,NULL,13500,13500,13500,550,7550,7550,0
50225062,FA2022 ,13005,515,3855,2220,19595,6750,6750,0,2750,7300,0,10050,6220,12295,9545,921
50225062,FA2023 ,13500,550,4550,2325,20925,6750,6750,0,NULL,6750,0,6750,7300,14175,14175,921
50225062,FA2024 ,14750,7250,7250,NULL,22000,6750,6750,0,NULL,6750,0,6750,15250,15250,15250,921
50225062,SP2022 ,13005,515,3855,2220,19595,6750,6750,0,2750,6750,0,9500,6770,12845,10095,921
50225062,SP2023 ,13500,550,4550,2325,20925,6750,6750,0,NULL,6750,0,6750,7300,14175,14175,921
50225062,SP2024 ,14750,600,5720,1270,22340,6750,6750,0,NULL,6750,0,6750,8600,15590,15590,921
50232746,FA2024 ,14750,600,5410,2450,23210,8850,8850,0,2750,8850,0,11600,6500,14360,11610,0
50232746,SP2024 ,14750,600,5410,2450,23210,8850,8850,0,2750,8850,0,11600,6500,14360,11610,0
50225534,FA2022 ,13005,515,4260,2220,20000,7000,7000,0,2750,7000,0,9750,6520,13000,10250,0
50225534,FA2023 ,13500,550,4560,2325,20935,8000,7000,1000,3250,8000,0,11250,6050,12935,9685,0
50225534,FA2024 ,14750,600,5410,2450,23210,9500,6500,3000,3750,11588,0,15338,3762,11622,7872,0
50225534,SP2022 ,13005,515,4260,2220,20000,7000,7000,0,2750,7000,0,9750,6520,13000,10250,0
50225534,SP2023 ,13500,550,4560,2325,20935,8000,7000,1000,3250,8000,0,11250,6050,12935,9685,0
50225534,SP2024 ,14750,7250,7250,NULL,22000,4500,4500,0,3750,6387,0,10137,15613,15613,11863,0
50214390,FA2021 ,12625,500,4050,2110,19285,11075,0,11075,0,13898,0,13898,-773,5387,5387,0
50214390,FA2022 ,13005,515,4610,NULL,18130,15075,0,15075,0,21048,0,21048,-7528,-2918,-2918,0
50214390,FA2023 ,13500,550,4000,1200,19250,11675,600,11075,0,19497,0,19497,-5447,-247,-247,0
50214390,SP2021 ,12625,500,4050,2110,19285,14075,0,14075,0,14897,0,14897,-1772,4388,4388,0
50214390,SP2022 ,13005,515,4610,NULL,18130,12075,0,12075,0,18047,0,18047,-4527,83,83,0
50214390,SP2023 ,13500,550,4000,1200,19250,11425,350,11075,2750,14248,0,16998,-198,5002,2252,0
50204779,FA2021 ,12625,500,4270,1080,18475,4175,0,4175,3750,13059,0,16809,66,5416,1666,0
50204779,SP2021 ,12625,500,4270,1080,18475,4175,0,4175,3750,8847,0,12597,4278,9628,5878,0
50217785,FA2021 ,12625,500,4050,2110,19285,2425,2425,0,NULL,2425,0,2425,10700,16860,16860,1040
50217785,FA2022 ,13005,515,4260,2220,20000,2520,2520,0,NULL,2520,0,2520,11000,17480,17480,1040
50217785,FA2023 ,13500,550,4560,2325,20935,2425,2425,0,3750,2425,0,6175,11625,18510,14760,1040
50217785,SP2021 ,12625,500,4050,2110,19285,2425,2425,0,NULL,2425,0,2425,10700,16860,16860,1040
50217785,SP2022 ,13005,515,4260,2220,20000,2425,2425,0,NULL,2425,0,2425,11095,17575,17575,1040
50228905,FA2023 ,13500,550,4000,2535,20585,8500,500,8000,2750,13573,0,16323,477,7012,4262,0
50228905,FA2024 ,14750,600,5410,2450,23210,10500,7500,3000,2250,21108,0,23358,-5758,2102,-148,0
50228905,SP2023 ,13500,550,4000,2325,20375,8500,500,8000,2750,13572,0,16322,478,6803,4053,0
50228905,SP2024 ,14750,600,5410,2450,23210,8500,7500,1000,2250,19107,0,21357,-3757,4103,1853,0
50231351,FA2024 ,14750,600,4200,2900,22450,7500,7500,0,NULL,7500,0,7500,7850,14950,14950,-250
50231351,SP2024 ,14750,600,4200,2900,22450,7750,7750,0,NULL,7750,0,7750,7600,14700,14700,-250
50215258,FA2021 ,12625,500,4050,2110,19285,4725,4725,0,0,13725,0,13725,-600,5560,5560,0
50215258,FA2022 ,13005,515,5080,1140,19740,5725,4725,1000,3750,5725,0,9475,7795,14015,10265,0
50215258,FA2023 ,13500,550,5440,2325,21815,4725,4725,0,3750,12225,0,15975,1825,9590,5840,0
50215258,SP2021 ,12625,500,4050,2110,19285,4725,4725,0,0,12225,0,12225,900,7060,7060,0
50215258,SP2022 ,13005,515,5080,2220,20820,5725,4725,1000,3750,13225,0,16975,295,7595,3845,0
50215258,SP2023 ,13500,550,5440,1200,20690,4725,4725,0,3750,4725,0,8475,9325,15965,12215,0
50209301,FA2021 ,12625,6350,6350,NULL,18975,4175,2675,1500,0,10523,0,10523,8452,8452,8452,0
50209301,FA2022 ,13005,515,4610,2220,20350,7425,2675,4750,NULL,7425,0,7425,6095,12925,12925,0
50209301,SP2021 ,12625,500,3740,2110,18975,4175,2675,1500,0,9982,0,9982,3143,8993,8993,0
50209301,SP2022 ,13005,515,4610,2220,20350,7425,2675,4750,NULL,7425,0,7425,6095,12925,12925,0
50216286,FA2021 ,12625,500,3740,2110,18975,11225,0,11225,3250,16873,0,20123,-3748,2102,-1148,0
50216286,FA2022 ,13005,515,3855,2220,19595,11225,0,11225,0,14698,0,14698,-1178,4897,4897,0
50216286,FA2023 ,13500,550,4000,2325,20375,12225,0,12225,3750,16147,0,19897,-2097,4228,478,0
50216286,SP2021 ,12625,500,3740,2110,18975,11225,0,11225,3250,15932,0,19182,-2807,3043,-207,0
50216286,SP2022 ,13005,515,3855,2220,19595,11225,0,11225,0,14697,0,14697,-1177,4898,4898,0
50216286,SP2023 ,13500,550,4000,2325,20375,12225,0,12225,3750,16148,0,19898,-2098,4227,477,0
50230327,FA2023 ,13500,550,4000,2325,20375,5000,5000,0,0,9948,0,9948,4102,10427,10427,100
50230327,FA2024 ,14750,600,4200,2450,22000,5000,5000,0,0,11448,0,11448,3902,10552,10552,100
50230327,SP2024 ,14750,600,4200,2450,22000,5000,5000,0,0,11447,0,11447,3903,10553,10553,100
50222706,FA2021 ,12625,500,3740,2110,18975,2000,0,2000,2750,15625,12625,18375,-2500,3350,600,235
50222706,FA2022 ,13005,515,3855,2220,19595,2000,0,2000,NULL,18860,13005,18860,-5340,735,735,235
50222706,FA2023 ,13500,550,5150,2325,21525,2000,0,2000,NULL,20650,13500,20650,-6600,875,875,235
50222706,FA2024 ,14750,600,5030,1270,21650,2000,0,2000,NULL,19450,14750,19450,-4100,2200,2200,235
50222706,SP2021 ,12625,500,3740,2110,18975,0,0,0,2750,12625,12625,15375,500,6350,3600,235
50222706,SP2022 ,13005,515,3855,2220,19595,0,0,0,NULL,16860,13005,16860,-3340,2735,2735,235
50222706,SP2023 ,13500,550,5150,2325,21525,0,0,0,NULL,18650,13500,18650,-4600,2875,2875,235
50222706,SP2024 ,14750,600,5030,1270,21650,0,0,0,NULL,17450,14750,17450,-2100,4200,4200,235
50225350,FA2022 ,13005,515,4800,2220,20540,8300,8300,0,2750,9675,0,12425,3845,10865,8115,0
50225350,FA2023 ,13500,550,4550,2325,20925,8300,8300,0,2250,9175,0,11425,4875,11750,9500,0
50225350,FA2024 ,14750,600,4780,2450,22580,8300,5500,2800,3750,11518,0,15268,3832,11062,7312,0
50225350,SP2022 ,13005,515,4380,2220,20120,8300,8300,0,2750,9675,0,12425,3845,10445,7695,0
50225350,SP2023 ,13500,550,4550,2325,20925,8300,8300,0,2250,9175,0,11425,4875,11750,9500,0
50225350,SP2024 ,14750,600,4780,2450,22580,8300,5500,2800,1000,11517,0,12517,3833,11063,10063,0
50224933,SP2021 ,13866,6974,6974,NULL,20840,0,0,0,NULL,0,0,0,20840,20840,20840,0
50225211,FA2022 ,13005,515,4810,2220,20550,6750,6750,0,2750,6750,0,9500,6770,13800,11050,3000
50225211,FA2023 ,13500,550,4560,2325,20935,6750,6750,0,3250,6750,0,10000,7300,14185,10935,3000
50225211,FA2024 ,14750,600,5720,38.03,21108.03,6750,6750,0,3750,6750,0,10500,8600,14358.03,10608.03,3000
50225211,SP2022 ,13005,515,4810,2220,20550,6750,6750,0,2750,6750,0,9500,6770,13800,11050,3000
50225211,SP2023 ,13500,550,4560,2325,20935,6750,6750,0,3250,6750,0,10000,7300,14185,10935,3000
50225211,SP2024 ,14750,600,5720,NULL,21070,6750,6750,0,3750,6750,0,10500,8600,14320,10570,3000
50231506,FA2024 ,14750,600,4790,2450,22590,9000,9000,0,2750,9000,0,11750,6350,13590,10840,0
50231506,SP2024 ,14750,600,4790,2450,22590,9000,9000,0,2750,9000,0,11750,6350,13590,10840,0
50216347,FA2021 ,12625,500,4580,NULL,17705,5925,5925,0,0,12005,0,12005,1120,5700,5700,0
50216347,FA2022 ,13005,515,4810,10.5,18340.5,5925,0,5925,1250,10735,0,11985,2785,7605.5,6355.5,0
50216347,FA2023 ,7450,550,5150,NULL,13150,3269,0,3269,0,9019,0,9019,-1019,4131,4131,0
50216347,SP2021 ,12625,500,4580,NULL,17705,5925,5925,0,10000,10505,0,20505,2620,7200,-2800,0
50216347,SP2022 ,13005,515,4810,NULL,18330,5925,0,5925,1250,11216,0,12466,2304,7114,5864,0
50216347,SP2023 ,3720,NULL,5150,NULL,8870,0,0,0,3700,5750,0,9450,-2030,3120,-580,0
50203132,FA2021 ,12625,6350,6350,NULL,18975,6325,6325,0,12050,7825,0,19875,11150,11150,-900,0
50203132,SP2021 ,6960,500,3740,2110,13310,3487,3487,0,8650,3487,0,12137,3973,9823,1173,0
50203513,FA2021 ,12625,500,4270,NULL,17395,3425,3425,0,3750,4425,0,8175,8700,12970,9220,0
50203513,SP2021 ,12625,500,4270,NULL,17395,3425,3425,0,3750,3425,0,7175,9700,13970,10220,0
50231436,FA2024 ,14750,600,4200,2900,22450,12750,1750,11000,12676,14840,0,27516,510,7610,-5066,-0.05
50231436,SP2024 ,14750,600,4200,2450,22000,10750,1750,9000,12676,12840,0,25516,2510,9160,-3516,-0.05
50203812,FA2021 ,3470,NULL,NULL,NULL,3470,0,0,0,0,4470,3470,4470,-1000,-1000,-1000,0
50204286,FA2021 ,12625,500,4270,1080,18475,2675,2675,0,NULL,2675,0,2675,10450,15800,15800,-1470
50204286,SP2021 ,12625,500,4270,1080,18475,2675,2675,0,NULL,2675,0,2675,10450,15800,15800,-1470
50232855,FA2024 ,14750,600,4200,2450,22000,10500,8500,2000,0,10870,0,10870,4480,11130,11130,0
50232855,SP2024 ,14750,600,4200,2450,22000,8500,8500,0,0,8870,0,8870,6480,13130,13130,0
50225343,FA2023 ,13500,550,4000,2325,20375,9000,7500,1500,NULL,9000,0,9000,5050,11375,11375,4234
50225343,FA2024 ,14750,600,4200,2450,22000,10000,7500,2500,NULL,10000,0,10000,5350,12000,12000,4234
50225343,SP2023 ,13500,550,4000,2325,20375,9000,7500,1500,NULL,9000,0,9000,5050,11375,11375,4234
50225343,SP2024 ,14750,600,4200,2450,22000,9000,7500,1500,NULL,9000,0,9000,6350,13000,13000,4234
50228613,SP2023 ,13500,550,NULL,NULL,14050,4485,3485,1000,0,17683,0,17683,-3633,-3633,-3633,0
50225386,FA2022 ,13005,515,4810,2220,20550,5300,5300,0,17329,5300,0,22629,8220,15250,-2079,0
50225386,FA2023 ,13500,550,5150,2325,21525,5300,5000,300,18250,5300,0,23550,8750,16225,-2025,0
50225386,SP2022 ,13005,515,4810,2220,20550,5300,5300,0,16171,5300,0,21471,8220,15250,-921,0
50225386,SP2023 ,13500,550,5150,2325,21525,5300,5000,300,18250,5300,0,23550,8750,16225,-2025,0
50209298,SP2021 ,13867,6974,6974,NULL,20841,0,0,0,NULL,0,0,0,20841,20841,20841,0
50215482,FA2021 ,19340,860,5440,2110,26890,11500,9500,2000,3250,12500,0,15750,7700,14390,11140,0
50215482,FA2022 ,19910,890,5700,1140,26750,9000,9000,0,3750,9000,0,12750,11800,17750,14000,0
50215482,FA2023 ,20670,950,6390,1200,28260,9000,9000,0,3750,9000,0,12750,12620,19260,15510,0
50215482,SP2021 ,19340,860,5440,2110,26890,9500,9500,0,3250,9500,0,12750,10700,17390,14140,0
50215482,SP2022 ,19910,890,5700,1140,26750,9000,9000,0,3750,9000,0,12750,11800,17750,14000,0
50228394,FA2023 ,13500,550,4560,2325,20935,9500,0,9500,NULL,9500,0,9500,4550,11435,11435,0
50228394,FA2024 ,14750,600,4790,2450,22590,9500,0,9500,NULL,9500,0,9500,5850,13090,13090,0
50228394,SP2023 ,13500,550,4560,2325,20935,9500,0,9500,NULL,9500,0,9500,4550,11435,11435,0
50228394,SP2024 ,14750,600,4790,2450,22590,9500,0,9500,NULL,9500,0,9500,5850,13090,13090,0
50231361,FA2024 ,14750,600,5410,1270,22030,8100,8100,0,2750,14100,0,16850,1250,7930,5180,0
50231361,SP2024 ,14750,600,5410,1270,22030,8100,8100,0,2750,8100,0,10850,7250,13930,11180,0
50231456,FA2024 ,14750,600,5410,2450,23210,8500,8500,0,2750,8500,0,11250,6850,14710,11960,4114
50231456,SP2024 ,14750,600,5410,2450,23210,8500,8500,0,2750,8500,0,11250,6850,14710,11960,4114
50197379,FA2022 ,13005,515,4810,2220,20550,4500,4500,0,NULL,4500,0,4500,9020,16050,16050,0
50197379,FA2023 ,13500,550,5150,2325,21525,4500,4500,0,NULL,4500,0,4500,9550,17025,17025,0
50197379,SP2022 ,13005,515,4810,2220,20550,4500,4500,0,NULL,4500,0,4500,9020,16050,16050,0
50218824,FA2021 ,12625,500,3740,2110,18975,4625,4625,0,NULL,6125,0,6125,7000,12850,12850,0
50218824,FA2024 ,14750,600,5030,1270,21650,4625,4625,0,NULL,4625,0,4625,10725,17025,17025,0
50218824,SP2021 ,12625,500,3740,2110,18975,4625,4625,0,NULL,4625,0,4625,8500,14350,14350,0
50218824,SP2024 ,14750,600,5030,1270,21650,4625,4625,0,NULL,4625,0,4625,10725,17025,17025,0
50204266,FA2021 ,12625,500,3740,1080,17945,8425,8425,0,NULL,9925,0,9925,3200,8020,8020,0
50204266,SP2021 ,12625,6350,6350,NULL,18975,3800,3800,0,NULL,3800,0,3800,15175,15175,15175,0
50218551,FA2021 ,6960,500,3740,2110,13310,8600,8600,0,3250,13848,0,17098,-6388,-538,-3788,0
50221968,FA2021 ,12625,500,NULL,1080,14205,3450,3450,0,NULL,4450,0,4450,8675,9755,9755,0
50221968,FA2022 ,7170,257,NULL,NULL,7427,1712,1712,0,NULL,1712,0,1712,5715,5715,5715,0
50221968,SP2021 ,12625,500,NULL,1080,14205,3450,3450,0,NULL,3450,0,3450,9675,10755,10755,0
50221968,SP2022 ,13005,515,NULL,NULL,13520,3105,3105,0,NULL,3105,0,3105,10415,10415,10415,0
50213373,FA2022 ,13005,515,3855,2220,19595,10425,7425,3000,NULL,10425,0,10425,3095,9170,9170,0
50213373,FA2023 ,7450,550,5440,NULL,13440,4098,4098,0,NULL,7598,0,7598,402,5842,5842,0
50213373,SP2021 ,12625,500,3740,2110,18975,6925,6925,0,NULL,6925,0,6925,6200,12050,12050,0
50213373,SP2022 ,13005,6590,6590,NULL,19595,7425,7425,0,NULL,7425,0,7425,12170,12170,12170,0
50217594,FA2021 ,12625,500,5160,1080,19365,3925,0,3925,16911,7548,0,24459,5577,11817,-5094,0
50217594,SP2021 ,12625,500,5160,1080,19365,3925,0,3925,16911,5547,0,22458,7578,13818,-3093,0
50216124,FA2022 ,13005,515,4810,2220,20550,9000,7000,2000,0,9000,0,9000,4520,11550,11550,3633.33
50216124,FA2023 ,13500,550,5150,2325,21525,9000,7000,2000,3750,9000,0,12750,5050,12525,8775,3633.33
50216124,FA2024 ,14750,600,4790,2450,22590,9000,5000,4000,3750,13790,0,17540,1560,8800,5050,3633.33
50216124,SP2022 ,13005,515,4810,2220,20550,7000,7000,0,2750,7000,0,9750,6520,13550,10800,3633.33
50216124,SP2023 ,13500,550,5150,2325,21525,7000,7000,0,3750,7000,0,10750,7050,14525,10775,3633.33
50216124,SP2024 ,14750,600,4790,2450,22590,7000,5000,2000,3750,11790,0,15540,3560,10800,7050,3633.33
50202825,FA2021 ,6960,250,NULL,NULL,7210,0,0,0,NULL,1500,0,1500,5710,5710,5710,0
50202825,FA2022 ,1860,NULL,NULL,NULL,1860,0,0,0,NULL,0,0,0,1860,1860,1860,0
50202825,SP2021 ,6960,250,NULL,NULL,7210,0,0,0,NULL,0,0,0,7210,7210,7210,0
50202825,SP2022 ,5360,257,NULL,NULL,5617,0,0,0,NULL,0,0,0,5617,5617,5617,0
50234477,FA2024 ,14750,600,4200,2450,22000,6000,6000,0,8493,6000,0,14493,9350,16000,7507,3681.32
50234477,SP2024 ,14750,600,4200,2450,22000,6000,6000,0,8493,6000,0,14493,9350,16000,7507,3681.32
50229480,FA2023 ,13500,550,5150,2325,21525,8350,8350,0,2750,12048,0,14798,2002,9477,6727,0
50227745,FA2023 ,13500,550,4000,2325,20375,6500,6500,0,0,6500,0,6500,7550,13875,13875,0
50227745,SP2023 ,13500,550,5150,2325,21525,6500,6500,0,0,6500,0,6500,7550,15025,15025,0
50230188,FA2023 ,13500,550,4000,2325,20375,8350,8350,0,4750,10223,0,14973,3827,10152,5402,0
50224664,FA2022 ,13005,515,4810,2220,20550,8950,8950,0,2750,14523,0,17273,-1003,6027,3277,-3448
50224664,FA2023 ,13500,550,4560,2325,20935,8950,8950,0,3250,17583,0,20833,-3533,3352,102,-3448
50224664,FA2024 ,14750,600,4790,2450,22590,10450,7500,2950,3750,22863,0,26613,-7513,-273,-4023,-3448
50224664,SP2022 ,13005,515,4810,2220,20550,8950,8950,0,2750,14522,0,17272,-1002,6028,3278,-3448
50224664,SP2023 ,13500,550,4560,2325,20935,8950,8950,0,3250,17582,0,20832,-3532,3353,103,-3448
50224664,SP2024 ,14750,600,4790,2450,22590,10450,7500,2950,0,22863,0,22863,-7513,-273,-273,-3448
50112650,FA2021 ,12625,500,4830,1080,19035,2675,0,2675,6250,15448,0,21698,-2323,3587,-2663,0
50112650,FA2022 ,13005,515,5080,1140,19740,3425,0,3425,6250,8273,0,14523,5247,11467,5217,0
50112650,SP2021 ,12625,500,4830,1080,19035,2675,0,2675,6250,6447,0,12697,6678,12588,6338,0
50112650,SP2022 ,3580,NULL,NULL,NULL,3580,750,0,750,0,1612,0,1612,1968,1968,1968,0
50231641,FA2024 ,14750,600,5410,2450,23210,8000,8000,0,2750,8000,0,10750,7350,15210,12460,15
50231641,SP2024 ,14750,600,5410,2450,23210,8000,8000,0,10750,8000,0,18750,7350,15210,4460,15
50233555,FA2024 ,14750,600,4200,2450,22000,9000,9000,0,2750,12188,0,14938,3162,9812,7062,2425
50233555,SP2024 ,14750,600,4200,2450,22000,9000,9000,0,2750,12187,0,14937,3163,9813,7063,2425
50232775,FA2024 ,14750,600,5410,2450,23210,8500,8500,0,2750,13698,0,16448,1652,9512,6762,0
50232775,SP2024 ,14750,600,5410,2450,23210,8500,8500,0,2750,13697,0,16447,1653,9513,6763,0
50217873,FA2021 ,12625,500,3740,2110,18975,10200,275,9925,NULL,11700,0,11700,1425,7275,7275,0
50217873,FA2022 ,13005,515,5080,NULL,18600,13155,230,12925,0,14155,0,14155,-635,4445,4445,0
50217873,SP2021 ,12625,500,3740,2110,18975,10207,282,9925,NULL,10207,0,10207,2918,8768,8768,0
50217873,SP2022 ,13005,515,5080,NULL,18600,10192,267,9925,12000,10192,0,22192,3328,8408,-3592,0
50119320,FA2021 ,12625,500,3740,2110,18975,8050,8050,0,2750,9050,0,11800,4075,9925,7175,0
50119320,FA2022 ,13005,515,4610,NULL,18130,7550,7550,0,3750,7550,0,11300,5970,10580,6830,0
50119320,FA2023 ,13500,550,4790,1200,20040,7550,7550,0,3750,7550,0,11300,6500,12490,8740,0
50119320,SP2021 ,12625,500,3740,2110,18975,8050,8050,0,2750,8050,0,10800,5075,10925,8175,0
50119320,SP2022 ,13005,515,4610,NULL,18130,7550,7550,0,3750,7550,0,11300,5970,10580,6830,0
50119320,SP2023 ,13500,550,4790,1200,20040,7550,7550,0,3750,7550,0,11300,6500,12490,8740,0
50203395,FA2021 ,12625,6350,6350,NULL,18975,0,0,0,3750,2873,0,6623,16102,16102,12352,0
50203395,SP2021 ,12625,500,4830,NULL,17955,3275,3275,0,3750,5797,0,9547,7328,12158,8408,0
50229118,FA2023 ,13500,550,5150,2325,21525,6800,6800,0,4750,13848,0,18598,202,7677,2927,3184.34
50229118,SP2023 ,13500,550,4000,2325,20375,6800,6800,0,4750,13847,0,18597,203,6528,1778,3184.34
50218830,FA2021 ,12625,500,3740,2110,18975,0,0,0,NULL,1500,0,1500,11625,17475,17475,0
50218830,SP2021 ,12625,500,3740,2110,18975,0,0,0,NULL,0,0,0,13125,18975,18975,0
50223578,FA2021 ,12625,500,4270,1080,18475,6500,6500,0,14192,7273,0,21465,5852,11202,-2990,150
50223578,FA2022 ,13005,515,3855,1140,18515,6000,6000,0,3750,9472,0,13222,4048,9043,5293,150
50223578,SP2021 ,12625,500,4270,1080,18475,6500,6500,0,3750,7272,0,11022,5853,11203,7453,150
50223578,SP2022 ,13005,515,3855,1140,18515,6000,6000,0,3750,9473,0,13223,4047,9042,5292,150
50224355,FA2022 ,13005,515,4810,2220,20550,9350,9350,0,2750,9350,0,12100,4170,11200,8450,4788
50224355,FA2023 ,13500,550,5150,2325,21525,9350,9350,0,3250,9350,0,12600,4700,12175,8925,4788
50224355,FA2024 ,14750,600,5720,1270,22340,9350,7000,2350,3750,9350,0,13100,6000,12990,9240,4788
50224355,SP2022 ,13005,515,4810,2220,20550,9350,9350,0,2750,9350,0,12100,4170,11200,8450,4788
50224355,SP2023 ,13500,550,5150,2325,21525,9350,9350,0,3250,9350,0,12600,4700,12175,8925,4788
50224355,SP2024 ,14750,600,5720,1270,22340,9350,7000,2350,3750,9350,0,13100,6000,12990,9240,4788
50225065,FA2022 ,13005,515,4810,2220,20550,9000,9000,0,NULL,9000,0,9000,4520,11550,11550,0
50225065,SP2022 ,13005,515,4810,2220,20550,9000,9000,0,NULL,9000,0,9000,4520,11550,11550,0
50234243,FA2024 ,14750,600,NULL,NULL,15350,5089,2939,2150,12474,5089,0,17563,10261,10261,-2213,-1862
50234243,SP2024 ,14750,600,4200,2450,22000,7150,5000,2150,17161,7150,0,24311,8200,14850,-2311,-1862
50233378,FA2024 ,14750,600,4200,2450,22000,8000,8000,0,5359,8000,0,13359,7350,14000,8641,-0.05
50233378,SP2024 ,14750,600,4200,2450,22000,8000,8000,0,3993,8000,0,11993,7350,14000,10007,-0.05
50216979,FA2021 ,19340,860,4600,2110,26050,12000,10000,2000,3250,13000,0,16250,7200,13050,9800,0
50216979,FA2022 ,19910,890,4745,2220,26875,9500,9500,0,3750,9500,0,13250,11300,17375,13625,0
50216979,FA2023 ,20670,950,5740,1200,27610,12000,10000,2000,3750,12000,0,15750,9620,15610,11860,0
50216979,SP2021 ,19340,860,4600,2110,26050,10000,10000,0,3250,10000,0,13250,10200,16050,12800,0
50216979,SP2022 ,19910,890,4745,2220,26875,11500,9500,2000,3750,11500,0,15250,9300,15375,11625,0
50216979,SP2023 ,20670,950,5740,1200,27610,10000,10000,0,3750,10000,0,13750,11620,17610,13860,0
50224508,FA2021 ,12625,500,3740,2110,18975,6500,6500,0,10250,9500,0,19750,3625,9475,-775,0
50224508,SP2021 ,12625,500,3740,2110,18975,6500,6500,0,9250,6500,0,15750,6625,12475,3225,0
50210740,FA2021 ,12625,500,3740,2110,18975,2375,0,2375,3750,3875,0,7625,9250,15100,11350,0
50210740,FA2022 ,13005,515,3855,2220,19595,2375,0,2375,3750,2375,0,6125,11145,17220,13470,0
50210740,FA2023 ,7450,275,NULL,NULL,7725,483,0,483,2750,483,0,3233,7242,7242,4492,0
50210740,SP2021 ,12625,500,3740,2110,18975,2375,0,2375,3750,2375,0,6125,10750,16600,12850,0
50210740,SP2022 ,13005,515,3855,2220,19595,2375,0,2375,3750,2375,0,6125,11145,17220,13470,0
50233050,FA2024 ,14750,600,4200,2450,22000,8500,7500,1000,0,9500,0,9500,5850,12500,12500,0
50233050,SP2024 ,14750,600,4200,2450,22000,7500,7500,0,2750,7500,0,10250,7850,14500,11750,0
50206738,FA2021 ,12625,500,NULL,NULL,13125,0,0,0,NULL,0,0,0,13125,13125,13125,0
50206738,SP2021 ,12625,500,NULL,NULL,13125,0,0,0,NULL,0,0,0,13125,13125,13125,0
50232227,FA2024 ,14750,600,5410,2900,23660,9000,0,9000,16730,9200,0,25930,6150,14460,-2270,0
50232227,SP2024 ,14750,600,5410,2900,23660,9000,0,9000,15440,9000,0,24440,6350,14660,-780,0
50228179,FA2023 ,13500,550,5150,2325,21525,0,0,0,NULL,13500,13500,13500,550,8025,8025,4305
50228179,FA2024 ,14750,600,5410,2450,23210,0,0,0,NULL,14750,14750,14750,600,8460,8460,4305
50228179,SP2023 ,13500,550,5150,2325,21525,0,0,0,NULL,13500,13500,13500,550,8025,8025,4305
50228179,SP2024 ,14750,600,5410,2450,23210,0,0,0,NULL,14750,14750,14750,600,8460,8460,4305
50206814,FA2021 ,12625,500,3740,1080,17945,2000,0,2000,NULL,3500,0,3500,9625,14445,14445,0
50206814,FA2022 ,13005,515,5080,NULL,18600,2500,2500,0,NULL,2500,0,2500,11020,16100,16100,0
50206814,SP2022 ,13005,515,5080,NULL,18600,2500,2500,0,NULL,2500,0,2500,11020,16100,16100,0
50191344,FA2021 ,12625,500,3740,1080,17945,8425,8425,0,NULL,9925,0,9925,3200,8020,8020,0
50191344,FA2022 ,13005,515,5080,NULL,18600,11425,8425,3000,NULL,11425,0,11425,2095,7175,7175,0
50191344,SP2021 ,12625,500,3740,1080,17945,10425,8425,2000,NULL,10425,0,10425,2700,7520,7520,0
50191344,SP2022 ,13005,515,5080,NULL,18600,12925,8425,4500,NULL,12925,0,12925,595,5675,5675,0
50197691,FA2022 ,13005,515,3855,2220,19595,9450,6335,3115,NULL,9450,0,9450,4070,10145,10145,5600
50197691,SP2021 ,12625,500,3740,2110,18975,9450,7450,2000,NULL,9450,0,9450,3675,9525,9525,5600
50197691,SP2022 ,13005,515,3855,2220,19595,7450,6335,1115,NULL,7450,0,7450,6070,12145,12145,5600
50211625,FA2021 ,12625,500,3740,1080,17945,7425,5425,2000,NULL,8925,0,8925,4200,9020,9020,0
50230474,FA2023 ,13500,550,4000,2325,20375,8000,8000,0,NULL,8000,0,8000,6050,12375,12375,5111
50230474,FA2024 ,14750,600,4790,2450,22590,8000,8000,0,NULL,8000,0,8000,7350,14590,14590,5111
50230474,SP2023 ,13500,550,4000,2325,20375,8000,8000,0,NULL,8000,0,8000,6050,12375,12375,5111
50230474,SP2024 ,14750,600,4790,2450,22590,8000,8000,0,NULL,8000,0,8000,7350,14590,14590,5111
50209407,FA2021 ,12625,6350,6350,NULL,18975,2925,2925,0,3750,3925,0,7675,15050,15050,11300,0
50209407,FA2022 ,13005,515,3855,1140,18515,2925,2925,0,3750,2925,0,6675,10595,15590,11840,0
50209407,SP2021 ,12625,500,3740,1080,17945,2925,2925,0,3750,2925,0,6675,10200,15020,11270,0
50209407,SP2022 ,13005,515,3855,1140,18515,2925,2925,0,3750,2925,0,6675,10595,15590,11840,0
50212108,FA2021 ,12625,500,3740,2110,18975,2925,0,2925,NULL,4425,0,4425,8700,14550,14550,0
50212108,FA2022 ,13005,515,3855,2220,19595,2925,0,2925,NULL,2925,0,2925,10595,16670,16670,0
50212108,FA2023 ,13500,550,5150,2325,21525,2925,0,2925,NULL,2925,0,2925,11125,18600,18600,0
50212108,SP2021 ,12625,500,3740,2110,18975,2925,0,2925,NULL,2925,0,2925,10200,16050,16050,0
50212108,SP2022 ,13850,515,3855,2220,20440,2925,0,2925,NULL,2925,0,2925,11440,17515,17515,0
50212108,SP2023 ,13500,550,5150,2325,21525,2925,0,2925,NULL,2925,0,2925,11125,18600,18600,0
50210136,FA2023 ,13500,550,5440,1200,20690,6425,4425,2000,NULL,6425,0,6425,7625,14265,14265,0
50210136,FA2024 ,14750,600,4200,2450,22000,6425,1050,5375,NULL,6425,0,6425,8925,15575,15575,0
50210136,SP2022 ,13005,515,5080,1140,19740,0,0,0,NULL,0,0,0,13520,19740,19740,0
50210136,SP2023 ,13500,550,5440,1200,20690,4425,4425,0,NULL,4425,0,4425,9625,16265,16265,0
50210136,SP2024 ,14750,600,4200,2450,22000,4425,1050,3375,NULL,4425,0,4425,10925,17575,17575,0
50213781,FA2021 ,19340,860,4600,2110,26050,11000,11000,0,NULL,12500,0,12500,7700,13550,13550,0
50213781,FA2022 ,19910,890,5970,1140,27020,11000,11000,0,NULL,11000,0,11000,9800,16020,16020,0
50213781,FA2023 ,20670,950,5740,NULL,26410,0,0,0,NULL,0,0,0,21620,26410,26410,0
50213781,SP2021 ,19340,860,4600,2110,26050,11000,11000,0,NULL,11000,0,11000,9200,15050,15050,0
50213781,SP2022 ,19910,890,5970,NULL,25880,11000,11000,0,NULL,11000,0,11000,9800,14880,14880,0
50213781,SP2023 ,20670,950,5740,NULL,26410,11000,11000,0,NULL,11000,0,11000,10620,15410,15410,0
50222123,FA2021 ,12625,500,4650,2110,19885,8000,8000,0,0,18000,0,18000,-4875,1885,1885,8971.49
50222123,FA2022 ,13005,515,4610,NULL,18130,7500,7500,0,3250,7500,0,10750,6020,10630,7380,8971.49
50222123,FA2023 ,13500,550,4790,NULL,18840,7500,7500,0,3250,7500,0,10750,6550,11340,8090,8971.49
50222123,FA2024 ,14750,600,5030,NULL,20380,7500,7500,0,NULL,7500,0,7500,7850,12880,12880,8971.49
50222123,SP2021 ,12625,500,4650,2110,19885,8000,8000,0,0,8000,0,8000,5125,11885,11885,8971.49
50222123,SP2022 ,13005,515,4610,NULL,18130,7500,7500,0,3250,7500,0,10750,6020,10630,7380,8971.49
50222123,SP2023 ,13500,550,4790,NULL,18840,7500,7500,0,3250,7500,0,10750,6550,11340,8090,8971.49
50222123,SP2024 ,14750,600,5030,NULL,20380,7500,7500,0,NULL,7500,0,7500,7850,12880,12880,8971.49
50226735,FA2022 ,13005,515,3855,2220,19595,7000,7000,0,2750,10748,0,13498,2772,8847,6097,610.95
50226735,FA2023 ,13500,550,4560,2325,20935,7606,7106,500,11081,12004,0,23085,2046,8931,-2150,610.95
50226735,FA2024 ,14750,600,5410,2450,23210,7000,7000,0,13735,11398,0,25133,3952,11812,-1923,610.95
50226735,SP2022 ,13005,515,3855,2220,19595,7055,7055,0,2750,10802,0,13552,2718,8793,6043,610.95
50226735,SP2023 ,13500,550,5150,2325,21525,7500,7000,500,11081,11897,0,22978,2153,9628,-1453,610.95
50226735,SP2024 ,14750,600,5410,2450,23210,7000,7000,0,13735,11397,0,25132,3953,11813,-1922,610.95
50209222,FA2021 ,12625,500,4580,2110,19815,4637,4637,0,10015,12985,0,23000,140,6830,-3185,0
50209222,FA2022 ,13005,515,4260,1140,18920,4637,4637,0,14192,8485,0,22677,5035,10435,-3757,0
50209222,SP2021 ,12625,500,4580,2110,19815,4638,4638,0,10015,12045,0,22060,1080,7770,-2245,0
50209234,FA2021 ,12625,500,5160,1080,19365,4675,4675,0,NULL,4675,0,4675,8450,14690,14690,0
50209234,SP2021 ,12625,500,5160,1080,19365,4675,4675,0,NULL,4675,0,4675,8450,14690,14690,0
50210073,FA2021 ,12625,500,3740,2110,18975,2175,2175,0,3750,3175,0,6925,9950,15800,12050,0
50210073,FA2022 ,13005,515,4610,NULL,18130,2175,2175,0,3750,2175,0,5925,11345,15955,12205,0
50210073,SP2021 ,12625,6350,6350,NULL,18975,2175,2175,0,3750,2175,0,5925,16800,16800,13050,0
50210073,SP2022 ,13005,515,4610,NULL,18130,2175,2175,0,3750,2175,0,5925,11345,15955,12205,0
50210078,FA2021 ,12625,500,4050,2110,19285,3425,2675,750,NULL,7475,0,7475,5650,11810,11810,0
50210078,FA2022 ,13005,515,4610,1140,19270,2675,2675,0,NULL,5103,0,5103,8417,14167,14167,0
50210078,SP2021 ,12625,500,4050,2110,19285,3425,2675,750,NULL,7475,0,7475,5650,11810,11810,0
50210078,SP2022 ,7170,515,4610,1140,13435,1475,1475,0,NULL,6987,0,6987,698,6448,6448,0
50215129,FA2021 ,12625,500,4580,2110,19815,9925,9925,0,3047,19028,0,22075,-5903,787,-2260,0
50215129,SP2021 ,12625,500,4580,2110,19815,9925,9925,0,3048,17027,0,20075,-3902,2788,-260,0
50221006,FA2021 ,12625,500,4580,2110,19815,6000,6000,0,15975,6000,0,21975,7125,13815,-2160,0
50221006,SP2021 ,12625,500,4580,2110,19815,6000,6000,0,14440,6000,0,20440,7125,13815,-625,0
50222508,FA2021 ,12625,500,4580,2110,19815,6500,6500,0,13750,7500,0,21250,5625,12315,-1435,0
50222508,FA2022 ,13005,515,3855,2220,19595,5500,5500,0,3250,5500,0,8750,8020,14095,10845,0
50222508,SP2021 ,12625,500,4580,2110,19815,6500,6500,0,2750,6500,0,9250,6625,13315,10565,0
50222508,SP2022 ,13005,515,3855,2220,19595,5500,5500,0,14250,5500,0,19750,8020,14095,-155,0
50225326,FA2022 ,13005,515,3855,2220,19595,7500,7500,0,9800,10323,0,20123,3197,9272,-528,2340
50225326,FA2023 ,13500,550,5150,2325,21525,7500,7500,0,0,10522,0,10522,3528,11003,11003,2340
50225326,SP2022 ,13005,515,3855,2220,19595,7500,7500,0,9391,10322,0,19713,3198,9273,-118,2340
50225326,SP2023 ,13500,550,5150,2325,21525,7500,7500,0,11203,10522,0,21725,3528,11003,-200,2340
50225844,FA2022 ,13005,515,4260,2220,20000,6500,6500,0,NULL,6500,0,6500,7020,13500,13500,2517.32
50225844,FA2023 ,13500,550,4560,2325,20935,7000,7000,0,NULL,7000,0,7000,7050,13935,13935,2517.32
50225844,FA2024 ,14750,600,5030,1270,21650,7500,6500,1000,NULL,7500,0,7500,7850,14150,14150,2517.32
50225844,SP2022 ,13005,515,4260,2220,20000,6500,6500,0,NULL,6500,0,6500,7020,13500,13500,2517.32
50225844,SP2023 ,13500,550,4560,2325,20935,7000,7000,0,NULL,7000,0,7000,7050,13935,13935,2517.32
50225844,SP2024 ,14750,600,5030,1270,21650,7500,6500,1000,NULL,7500,0,7500,7850,14150,14150,2517.32
50228529,FA2023 ,13500,550,4000,2325,20375,7500,7500,0,0,7500,0,7500,6550,12875,12875,0
50228529,FA2024 ,14750,600,4780,2450,22580,8000,8000,0,NULL,8000,0,8000,7350,14580,14580,0
50228529,SP2023 ,13500,550,4000,2325,20375,7500,7500,0,0,7500,0,7500,6550,12875,12875,0
50228529,SP2024 ,14750,600,4780,2450,22580,8000,8000,0,NULL,8000,0,8000,7350,14580,14580,0
50231583,FA2024 ,14750,600,NULL,2450,17800,5865,3865,2000,2750,16313,0,19063,-963,1487,-1263,-1750.8
50231583,SP2024 ,14750,600,NULL,NULL,15350,5865,3865,2000,2750,16312,0,19062,-962,-962,-3712,-1750.8
50231882,FA2024 ,14750,600,4200,2680,22230,9000,9000,0,5000,10500,0,15500,4850,11730,6730,0
50232653,FA2024 ,14750,600,4200,2450,22000,10000,10000,0,14758,10000,0,24758,5350,12000,-2758,-1284
50232653,SP2024 ,14750,600,4200,2450,22000,10000,10000,0,14758,10000,0,24758,5350,12000,-2758,-1284
50232779,FA2024 ,14750,600,4790,2450,22590,6000,6000,0,2750,6370,0,9120,8980,16220,13470,0
50232779,SP2024 ,14750,600,4790,2450,22590,6000,6000,0,2750,6370,0,9120,8980,16220,13470,0
50224992,FA2022 ,13005,515,3855,2220,19595,12500,0,12500,2750,12500,0,15250,1020,7095,4345,0
50224992,FA2023 ,13500,550,4000,2325,20375,12500,0,12500,NULL,12500,0,12500,1550,7875,7875,0
50224992,FA2024 ,14750,600,4200,2450,22000,9550,0,9550,NULL,9550,0,9550,5800,12450,12450,0
50224992,SP2022 ,13005,515,3855,2220,19595,9500,0,9500,2750,9500,0,12250,4020,10095,7345,0
50224992,SP2023 ,13500,550,4000,2325,20375,9550,0,9550,NULL,9550,0,9550,4500,10825,10825,0
50224992,SP2024 ,14750,600,4200,2450,22000,9500,0,9500,NULL,9500,0,9500,5850,12500,12500,0
40000880,FA2021 ,12625,500,3740,2110,18975,0,0,0,NULL,12625,12625,12625,500,6350,6350,0
40000880,FA2022 ,13005,515,3855,2220,19595,0,0,0,NULL,13005,13005,13005,515,6590,6590,0
40000880,FA2023 ,13500,550,4790,2325,21165,0,0,0,NULL,13500,13500,13500,550,7665,7665,0
40000880,FA2024 ,14750,600,5030,2450,22830,0,0,0,NULL,14750,14750,14750,600,8080,8080,0
40000880,SP2021 ,12625,500,3740,2110,18975,0,0,0,NULL,12625,12625,12625,500,6350,6350,0
40000880,SP2022 ,13005,515,3855,2220,19595,0,0,0,NULL,13005,13005,13005,515,6590,6590,0
40000880,SP2023 ,13500,550,4790,2325,21165,0,0,0,NULL,13500,13500,13500,550,7665,7665,0
40000880,SP2024 ,8140,600,5030,2450,16220,0,0,0,NULL,8140,8140,8140,600,8080,8080,0
40001220,FA2021 ,3740,NULL,NULL,NULL,3740,0,0,0,NULL,0,0,0,3740,3740,3740,0
40001220,SP2021 ,3470,NULL,NULL,NULL,3470,0,0,0,NULL,0,0,0,3470,3470,3470,0
50202927,SP2021 ,1800,NULL,NULL,NULL,1800,0,0,0,NULL,0,0,0,1800,1800,1800,0
50215017,FA2021 ,12625,500,4580,2110,19815,7175,7175,0,12251,8675,0,20926,4450,11140,-1111,0
50215017,FA2022 ,13005,515,4610,1140,19270,7175,7175,0,12150,7175,0,19325,6345,12095,-55,0
50215017,SP2021 ,12625,500,4580,2110,19815,7175,7175,0,12249,7175,0,19424,5950,12640,391,0
50215017,SP2022 ,13005,515,4610,1140,19270,7175,7175,0,12150,7175,0,19325,6345,12095,-55,0
50222441,FA2021 ,12625,500,4830,NULL,17955,7000,7000,0,2750,8000,0,10750,5125,9955,7205,0
50222630,FA2022 ,13005,515,3855,2220,19595,7000,7000,0,12750,7000,0,19750,6520,12595,-155,0
50222630,FA2023 ,13500,550,5150,2325,21525,5250,5250,0,14377,8773,0,23150,5277,12752,-1625,0
50222630,FA2024 ,14750,600,5410,2450,23210,7000,5000,2000,8417,12598,0,21015,2752,10612,2195,0
50222630,SP2022 ,13005,515,4810,2220,20550,7000,7000,0,12750,7000,0,19750,6520,13550,800,0
50222630,SP2023 ,13500,550,5150,2325,21525,6250,5250,1000,13378,9772,0,23150,4278,11753,-1625,0
50222630,SP2024 ,14750,600,5410,2450,23210,7000,5000,2000,8417,12597,0,21014,2753,10613,2196,0
50222951,FA2022 ,13005,515,3855,2220,19595,9000,9000,0,2750,9000,0,11750,4520,10595,7845,0
50222951,FA2023 ,13500,550,4000,2535,20585,9300,7800,1500,3250,9300,0,12550,4750,11285,8035,0
50222951,FA2024 ,14750,600,5030,NULL,20380,8500,7000,1500,3750,11000,0,14750,4350,9380,5630,0
50222951,SP2022 ,13005,515,3855,2220,19595,9000,9000,0,2750,9000,0,11750,4520,10595,7845,0
50222951,SP2023 ,13500,550,4000,2535,20585,9000,7500,1500,3250,9000,0,12250,5050,11585,8335,0
50222951,SP2024 ,14750,600,5030,NULL,20380,9000,7500,1500,2750,9000,0,11750,6350,11380,8630,0
50225038,FA2022 ,13005,515,4810,2220,20550,4500,4500,0,19051,4500,0,23551,9020,16050,-3001,0
50225038,FA2023 ,13500,550,5150,2325,21525,4500,4500,0,19147,4500,0,23647,9550,17025,-2122,0
50225038,SP2022 ,13005,515,4810,2220,20550,4500,4500,0,19052,4500,0,23552,9020,16050,-3002,0
50225038,SP2023 ,13500,550,5150,2325,21525,4500,4500,0,19147,4500,0,23647,9550,17025,-2122,0
50228635,FA2023 ,13500,550,5150,2535,21735,6000,6000,0,0,9673,0,9673,4377,12062,12062,0
50228663,FA2023 ,13500,550,1948,2325,18323,5830,5830,0,2750,5830,0,8580,8220,12493,9743,280
50228663,FA2024 ,14750,600,4200,2450,22000,8000,8000,0,3250,8000,0,11250,7350,14000,10750,280
50228663,SP2023 ,13500,550,5150,2325,21525,8000,8000,0,2750,8000,0,10750,6050,13525,10775,280
50228663,SP2024 ,14750,600,4200,2450,22000,8000,8000,0,3250,8000,0,11250,7350,14000,10750,280
50234376,FA2024 ,15000,7500,7500,NULL,22500,0,0,0,NULL,0,0,0,22500,22500,22500,0
50234837,FA2024 ,14750,600,4200,2450,22000,8850,6500,2350,2750,8850,0,11600,6500,13150,10400,13564.88
50234837,SP2024 ,14750,600,4200,2450,22000,8850,6500,2350,2750,8850,0,11600,6500,13150,10400,13564.88
50229687,FA2023 ,13500,550,4000,2325,20375,6950,6950,0,2750,9373,0,12123,4677,11002,8252,166
50229687,FA2024 ,14750,600,4200,2450,22000,6950,5500,1450,13407,11048,0,24455,4302,10952,-2455,166
50229687,SP2023 ,13500,550,4000,2325,20375,8950,6950,2000,9746,11372,0,21118,2678,9003,-743,166
50229687,SP2024 ,14750,600,4200,2450,22000,9950,5500,4450,8250,14047,0,22297,1303,7953,-297,166
50110124,FA2021 ,12625,500,4830,NULL,17955,6675,0,6675,NULL,6675,0,6675,6450,11280,11280,0
50110124,SP2021 ,12625,500,4830,NULL,17955,6675,0,6675,NULL,6675,0,6675,6450,11280,11280,0
50232333,FA2024 ,14750,600,4790,2900,23040,0,0,0,2750,18448,14750,21198,-3098,4592,1842,0
50232333,SP2024 ,14750,600,4790,2450,22590,0,0,0,2750,18447,14750,21197,-3097,4143,1393,0
50219156,FA2021 ,19340,860,860,NULL,20200,10750,10750,0,5250,18748,0,23998,1452,1452,-3798,0
50219156,FA2022 ,19910,890,890,NULL,20800,11750,11750,0,6250,17823,0,24073,2977,2977,-3273,0
50219156,FA2023 ,20670,950,950,NULL,21620,10250,4500,5750,6250,13173,0,19423,8447,8447,2197,0
50219156,SP2021 ,19340,860,860,NULL,20200,10750,10750,0,5250,17807,0,23057,2393,2393,-2857,0
50219156,SP2022 ,19910,890,890,NULL,20800,10250,10250,0,6250,16322,0,22572,4478,4478,-1772,0
50219156,SP2023 ,20670,950,950,NULL,21620,10250,4500,5750,6250,13172,0,19422,8448,8448,2198,0
50235823,SP2024 ,14750,600,5720,1270,22340,6050,6050,0,5250,9748,0,14998,5602,12592,7342,6935
50210201,FA2021 ,12625,500,4830,1080,19035,2425,2425,0,3750,3425,0,7175,9700,15610,11860,0
50210201,FA2022 ,13005,515,5080,NULL,18600,2425,2425,0,3750,2425,0,6175,11095,16175,12425,0
50210201,SP2021 ,12625,500,4830,1080,19035,2425,2425,0,3750,2425,0,6175,10700,16610,12860,0
50210201,SP2022 ,13005,515,5080,NULL,18600,2425,2425,0,3750,2425,0,6175,11095,16175,12425,0
50230414,FA2023 ,13500,550,4000,1200,19250,7000,7000,0,2750,7000,0,9750,7050,12250,9500,0
50230414,SP2023 ,13500,550,4000,1200,19250,7000,7000,0,2750,7000,0,9750,7050,12250,9500,0
40001300,FA2022 ,13005,515,3855,2220,19595,13005,13005,0,2750,13005,0,15755,515,6590,3840,-110.91
40001300,FA2023 ,13500,550,4000,2325,20375,13500,13500,0,NULL,13500,0,13500,550,6875,6875,-110.91
40001300,FA2024 ,14750,600,5240,2450,23040,14750,14750,0,NULL,14750,0,14750,600,8290,8290,-110.91
40001300,SP2022 ,13005,515,3855,2220,19595,13005,13005,0,2750,13005,0,15755,515,6590,3840,-110.91
40001300,SP2023 ,13500,550,4000,2325,20375,13500,13500,0,NULL,13500,0,13500,550,6875,6875,-110.91
40001300,SP2024 ,14750,600,5240,2450,23040,14750,14750,0,NULL,14750,0,14750,600,8290,8290,-110.91
50193055,SP2023 ,13500,550,NULL,NULL,14050,1000,1000,0,6250,4773,0,11023,9277,9277,3027,0
50226663,FA2022 ,13005,515,3855,2220,19595,13198,9198,4000,NULL,14198,0,14198,-678,5397,5397,28728.65
50226663,FA2023 ,13500,550,5800,1200,21050,15500,5500,10000,NULL,20000,0,20000,-5950,1050,1050,28728.65
50226663,FA2024 ,14750,600,4200,2450,22000,13500,5000,8500,NULL,13500,0,13500,1850,8500,8500,28728.65
50226663,SP2022 ,13005,515,3855,2220,19595,13500,9000,4500,NULL,13500,0,13500,20,6095,6095,28728.65
50226663,SP2023 ,13500,550,4560,1200,19810,11500,5000,6500,NULL,13500,0,13500,550,6310,6310,28728.65
50226663,SP2024 ,14750,600,4200,2450,22000,11750,5250,6500,NULL,11750,0,11750,3600,10250,10250,28728.65
50215137,FA2021 ,12625,500,4050,2110,19285,0,0,0,3250,16698,12625,19948,-3573,2587,-663,0
50215137,FA2022 ,13005,515,3855,1140,18515,0,0,0,3750,14128,13005,17878,-608,4387,637,0
50215137,FA2023 ,13500,550,4790,NULL,18840,0,0,0,3750,14773,13500,18523,-723,4067,317,0
50215137,SP2021 ,12625,500,4050,2110,19285,0,0,0,3250,14697,12625,17947,-1572,4588,1338,0
50215137,SP2022 ,13005,515,3855,NULL,17375,0,0,0,3750,14127,13005,17877,-607,3248,-502,0
50215137,SP2023 ,13500,550,4790,NULL,18840,0,0,0,3750,14772,13500,18522,-722,4068,318,0
50221593,FA2021 ,12625,500,4580,2110,19815,5500,5500,0,2750,5500,0,8250,7625,14315,11565,0
50221593,FA2022 ,13005,515,4810,2220,20550,5000,5000,0,3250,5000,0,8250,8520,15550,12300,0
50221593,SP2021 ,12625,500,4580,2110,19815,5500,5500,0,2750,5500,0,8250,7625,14315,11565,0
50221593,SP2022 ,13005,515,4810,2220,20550,5000,5000,0,3250,5000,0,8250,8520,15550,12300,0
50217251,FA2021 ,12625,500,NULL,NULL,13125,4425,4425,0,2750,10073,0,12823,3052,3052,302,13233
50217251,FA2022 ,13005,515,3855,2220,19595,7425,5925,1500,3250,11273,0,14523,2247,8322,5072,13233
50217251,FA2023 ,13500,550,4550,2325,20925,7425,0,7425,3750,11523,0,15273,2527,9402,5652,13233
50217251,FA2024 ,6090,300,NULL,NULL,6390,3188,0,3188,NULL,3188,0,3188,3202,3202,3202,13233
50217251,SP2022 ,13005,515,3855,2220,19595,7425,5925,1500,3250,11272,0,14522,2248,8323,5073,13233
50217251,SP2023 ,13500,550,4550,2325,20925,7425,0,7425,3750,11522,0,15272,2528,9403,5653,13233
50217251,SP2024 ,14750,600,NULL,1270,16620,7425,0,7425,NULL,7425,0,7425,7925,9195,9195,13233
50208022,FA2021 ,12625,500,4580,2550,20255,3925,3925,0,NULL,5425,0,5425,7700,14830,14830,0
50208022,FA2022 ,13005,515,4810,2690,21020,3925,3925,0,NULL,3925,0,3925,9595,17095,17095,0
50208022,SP2021 ,12625,500,4580,2550,20255,3925,3925,0,NULL,3925,0,3925,9200,16330,16330,0
50208022,SP2022 ,13005,515,4810,2690,21020,3925,3925,0,NULL,3925,0,3925,9595,17095,17095,0
50213050,FA2021 ,12625,500,4050,2110,19285,22185,4062,18123,NULL,23685,0,23685,-10560,-4400,-4400,0
50213050,FA2022 ,13005,515,4610,1140,19270,19716,1121,18595,NULL,19716,0,19716,-6196,-446,-446,0
50213050,SP2021 ,12625,500,4270,1080,18475,18828,4081,14747,NULL,18828,0,18828,-5703,-353,-353,0
50213050,SP2022 ,13005,515,4610,1140,19270,19595,1000,18595,NULL,19595,0,19595,-6075,-325,-325,0
50231968,SP2023 ,14500,7000,7000,NULL,21500,0,0,0,NULL,0,0,0,21500,21500,21500,0
50224995,FA2022 ,13005,515,4810,2220,20550,9300,9300,0,2750,9300,0,12050,4220,11250,8500,1106.33
50224995,FA2023 ,13500,550,5150,2325,21525,9300,6500,2800,3250,14450,0,17700,-400,7075,3825,1106.33
50224995,FA2024 ,14750,600,4200,2450,22000,10300,6500,3800,3750,15100,0,18850,250,6900,3150,1106.33
50224995,SP2022 ,13005,515,4810,2220,20550,9300,9300,0,2750,9300,0,12050,4220,11250,8500,1106.33
50224995,SP2023 ,13500,550,5150,2325,21525,9300,6500,2800,3250,14450,0,17700,-400,7075,3825,1106.33
50224995,SP2024 ,14750,600,4200,2450,22000,10300,6500,3800,3750,15100,0,18850,250,6900,3150,1106.33
50209815,FA2021 ,12625,6350,6350,NULL,18975,425,0,425,3750,1425,0,5175,17550,17550,13800,0
50209815,FA2022 ,13005,515,4380,2220,20120,425,0,425,3750,425,0,4175,13095,19695,15945,0
50209815,SP2021 ,12625,500,3740,1080,17945,425,0,425,3750,425,0,4175,12700,17520,13770,0
50209815,SP2022 ,13005,515,4380,2220,20120,425,0,425,3750,425,0,4175,13095,19695,15945,0
50217390,FA2021 ,12625,500,3740,2110,18975,14325,10325,4000,3250,15825,0,19075,-2700,3150,-100,0
50217390,FA2022 ,13005,515,4610,NULL,18130,10325,10325,0,8750,11325,0,20075,2195,6805,-1945,0
50217390,FA2023 ,13500,550,5440,NULL,19490,10325,0,10325,9750,11825,0,21575,2225,7665,-2085,0
50217390,SP2021 ,12625,500,3740,2110,18975,10325,10325,0,3250,14325,0,17575,-1200,4650,1400,0
50217390,SP2022 ,13005,515,4610,NULL,18130,10325,10325,0,8250,10325,0,18575,3195,7805,-445,0
50217390,SP2023 ,13500,550,5440,NULL,19490,10325,0,10325,9250,10325,0,19575,3725,9165,-85,0
50186429,FA2021 ,12625,500,3740,2110,18975,4925,0,4925,NULL,6425,0,6425,6700,12550,12550,0
50186429,SP2021 ,12625,500,3740,2110,18975,4925,0,4925,NULL,4925,0,4925,8200,14050,14050,0
50199931,FA2022 ,13005,515,3855,1140,18515,2500,2500,0,6250,5948,0,12198,7572,12567,6317,0
50199931,SP2022 ,13005,515,3855,NULL,17375,2500,2500,0,6250,5947,0,12197,7573,11428,5178,0
50206119,FA2022 ,13005,515,5080,NULL,18600,8425,8425,0,NULL,8425,0,8425,5095,10175,10175,0
50206119,SP2022 ,13005,515,5080,NULL,18600,8425,8425,0,NULL,8425,0,8425,5095,10175,10175,0
50228408,FA2023 ,13500,550,4000,2325,20375,9000,9000,0,NULL,9000,0,9000,5050,11375,11375,3314
50228408,FA2024 ,14750,600,4790,NULL,20140,9000,9000,0,NULL,9000,0,9000,6350,11140,11140,3314
50228408,SP2023 ,13500,550,4000,2325,20375,9000,9000,0,NULL,9000,0,9000,5050,11375,11375,3314
50228408,SP2024 ,14750,600,4790,0,20140,9000,9000,0,NULL,9000,0,9000,6350,11140,11140,3314
50204132,FA2021 ,12625,500,4830,1080,19035,10175,7425,2750,3750,13648,0,17398,-523,5387,1637,0
50204132,SP2021 ,12625,500,4830,1080,19035,8175,7425,750,3750,9647,0,13397,3478,9388,5638,0
50221925,FA2021 ,12625,500,4580,2110,19815,9500,0,9500,12716,10500,0,23216,2625,9315,-3401,44
50221925,FA2022 ,13005,515,4260,2220,20000,10000,500,9500,6383,14260,0,20643,-740,5740,-643,44
50221925,FA2023 ,13500,550,4790,1200,20040,9550,0,9550,11059,11550,0,22609,2500,8490,-2569,44
50221925,FA2024 ,14750,600,5030,1270,21650,9500,0,9500,12103,11600,0,23703,3750,10050,-2053,44
50221925,SP2021 ,12625,500,4580,2110,19815,9500,0,9500,12716,9500,0,22216,3625,10315,-2401,44
50221925,SP2022 ,13005,515,4260,2220,20000,10000,500,9500,6382,14260,0,20642,-740,5740,-642,44
50221925,SP2023 ,13500,550,4790,1200,20040,9500,0,9500,11059,11500,0,22559,2550,8540,-2519,44
50221925,SP2024 ,14750,600,5030,1270,21650,9500,0,9500,12104,11600,0,23704,3750,10050,-2054,44
50146587,FA2021 ,6960,250,NULL,NULL,7210,0,0,0,6250,3624,0,9874,3586,3586,-2664,0
50146587,FA2022 ,3580,NULL,NULL,NULL,3580,750,0,750,NULL,750,0,750,2830,2830,2830,0
50146587,SP2021 ,6960,250,NULL,NULL,7210,0,0,0,6250,1060,0,7310,6150,6150,-100,0
50227337,FA2024 ,14750,600,4200,2450,22000,9000,8500,500,1750,12000,0,13750,3350,10000,8250,2894.32
50227337,SP2024 ,14750,600,4200,2450,22000,9000,8500,500,1750,9000,0,10750,6350,13000,11250,2894.32
50227878,FA2023 ,13500,550,4000,2325,20375,7000,7000,0,2750,9500,0,12250,4550,10875,8125,-70.09
50227878,FA2024 ,14750,600,4790,2450,22590,7000,7000,0,3250,9500,0,12750,5850,13090,9840,-70.09
50227878,SP2023 ,13500,550,4000,2325,20375,7000,7000,0,2750,7000,0,9750,7050,13375,10625,-70.09
50227878,SP2024 ,14750,600,4790,2450,22590,7000,7000,0,3250,7000,0,10250,8350,15590,12340,-70.09
50215180,FA2021 ,12625,500,4050,2550,19725,1675,0,1675,0,2675,0,2675,10450,17050,17050,0
50205343,FA2021 ,12625,500,NULL,NULL,13125,3225,2725,500,6250,17873,0,24123,-4748,-4748,-10998,0
50225482,FA2022 ,13005,515,3855,2690,20065,7350,7350,0,0,7350,0,7350,6170,12715,12715,99
50225482,FA2023 ,13500,550,4000,2535,20585,7350,5000,2350,2250,15423,0,17673,-1373,5162,2912,99
50225482,FA2024 ,14750,600,4200,2450,22000,7350,5000,2350,3750,12885,0,16635,2465,9115,5365,99
50225482,SP2022 ,13005,515,3855,2690,20065,7350,7350,0,13308,7350,0,20658,6170,12715,-593,99
50225482,SP2023 ,13500,550,4000,2325,20375,7350,5000,2350,3250,15422,0,18672,-1372,4953,1703,99
50225482,SP2024 ,14750,600,4200,2450,22000,7350,5000,2350,9855,12885,0,22740,2465,9115,-740,99
50224935,SP2021 ,15944,5556,5556,NULL,21500,0,0,0,NULL,0,0,0,21500,21500,21500,0
50227765,FA2023 ,13500,550,5150,2745,21945,7750,7750,0,2750,10000,0,12750,4050,11945,9195,3161.67
50227765,FA2024 ,14750,600,NULL,NULL,15350,6210,4710,1500,3250,6210,0,9460,9140,9140,5890,3161.67
50227765,SP2023 ,13500,550,5150,2745,21945,7750,7750,0,2750,9000,0,11750,5050,12945,10195,3161.67
50227765,SP2024 ,14750,600,NULL,NULL,15350,6210,4710,1500,3250,6210,0,9460,9140,9140,5890,3161.67
50215991,FA2021 ,12625,500,4580,2550,20255,5425,4825,600,3250,6425,0,9675,6700,13830,10580,0
50215991,FA2022 ,13005,515,4260,2220,20000,5425,4825,600,3750,5425,0,9175,8095,14575,10825,0
50215991,FA2023 ,13500,550,5440,2325,21815,5925,5325,600,3750,5925,0,9675,8125,15890,12140,0
50215991,SP2021 ,12625,500,4580,2550,20255,5425,4825,600,6243,5425,0,11668,7700,14830,8587,0
50215991,SP2022 ,13005,515,4260,2220,20000,5425,4825,600,11039,5425,0,16464,8095,14575,3536,0
50224900,FA2022 ,13005,515,4810,2220,20550,6750,6250,500,2750,6750,0,9500,6770,13800,11050,-270
50224900,FA2023 ,13500,550,5150,2325,21525,6750,6250,500,3250,6750,0,10000,7300,14775,11525,-270
50224900,FA2024 ,14750,600,5410,2450,23210,7400,1400,6000,3750,7400,0,11150,7950,15810,12060,-270
50224900,SP2022 ,13005,515,4810,2220,20550,6750,6250,500,2750,6750,0,9500,6770,13800,11050,-270
50224900,SP2023 ,13500,550,5150,2325,21525,7000,6500,500,10595,7000,0,17595,7050,14525,3930,-270
50224900,SP2024 ,14750,600,5410,2450,23210,7150,1150,6000,3750,7150,0,10900,8200,16060,12310,-270
50228557,FA2023 ,13500,550,5150,2325,21525,6500,6500,0,2750,6500,0,9250,7550,15025,12275,0
50228557,SP2023 ,13500,550,5150,2325,21525,6500,6500,0,8294,6500,0,14794,7550,15025,6731,0
50232472,FA2024 ,14750,600,4200,2450,22000,8300,8300,0,2750,13498,0,16248,1852,8502,5752,0
50232472,SP2024 ,14750,600,4200,2450,22000,8300,8300,0,2750,13497,0,16247,1853,8503,5753,0
50228614,FA2023 ,13500,550,4000,2745,20795,9000,7000,2000,12449,10773,0,23222,3277,10022,-2427,0
50228614,FA2024 ,14750,600,4200,2450,22000,9000,0,9000,11073,12485,0,23558,2865,9515,-1558,0
50228614,SP2023 ,13500,550,4000,2325,20375,9000,7000,2000,9950,10772,0,20722,3278,9603,-347,0
50228614,SP2024 ,14750,600,4200,2450,22000,9000,0,9000,9950,10985,0,20935,4365,11015,1065,0
50225594,FA2022 ,13005,515,3855,2220,19595,9700,7700,2000,4750,12323,0,17073,1197,7272,2522,2146.49
50225594,SP2022 ,13005,515,3855,2220,19595,7700,7700,0,4750,10322,0,15072,3198,9273,4523,2146.49
50224420,FA2022 ,13005,515,4810,2220,20550,8750,6750,2000,2750,10784,0,13534,2736,9766,7016,-1800
50224420,FA2023 ,13500,550,4560,2325,20935,8750,6750,2000,3250,10839,0,14089,3211,10096,6846,-1800
50224420,FA2024 ,14750,600,5030,NULL,20380,6750,6750,0,3750,8144,0,11894,7206,12236,8486,-1800
50224420,SP2022 ,13005,515,4810,2220,20550,6750,6750,0,2750,6750,0,9500,6770,13800,11050,-1800
50224420,SP2023 ,13500,550,4560,2325,20935,6750,6750,0,3250,6750,0,10000,7300,14185,10935,-1800
50224420,SP2024 ,14750,600,5030,NULL,20380,8750,6750,2000,3750,8750,0,12500,6600,11630,7880,-1800
50210959,FA2021 ,12625,500,4050,2110,19285,1675,1675,0,18096,4425,0,22521,8700,14860,-3236,0
50210959,FA2022 ,13005,515,5080,1140,19740,2925,2925,0,20509,2925,0,23434,10595,16815,-3694,0
50210959,SP2021 ,12625,500,4050,2110,19285,1675,1675,0,13720,2925,0,16645,10200,16360,2640,0
50210959,SP2022 ,13005,515,5080,1140,19740,2925,2925,0,11221,2925,0,14146,10595,16815,5594,0
50221721,FA2021 ,12625,500,3740,2110,18975,4500,4500,0,0,4500,0,4500,8625,14475,14475,4207
50221721,FA2022 ,13005,515,3855,2220,19595,4000,4000,0,NULL,4000,0,4000,9520,15595,15595,4207
50221721,FA2023 ,13500,550,4550,2325,20925,4000,4000,0,NULL,4000,0,4000,10050,16925,16925,4207
50221721,FA2024 ,14750,600,4200,2450,22000,4000,4000,0,10500,4000,0,14500,11350,18000,7500,4207
50221721,SP2021 ,12625,500,3740,2110,18975,4500,4500,0,0,4500,0,4500,8625,14475,14475,4207
50221721,SP2022 ,13005,515,3855,2220,19595,4000,4000,0,NULL,4000,0,4000,9520,15595,15595,4207
50221721,SP2023 ,13500,6825,6825,NULL,20325,4000,4000,0,NULL,4000,0,4000,16325,16325,16325,4207
50221721,SP2024 ,14750,600,4200,2450,22000,4000,4000,0,14500,4000,0,18500,11350,18000,3500,4207
50221914,FA2021 ,12625,500,4050,2110,19285,7500,5500,2000,2750,7500,0,10250,5625,11785,9035,0
50221914,SP2021 ,12625,500,4050,2110,19285,5500,5500,0,2750,5500,0,8250,7625,13785,11035,0
50223435,FA2021 ,12625,500,4580,2110,19815,5500,5500,0,4750,13048,0,17798,77,6767,2017,0
50223435,SP2021 ,12625,500,4580,2110,19815,5500,5500,0,279,12607,0,12886,518,7208,6929,0
50225070,SP2024 ,15000,7500,7500,NULL,22500,0,0,0,NULL,0,0,0,22500,22500,22500,0
50228231,FA2023 ,13500,550,4000,2325,20375,7500,7500,0,0,7500,0,7500,6550,12875,12875,0
50221078,FA2021 ,12625,500,4050,2110,19285,8650,8650,0,0,15523,0,15523,-2398,3762,3762,1090.67
50221078,FA2022 ,13005,515,4260,2220,20000,8150,8150,0,0,15173,0,15173,-1653,4827,4827,1090.67
50221078,FA2023 ,13500,550,4790,1200,20040,8150,8150,0,0,16900,0,16900,-2850,3140,3140,1090.67
50221078,FA2024 ,14750,600,5030,1270,21650,8075,6000,2075,0,18773,0,18773,-3423,2877,2877,1090.67
50221078,SP2021 ,12625,500,4050,2110,19285,8650,8650,0,0,10022,0,10022,3103,9263,9263,1090.67
50221078,SP2022 ,13005,515,4260,2220,20000,8150,8150,0,0,9172,0,9172,4348,10828,10828,1090.67
50221078,SP2023 ,13500,6825,6825,NULL,20325,8200,8200,0,3750,8200,0,11950,12125,12125,8375,1090.67
50221078,SP2024 ,14750,600,5030,1270,21650,8075,6000,2075,0,11772,0,11772,3578,9878,9878,1090.67
40001132,FA2021 ,12625,500,3740,2110,18975,3175,3175,0,3250,4675,0,7925,8450,14300,11050,0
40001132,FA2022 ,13005,515,4610,1140,19270,3175,3175,0,3750,3175,0,6925,10345,16095,12345,0
40001132,FA2023 ,13500,550,4550,2325,20925,3175,0,3175,NULL,3175,0,3175,10875,17750,17750,0
40001132,SP2021 ,12625,500,3740,2110,18975,3175,3175,0,3250,3175,0,6425,9950,15800,12550,0
40001132,SP2022 ,13005,515,4610,NULL,18130,3175,3175,0,3750,3175,0,6925,10345,14955,11205,0
40001132,SP2023 ,13500,550,4550,2325,20925,3175,0,3175,NULL,3175,0,3175,10875,17750,17750,0
50223807,FA2022 ,13005,515,3855,2220,19595,7500,7500,0,14341,7500,0,21841,6020,12095,-2246,10952.34
50223807,FA2023 ,13500,550,NULL,2325,16375,4830,4830,0,3250,4830,0,8080,9220,11545,8295,10952.34
50223807,SP2022 ,13005,515,3855,2220,19595,7500,7500,0,12147,7500,0,19647,6020,12095,-52,10952.34
50223807,SP2023 ,13500,550,NULL,2325,16375,4830,4830,0,3250,4830,0,8080,9220,11545,8295,10952.34
50223807,SP2024 ,14750,600,NULL,NULL,15350,4830,4830,0,3250,4830,0,8080,10520,10520,7270,10952.34
50231457,FA2024 ,14750,600,4200,2450,22000,7500,7500,0,15620,7500,0,23120,7850,14500,-1120,0
50231457,SP2024 ,5900,240,NULL,NULL,6140,2070,2070,0,4573,2070,0,6643,4070,4070,-503,0
50218728,FA2021 ,14090,4910,4910,NULL,19000,0,0,0,NULL,0,0,0,19000,19000,19000,0
50225155,FA2022 ,13005,515,4810,2220,20550,5250,5250,0,0,5250,0,5250,8270,15300,15300,0
50236960,SP2024 ,14750,600,4200,2450,22000,6500,6500,0,NULL,6500,0,6500,8850,15500,15500,0
50209679,FA2021 ,12625,500,5160,1080,19365,1425,1425,0,NULL,1425,0,1425,11700,17940,17940,0
50209679,FA2022 ,13005,515,4610,NULL,18130,1425,1425,0,NULL,1425,0,1425,12095,16705,16705,0
50209679,SP2021 ,12625,500,NULL,NULL,13125,0,0,0,NULL,0,0,0,13125,13125,13125,0
50209679,SP2022 ,7170,515,4610,NULL,12295,786,786,0,NULL,786,0,786,6899,11509,11509,0
50224694,FA2023 ,13500,550,5150,2325,21525,7750,7750,0,NULL,7750,0,7750,6300,13775,13775,0
50224694,FA2024 ,14750,600,5720,1270,22340,7750,7750,0,NULL,7750,0,7750,7600,14590,14590,0
50224694,SP2023 ,13500,550,5800,1200,21050,7750,7750,0,NULL,7750,0,7750,6300,13300,13300,0
50224694,SP2024 ,14750,7250,7250,NULL,22000,7750,7750,0,NULL,7750,0,7750,14250,14250,14250,0
50203458,FA2021 ,12625,500,4830,NULL,17955,6425,0,6425,12938,7925,0,20863,5200,10030,-2908,0
60001093,FA2024 ,14750,600,5410,2450,23210,0,0,0,2750,19948,14750,22698,-4598,3262,512,-170
60001093,SP2024 ,14750,600,5410,2450,23210,250,250,0,2750,20197,14750,22947,-4847,3013,263,-170
50231919,FA2024 ,14750,600,4200,2450,22000,0,0,0,2750,20150,14750,22900,-4800,1850,-900,-1951
50231919,SP2024 ,14750,600,4200,2450,22000,0,0,0,2750,14750,14750,17500,600,7250,4500,-1951
50119067,FA2021 ,12625,500,3740,2550,19415,0,0,0,NULL,12625,12625,12625,500,6790,6790,4006.24
50119067,FA2022 ,13005,515,3855,2690,20065,0,0,0,3250,13005,13005,16255,515,7060,3810,4006.24
50119067,FA2023 ,13500,550,5440,1200,20690,0,0,0,NULL,13500,13500,13500,550,7190,7190,4006.24
50119067,FA2024 ,14750,600,5030,2450,22830,0,0,0,NULL,14750,14750,14750,600,8080,8080,4006.24
50119067,SP2021 ,12625,500,3740,2550,19415,0,0,0,NULL,12625,12625,12625,500,6790,6790,4006.24
50119067,SP2022 ,13005,515,3855,2690,20065,0,0,0,3250,13005,13005,16255,515,7060,3810,4006.24
50119067,SP2023 ,13500,550,5440,2325,21815,0,0,0,NULL,13500,13500,13500,550,8315,8315,4006.24
50119067,SP2024 ,14750,600,5030,0,20380,0,0,0,NULL,14750,14750,14750,600,5630,5630,4006.24
50120405,FA2024 ,14750,600,4200,2450,22000,0,0,0,8580,14750,14750,23330,600,7250,-1330,0
50120405,SP2024 ,14750,600,4200,2450,22000,0,0,0,7695,14750,14750,22445,600,7250,-445,0
50226700,FA2022 ,14269,7231,7231,NULL,21500,0,0,0,NULL,0,0,0,21500,21500,21500,0
40001296,FA2023 ,13500,550,5150,2325,21525,7000,7000,0,1750,11223,0,12973,2827,10302,8552,0
40001296,FA2024 ,14750,600,5030,1270,21650,8100,7500,600,3250,8100,0,11350,7250,13550,10300,0
40001296,SP2023 ,13500,550,5150,2325,21525,7000,7000,0,2750,11222,0,13972,2828,10303,7553,0
40001296,SP2024 ,14750,600,5030,1270,21650,8100,7500,600,3250,8100,0,11350,7250,13550,10300,0
50209919,FA2021 ,12625,500,3740,1080,17945,6475,6475,0,2750,7975,0,10725,5150,9970,7220,0
50209919,FA2022 ,13005,515,3855,1140,18515,6475,6475,0,3750,6475,0,10225,7045,12040,8290,0
50209919,SP2021 ,12625,500,3740,1080,17945,6475,6475,0,3750,6475,0,10225,6650,11470,7720,0
50209919,SP2022 ,13005,515,3855,1140,18515,6475,6475,0,3750,6475,0,10225,7045,12040,8290,0
50214021,FA2023 ,13500,550,4000,2745,20795,7000,7000,0,3750,11523,0,15273,2527,9272,5522,0
50214021,FA2024 ,14750,600,5030,1270,21650,8100,7500,600,3750,8100,0,11850,7250,13550,9800,0
50214021,SP2023 ,13500,550,4000,2745,20795,7000,7000,0,3750,11522,0,15272,2528,9273,5523,0
50214021,SP2024 ,14750,600,5030,1270,21650,8100,7500,600,3750,8100,0,11850,7250,13550,9800,0
50203253,FA2021 ,12625,500,4830,1080,19035,3425,0,3425,NULL,3925,0,3925,9200,15110,15110,0
50203253,SP2021 ,12625,500,4830,1080,19035,3425,0,3425,NULL,3425,0,3425,9700,15610,15610,0
50234033,FA2024 ,14750,600,5410,2450,23210,7500,7500,0,19445,7500,0,26945,7850,15710,-3735,-4737.6
50234033,SP2024 ,14750,600,5410,2450,23210,7500,7500,0,17055,7500,0,24555,7850,15710,-1345,-4737.6
50209649,FA2021 ,12625,500,4580,2110,19815,925,925,0,3750,1925,0,5675,11200,17890,14140,0
50209649,FA2022 ,13005,515,NULL,1140,14660,0,0,0,16250,0,0,16250,13520,14660,-1590,0
50209649,SP2021 ,12625,500,NULL,1080,14205,0,0,0,13750,0,0,13750,13125,14205,455,0
50209649,SP2022 ,13005,515,NULL,1140,14660,0,0,0,16250,0,0,16250,13520,14660,-1590,0
50220871,FA2021 ,12625,500,4580,2550,20255,8000,8000,0,2750,8000,0,10750,5125,12255,9505,0
50220871,FA2022 ,13005,515,4810,2690,21020,7500,7500,0,3250,7500,0,10750,6020,13520,10270,0
50220871,FA2023 ,13500,550,4000,2325,20375,7500,7500,0,NULL,7500,0,7500,6550,12875,12875,0
50220871,FA2024 ,14750,600,4200,1270,20820,7500,7500,0,NULL,7500,0,7500,7850,13320,13320,0
50220871,SP2021 ,12625,500,4580,2550,20255,8250,8250,0,2750,8250,0,11000,4875,12005,9255,0
50220871,SP2022 ,13005,515,4810,2690,21020,7500,7500,0,3250,7500,0,10750,6020,13520,10270,0
50220871,SP2023 ,13500,550,4000,2325,20375,7500,7500,0,NULL,7500,0,7500,6550,12875,12875,0
50220871,SP2024 ,14750,600,4200,1270,20820,7500,7500,0,NULL,7500,0,7500,7850,13320,13320,0
50199218,FA2021 ,12625,6350,6350,NULL,18975,925,925,0,20456,2425,0,22881,16550,16550,-3906,0
50199218,SP2021 ,12625,500,4050,2110,19285,1375,1375,0,19412,1375,0,20787,11750,17910,-1502,0
50206600,FA2021 ,12625,500,3740,1080,17945,8062,2663,5399,NULL,9562,0,9562,3563,8383,8383,0
50206600,FA2022 ,13005,515,5080,0,18600,6097,3850,2247,NULL,6097,0,6097,7423,12503,12503,0
50206600,SP2021 ,12625,500,3740,1080,17945,6061,2662,3399,NULL,6061,0,6061,7064,11884,11884,0
50206600,SP2022 ,13005,515,5080,NULL,18600,8097,3850,4247,NULL,8097,0,8097,5423,10503,10503,0
50212168,FA2021 ,19340,860,4600,1080,25020,8750,7500,1250,12276,16723,0,28999,3477,8297,-3979,0
50212168,FA2022 ,19910,890,5970,1140,27020,9500,8250,1250,13273,15973,0,29246,4827,11047,-2226,0
50212168,SP2021 ,10660,860,4600,1080,16340,4824,4135,689,10276,7762,0,18038,3758,8578,-1698,0
50212168,SP2022 ,19910,890,5970,1140,27020,11500,8250,3250,13272,17972,0,31244,2828,9048,-4224,0
50213312,FA2023 ,13500,550,4000,2325,20375,7925,7425,500,NULL,7925,0,7925,6125,12450,12450,3253
50213312,FA2024 ,14750,600,4200,2450,22000,10475,7975,2500,NULL,10475,0,10475,4875,11525,11525,3253
50213312,SP2023 ,13500,550,4000,2325,20375,9925,7425,2500,NULL,9925,0,9925,4125,10450,10450,3253
50213312,SP2024 ,14750,600,4200,2450,22000,7925,7425,500,NULL,7925,0,7925,7425,14075,14075,3253
50215148,FA2021 ,12625,500,3740,2110,18975,10425,8425,2000,3250,11925,0,15175,1200,7050,3800,0
50215148,FA2022 ,13005,515,4810,1140,19470,10425,0,10425,3750,10425,0,14175,3095,9045,5295,0
50215148,FA2023 ,13500,550,4790,1200,20040,10425,0,10425,3750,10425,0,14175,3625,9615,5865,0
50215148,SP2021 ,12625,500,3740,2110,18975,8425,8425,0,3250,8425,0,11675,4700,10550,7300,0
50215148,SP2022 ,13005,515,4810,1140,19470,8425,0,8425,3750,8425,0,12175,5095,11045,7295,0
50215148,SP2023 ,13500,550,4790,NULL,18840,9425,0,9425,3750,9425,0,13175,4625,9415,5665,0
50215366,FA2021 ,12625,500,4580,2550,20255,9500,0,9500,NULL,9500,0,9500,3625,10755,10755,2438.41
50215366,FA2022 ,13005,515,4610,2220,20350,9500,0,9500,NULL,9500,0,9500,4020,10850,10850,2438.41
50215366,FA2023 ,13500,550,5440,NULL,19490,9550,0,9550,NULL,9550,0,9550,4500,9940,9940,2438.41
50215366,SP2021 ,12625,500,4580,2550,20255,9500,0,9500,NULL,9500,0,9500,3625,10755,10755,2438.41
50215366,SP2022 ,13005,515,4610,1140,19270,9500,0,9500,NULL,9500,0,9500,4020,9770,9770,2438.41
50215366,SP2023 ,13500,550,5440,NULL,19490,9500,0,9500,NULL,9500,0,9500,4550,9990,9990,2438.41
50215366,SP2024 ,14750,600,6090,55.09,21495.09,12000,0,12000,NULL,12000,0,12000,3350,9495.09,9495.09,2438.41
50215495,FA2021 ,12625,500,3740,2110,18975,8425,1175,7250,NULL,8925,0,8925,4200,10050,10050,0
50215495,FA2022 ,13005,515,3855,2220,19595,8425,1175,7250,NULL,8425,0,8425,5095,11170,11170,0
50215495,FA2023 ,13500,550,4790,1200,20040,12175,1675,10500,NULL,12175,0,12175,1875,7865,7865,0
50215495,SP2021 ,12625,500,3740,2110,18975,8425,1175,7250,NULL,8425,0,8425,4700,10550,10550,0
50215495,SP2022 ,13005,515,3855,2220,19595,10425,1175,9250,NULL,10425,0,10425,3095,9170,9170,0
50215495,SP2023 ,13500,550,4790,NULL,18840,10175,1675,8500,NULL,10175,0,10175,3875,8665,8665,0
50217208,FA2021 ,12625,500,4580,2110,19815,5925,5925,0,NULL,7425,0,7425,5700,12390,12390,0
50217208,FA2022 ,13005,515,5080,1140,19740,5925,5925,0,NULL,5925,0,5925,7595,13815,13815,0
50217208,FA2023 ,13500,550,5440,NULL,19490,5925,5925,0,NULL,5925,0,5925,8125,13565,13565,0
50217208,SP2021 ,12625,500,4580,2110,19815,5925,5925,0,NULL,5925,0,5925,7200,13890,13890,0
50217208,SP2022 ,13005,515,5080,NULL,18600,7925,5925,2000,NULL,7925,0,7925,5595,10675,10675,0
50217208,SP2023 ,13500,550,5440,NULL,19490,5925,5925,0,NULL,5925,0,5925,8125,13565,13565,0
50217807,FA2021 ,12625,500,4580,2110,19815,10325,0,10325,3250,17398,0,20648,-4273,2417,-833,0
50217807,FA2022 ,13005,515,4810,2220,20550,10325,0,10325,15618,14148,0,29766,-628,6402,-9216,0
50217807,FA2023 ,13500,550,5150,2325,21525,11325,0,11325,10772,15423,0,26195,-1373,6102,-4670,0
50217807,SP2021 ,12625,500,4580,2110,19815,8325,0,8325,3250,11897,0,15147,1228,7918,4668,0
50217807,SP2022 ,13005,515,4810,2220,20550,8325,0,8325,3750,12147,0,15897,1373,8403,4653,0
50217807,SP2023 ,13500,550,5150,2325,21525,8825,0,8825,10772,12922,0,23694,1128,8603,-2169,0
50218862,FA2021 ,12625,500,3740,1080,17945,5125,0,5125,NULL,6625,0,6625,6500,11320,11320,0
50218862,FA2022 ,13005,515,3855,2220,19595,5125,0,5125,NULL,5125,0,5125,8395,14470,14470,0
50218862,SP2021 ,12625,500,3740,1080,17945,5125,0,5125,NULL,5125,0,5125,8000,12820,12820,0
50218863,FA2021 ,12625,500,3740,2110,18975,9125,7125,2000,NULL,10625,0,10625,2500,8350,8350,5267
50218863,FA2022 ,13005,515,5080,1140,19740,7125,7125,0,NULL,7125,0,7125,6395,12615,12615,5267
50218863,FA2024 ,14750,600,4780,2450,22580,7125,7125,0,NULL,7125,0,7125,8225,15455,15455,5267
50218863,SP2021 ,12625,500,3740,2110,18975,7125,7125,0,NULL,7125,0,7125,6000,11850,11850,5267
50218863,SP2022 ,13005,515,5420,NULL,18940,7125,7125,0,NULL,7125,0,7125,6395,11815,11815,5267
50218863,SP2024 ,14750,600,4780,2450,22580,7125,7125,0,NULL,7125,0,7125,8225,15455,15455,5267
50222331,FA2021 ,12625,500,4580,2110,19815,5250,5250,0,NULL,6250,0,6250,6875,13565,13565,0
50222331,FA2022 ,13005,515,4610,1140,19270,5250,5250,0,NULL,5250,0,5250,8270,14020,14020,0
50222331,FA2023 ,13500,550,5440,1200,20690,6250,5250,1000,NULL,6250,0,6250,7800,14440,14440,0
50222331,SP2021 ,12625,500,4580,2110,19815,5250,5250,0,NULL,5250,0,5250,7875,14565,14565,0
50222331,SP2022 ,13005,515,4610,1140,19270,5250,5250,0,NULL,5250,0,5250,8270,14020,14020,0
50222522,FA2021 ,12625,500,4580,2110,19815,6000,4000,2000,NULL,7000,0,7000,6125,12815,12815,225
50222522,FA2023 ,13500,550,4000,2325,20375,4000,4000,0,NULL,4000,0,4000,10050,16375,16375,225
50222522,SP2023 ,13500,550,4000,2325,20375,4000,4000,0,NULL,4000,0,4000,10050,16375,16375,225
50223098,FA2021 ,12625,500,3740,2110,18975,9750,7750,2000,NULL,10750,0,10750,2375,8225,8225,0
50223098,FA2022 ,13005,515,3855,2220,19595,7250,7250,0,NULL,7250,0,7250,6270,12345,12345,0
50223098,FA2023 ,13500,550,4000,2325,20375,8250,8250,0,NULL,8250,0,8250,5800,12125,12125,0
50223098,FA2024 ,14750,7250,7250,NULL,22000,8250,8250,0,NULL,8250,0,8250,13750,13750,13750,0
50223098,SP2021 ,12625,500,3740,2110,18975,7750,7750,0,NULL,7750,0,7750,5375,11225,11225,0
50223098,SP2022 ,13005,515,3855,2220,19595,7250,7250,0,NULL,7250,0,7250,6270,12345,12345,0
50223098,SP2023 ,13500,550,4000,2325,20375,7750,7750,0,NULL,7750,0,7750,6300,12625,12625,0
50223098,SP2024 ,14750,600,4200,2450,22000,8250,8250,0,NULL,8250,0,8250,7100,13750,13750,0
50223104,FA2021 ,12625,500,3740,2110,18975,7500,5500,2000,NULL,8500,0,8500,4625,10475,10475,0
50223104,FA2022 ,13005,515,5080,NULL,18600,5000,5000,0,NULL,5000,0,5000,8520,13600,13600,0
50223104,FA2023 ,13500,550,5440,1200,20690,5000,5000,0,NULL,5000,0,5000,9050,15690,15690,0
50223104,FA2024 ,14750,600,5720,NULL,21070,5000,5000,0,NULL,5000,0,5000,10350,16070,16070,0
50223104,SP2021 ,12625,500,3740,2110,18975,5500,5500,0,NULL,5500,0,5500,7625,13475,13475,0
50223104,SP2022 ,13005,515,5080,NULL,18600,5000,5000,0,NULL,5000,0,5000,8520,13600,13600,0
50223104,SP2023 ,13500,550,5440,NULL,19490,5000,5000,0,NULL,5000,0,5000,9050,14490,14490,0
50223104,SP2024 ,14750,600,5720,NULL,21070,5000,5000,0,NULL,5000,0,5000,10350,16070,16070,0
50225933,FA2022 ,13005,515,3855,2220,19595,9500,9500,0,NULL,9500,0,9500,4020,10095,10095,9888
50225933,SP2022 ,13005,515,3855,2220,19595,11500,9500,2000,NULL,11500,0,11500,2020,8095,8095,9888
50225933,SP2024 ,14750,600,4200,2450,22000,11500,7000,4500,NULL,11500,0,11500,3850,10500,10500,9888
50226586,FA2022 ,13005,515,3855,2220,19595,5000,5000,0,NULL,5000,0,5000,8520,14595,14595,0
50226586,FA2023 ,13500,550,5440,1200,20690,7000,5950,1050,NULL,7000,0,7000,7050,13690,13690,0
50226586,SP2022 ,13005,515,3855,2220,19595,5000,5000,0,NULL,5000,0,5000,8520,14595,14595,0
50226586,SP2023 ,13500,550,5440,1200,20690,7000,5950,1050,NULL,7000,0,7000,7050,13690,13690,0
50226701,FA2022 ,14269,7231,7231,NULL,21500,0,0,0,NULL,0,0,0,21500,21500,21500,0
50226912,FA2022 ,13005,515,3855,2220,19595,10000,10000,0,NULL,10000,0,10000,3520,9595,9595,0
50226912,FA2023 ,13500,550,5440,1200,20690,10000,10000,0,NULL,10000,0,10000,4050,10690,10690,0
50226912,SP2022 ,13005,515,3855,2220,19595,10000,10000,0,NULL,10000,0,10000,3520,9595,9595,0
50226912,SP2023 ,13500,550,5440,1200,20690,10000,10000,0,NULL,10000,0,10000,4050,10690,10690,0
50228040,FA2023 ,13500,550,5150,2325,21525,11500,1000,10500,2750,13500,0,16250,550,8025,5275,0
50228040,FA2024 ,14750,600,5410,1270,22030,9500,0,9500,2230,11000,0,13230,4350,11030,8800,0
50228040,SP2023 ,13500,550,5150,2325,21525,9500,0,9500,2750,9500,0,12250,4550,12025,9275,0
50228040,SP2024 ,14750,600,5410,1270,22030,9500,0,9500,2230,9500,0,11730,5850,12530,10300,0
50232262,FA2024 ,14750,600,5410,2450,23210,8000,8000,0,17891,8370,0,26261,6980,14840,-3051,-3608
50232262,SP2024 ,14750,600,5410,2450,23210,8000,8000,0,17890,8370,0,26260,6980,14840,-3050,-3608
50224344,FA2022 ,13005,515,4810,2220,20550,6250,6250,0,15802,6250,0,22052,7270,14300,-1502,-1071
50224344,FA2023 ,13500,550,5150,2325,21525,6250,6250,0,15564,6250,0,21814,7800,15275,-289,-1071
50224344,FA2024 ,14750,600,5030,NULL,20380,6250,6250,0,18962,6250,0,25212,9100,14130,-4832,-1071
50224344,SP2022 ,13005,515,4810,2220,20550,6250,6250,0,15802,6250,0,22052,7270,14300,-1502,-1071
50224344,SP2023 ,13500,550,5150,2325,21525,6250,6250,0,16170,6250,0,22420,7800,15275,-895,-1071
50224344,SP2024 ,14750,600,5030,NULL,20380,6250,6250,0,15192,6250,0,21442,9100,14130,-1062,-1071
50219441,FA2021 ,12625,500,4580,2110,19815,4825,4700,125,15870,7575,0,23445,5550,12240,-3630,-3352
50219441,FA2022 ,13005,515,3855,1140,18515,6075,0,6075,13750,7275,0,21025,6245,11240,-2510,-3352
50219441,FA2023 ,13500,550,4790,1200,20040,6075,0,6075,15526,7275,0,22801,6775,12765,-2761,-3352
50219441,FA2024 ,8140,300,NULL,1270,9710,2525,0,2525,7750,5223,0,12973,3217,4487,-3263,-3352
50219441,SP2021 ,12625,500,3740,2110,18975,4825,4700,125,15870,6075,0,21945,7050,12900,-2970,-3352
50219441,SP2022 ,13005,515,3855,1140,18515,6075,0,6075,13750,6075,0,19825,7445,12440,-1310,-3352
50219441,SP2023 ,13500,550,4790,1200,20040,6075,0,6075,16666,6075,0,22741,7975,13965,-2701,-3352
50219441,SP2024 ,8140,300,NULL,2450,10890,2525,0,2525,6250,5222,0,11472,3218,5668,-582,-3352
50217993,FA2021 ,12625,500,NULL,2110,15235,6675,6675,0,10250,9425,0,19675,3700,5810,-4440,-1720
50217993,FA2022 ,13005,515,NULL,2220,15740,7925,6625,1300,3750,7925,0,11675,5595,7815,4065,-1720
50217993,FA2023 ,13500,550,NULL,2325,16375,6675,5375,1300,7250,7925,0,15175,6125,8450,1200,-1720
50217993,FA2024 ,14750,600,NULL,2450,17800,7925,0,7925,9000,7925,0,16925,7425,9875,875,-1720
50217993,SP2021 ,12625,500,NULL,2110,15235,6675,6675,0,10250,7925,0,18175,5200,7310,-2940,-1720
50217993,SP2022 ,13005,515,NULL,2220,15740,7925,6625,1300,11250,7925,0,19175,5595,7815,-3435,-1720
50217993,SP2023 ,13500,550,NULL,2325,16375,6675,5375,1300,10750,7925,0,18675,6125,8450,-2300,-1720
50217993,SP2024 ,14750,600,NULL,2450,17800,7925,0,7925,11800,7925,0,19725,7425,9875,-1925,-1720
50225073,FA2022 ,13005,515,4810,2220,20550,7500,7500,0,NULL,7500,0,7500,6020,13050,13050,15
50225073,FA2023 ,13500,550,4000,2325,20375,7500,7500,0,NULL,7500,0,7500,6550,12875,12875,15
50225073,FA2024 ,14750,600,4200,2450,22000,7500,7500,0,NULL,7500,0,7500,7850,14500,14500,15
50225073,SP2022 ,13005,515,4810,2220,20550,7500,7500,0,NULL,7500,0,7500,6020,13050,13050,15
50225073,SP2023 ,13500,550,4000,2325,20375,7500,7500,0,NULL,7500,0,7500,6550,12875,12875,15
50225073,SP2024 ,14750,600,4200,2450,22000,7500,7500,0,NULL,7500,0,7500,7850,14500,14500,15
50233752,FA2024 ,14750,600,4790,2450,22590,6800,6800,0,4750,6800,0,11550,8550,15790,11040,7479.33
50233752,SP2024 ,14750,600,4790,2450,22590,6800,6800,0,4750,6800,0,11550,8550,15790,11040,7479.33
50222229,FA2021 ,12625,500,3740,2110,18975,4500,4500,0,2750,5500,0,8250,7625,13475,10725,4296
50222229,FA2023 ,13500,550,4000,1200,19250,4000,4000,0,3250,4000,0,7250,10050,15250,12000,4296
50222229,FA2024 ,14750,600,4790,2450,22590,4000,0,4000,3750,4620,0,8370,10730,17970,14220,4296
50222229,SP2021 ,12625,500,3740,2110,18975,4900,4500,400,2750,4900,0,7650,8225,14075,11325,4296
50222229,SP2022 ,13005,515,4380,2220,20120,4600,4000,600,3250,4600,0,7850,8920,15520,12270,4296
50222229,SP2023 ,13500,550,4000,1200,19250,4000,4000,0,3250,4000,0,7250,10050,15250,12000,4296
50222229,SP2024 ,14750,600,4790,1270,21410,4000,0,4000,3750,4620,0,8370,10730,16790,13040,4296
50232501,FA2024 ,14750,600,4200,2450,22000,10750,10750,0,2750,11120,0,13870,4230,10880,8130,2719.32
50232501,SP2024 ,14750,600,4200,2450,22000,10750,10750,0,2750,11120,0,13870,4230,10880,8130,2719.32
50235016,FA2024 ,14750,600,4200,2450,22000,12081,10081,2000,5250,15779,0,21029,-429,6221,971,-1041.07
50235016,SP2024 ,14750,600,4200,2450,22000,10080,10080,0,5250,14777,0,20027,573,7223,1973,-1041.07
50203628,FA2021 ,12625,500,NULL,1080,14205,5675,5325,350,3750,7175,0,10925,5950,7030,3280,0
50203628,SP2021 ,12625,500,NULL,1080,14205,5675,5325,350,16280,5675,0,21955,7450,8530,-7750,0
50232951,FA2024 ,14750,600,4200,2680,22230,6500,6500,0,0,6500,0,6500,8850,15730,15730,3152
50226953,FA2023 ,13500,550,4000,2325,20375,8500,8500,0,2750,8500,0,11250,5550,11875,9125,0
50226953,FA2024 ,14750,600,4200,2450,22000,8000,8000,0,3250,8000,0,11250,7350,14000,10750,0
50226953,SP2023 ,13500,550,4000,2325,20375,8500,8500,0,2750,8500,0,11250,5550,11875,9125,0
50226953,SP2024 ,14750,600,4200,2450,22000,8000,8000,0,3250,8000,0,11250,7350,14000,10750,0
50210090,FA2021 ,12625,500,3740,1080,17945,4225,450,3775,14910,8347,0,23257,4778,9598,-5312,0
50210090,SP2021 ,5200,250,NULL,NULL,5450,937,0,937,3750,1964,0,5714,3486,3486,-264,0
50210253,FA2021 ,12625,500,4580,2110,19815,0,0,0,17906,0,0,17906,13125,19815,1909,0
50210253,FA2022 ,13005,515,4260,2220,20000,0,0,0,21310,0,0,21310,13520,20000,-1310,0
50210253,SP2021 ,12625,500,4580,2110,19815,0,0,0,20000,0,0,20000,13125,19815,-185,0
50210253,SP2022 ,13005,515,4260,2220,20000,0,0,0,18610,0,0,18610,13520,20000,1390,0
50235098,FA2024 ,14750,600,4790,2450,22590,10528,10528,0,13666,10528,0,24194,4822,12062,-1604,388
50235098,SP2024 ,14750,600,4790,2450,22590,10528,10528,0,11150,10528,0,21678,4822,12062,912,388
50226015,FA2022 ,13005,515,4810,2220,20550,9100,7100,2000,2750,14423,0,17173,-903,6127,3377,-1449.77
50226015,FA2023 ,13500,550,5150,2325,21525,8050,550,7500,8471,11823,0,20294,2227,9702,1231,-1449.77
50226015,FA2024 ,14750,600,5030,1270,21650,8600,500,8100,3250,17447,0,20697,-2097,4203,953,-1449.77
50226015,SP2022 ,13005,515,4810,2220,20550,8100,7100,1000,9015,9422,0,18437,4098,11128,2113,-1449.77
50226015,SP2023 ,13500,550,5150,2325,21525,8050,550,7500,8471,11822,0,20293,2228,9703,1232,-1449.77
50226015,SP2024 ,14750,600,5030,1270,21650,8600,500,8100,3250,17494,0,20744,-2144,4156,906,-1449.77
50232009,FA2024 ,14750,600,5410,2450,23210,6750,6750,0,2750,6750,0,9500,8600,16460,13710,0
50232009,SP2024 ,14750,600,5410,2450,23210,6750,6750,0,2750,6750,0,9500,8600,16460,13710,0
50226220,FA2022 ,13005,515,3855,2220,19595,12050,10050,2000,2750,16673,0,19423,-3153,2922,172,-2823.7
50226220,FA2023 ,13500,550,4000,2325,20375,10550,8550,2000,3250,21198,0,24448,-7148,-823,-4073,-2823.7
50226220,FA2024 ,14750,600,4200,2450,22000,12550,7000,5550,3750,16648,0,20398,-1298,5352,1602,-2823.7
50226220,SP2022 ,13005,515,3855,2220,19595,10050,10050,0,2750,18762,0,21512,-5242,833,-1917,-2823.7
50226220,SP2023 ,13500,550,4000,2325,20375,10550,10550,0,3250,15222,0,18472,-1172,5153,1903,-2823.7
50226220,SP2024 ,14750,600,4200,2450,22000,10050,7000,3050,3750,17647,0,21397,-2297,4353,603,-2823.7
50227226,FA2022 ,13005,515,3855,2220,19595,4500,4500,0,5750,7948,0,13698,5572,11647,5897,0
50227226,FA2023 ,13500,550,4000,2325,20375,4500,4500,0,11435,8598,0,20033,5452,11777,342,0
50227226,SP2022 ,13005,515,3855,2220,19595,4500,4500,0,5750,7947,0,13697,5573,11648,5898,0
50227226,SP2023 ,13500,550,4000,2325,20375,4500,4500,0,11436,8597,0,20033,5453,11778,342,0
50225074,FA2022 ,13005,515,4810,2220,20550,5750,5750,0,NULL,5750,0,5750,7770,14800,14800,0
50225074,SP2022 ,13005,515,4810,2220,20550,5750,5750,0,NULL,5750,0,5750,7770,14800,14800,0
50231645,FA2024 ,14750,600,5410,2450,23210,9500,0,9500,NULL,9500,0,9500,5850,13710,13710,0
50231645,SP2024 ,14750,600,5410,2450,23210,9500,0,9500,NULL,9500,0,9500,5850,13710,13710,0
50229481,FA2023 ,13500,550,4000,2325,20375,5000,5000,0,2750,5000,0,7750,9050,15375,12625,0
50229481,SP2023 ,13500,550,4000,2325,20375,5000,5000,0,1375,5000,0,6375,9050,15375,14000,0
50229945,FA2023 ,4050,165,2658,697,7570,2325,2325,0,11158,2325,0,13483,1890,5245,-5913,0
50206098,FA2021 ,12625,500,3740,1080,17945,6000,6000,0,0,7000,0,7000,6125,10945,10945,0
50206098,FA2022 ,2600,103,450,228,3381,1100,1100,0,0,1100,0,1100,1603,2281,2281,0
50204097,FA2021 ,12625,500,4830,1080,19035,7850,7850,0,6750,9350,0,16100,3775,9685,2935,0
50204097,SP2021 ,12625,500,4830,1080,19035,7850,7850,0,3750,7850,0,11600,5275,11185,7435,0
50229751,FA2023 ,13500,550,5150,2745,21945,7000,7000,0,14500,7000,0,21500,7050,14945,445,15
50229751,FA2024 ,14750,600,5410,2900,23660,7000,7000,0,0,7000,0,7000,8350,16660,16660,15
50229751,SP2023 ,13500,550,5150,2745,21945,7000,7000,0,0,7000,0,7000,7050,14945,14945,15
50229751,SP2024 ,14750,600,5410,2450,23210,7000,7000,0,16565,7000,0,23565,8350,16210,-355,15
50216153,FA2021 ,12625,500,4580,2110,19815,8625,7825,800,4750,11375,0,16125,1750,8440,3690,10224.83
50216153,FA2022 ,13005,515,4260,2220,20000,9875,9075,800,5750,11802,0,17552,1718,8198,2448,10224.83
50216153,FA2023 ,13500,550,4790,1200,20040,9875,8575,1300,NULL,9875,0,9875,4175,10165,10165,10224.83
50216153,FA2024 ,14750,600,5030,1270,21650,9875,9075,800,NULL,9875,0,9875,5475,11775,11775,10224.83
50216153,SP2021 ,12625,500,4580,2110,19815,8625,7825,800,4750,9875,0,14625,3250,9940,5190,10224.83
50216153,SP2022 ,13005,515,4260,2220,20000,9875,9075,800,5750,11803,0,17553,1717,8197,2447,10224.83
50216153,SP2023 ,7450,550,4790,1200,13990,5449,5008,441,NULL,5449,0,5449,2551,8541,8541,10224.83
50216153,SP2024 ,14750,600,NULL,NULL,15350,4621,4180,441,NULL,4621,0,4621,10729,10729,10729,10224.83
50205704,FA2021 ,12625,500,4830,1080,19035,0,0,0,3750,14125,12625,17875,-1000,4910,1160,0
50205704,SP2021 ,12625,500,4830,NULL,17955,0,0,0,3750,12625,12625,16375,500,5330,1580,0
50204489,FA2021 ,12625,500,4270,NULL,17395,1925,1925,0,3750,2925,0,6675,10200,14470,10720,0
50231342,SP2024 ,14750,600,5410,2450,23210,7000,7000,0,2750,7000,0,9750,8350,16210,13460,-82
50205312,FA2021 ,12625,500,4270,1080,18475,5175,5175,0,6750,6675,0,13425,6450,11800,5050,0
50205312,SP2021 ,12625,500,4270,1080,18475,5175,5175,0,11050,5175,0,16225,7950,13300,2250,0
50205795,FA2021 ,12625,500,4830,NULL,17955,5250,5250,0,0,11523,0,11523,1602,6432,6432,0
50205795,SP2021 ,6960,500,4830,1080,13370,5583,3583,2000,0,7219,0,7219,241,6151,6151,0
50226901,FA2024 ,14750,600,4200,2450,22000,9000,9000,0,2750,10000,0,12750,5350,12000,9250,2489.32
50226901,SP2024 ,14750,600,4200,2450,22000,9000,9000,0,2750,11000,0,13750,4350,11000,8250,2489.32
50208995,FA2021 ,12625,500,4470,1080,18675,4325,0,4325,3750,5825,0,9575,7300,12850,9100,0
50208995,FA2022 ,13005,515,4610,NULL,18130,5325,0,5325,3750,5325,0,9075,8195,12805,9055,0
50208995,SP2021 ,12625,500,4470,1080,18675,4325,0,4325,3500,4325,0,7825,8800,14350,10850,0
50208995,SP2022 ,13005,515,4610,NULL,18130,5325,0,5325,3750,5325,0,9075,8195,12805,9055,0
50209944,FA2021 ,12625,500,4270,NULL,17395,0,0,0,NULL,0,0,0,13125,17395,17395,0
50209944,FA2022 ,13005,515,4610,NULL,18130,0,0,0,NULL,0,0,0,13520,18130,18130,0
50209944,SP2021 ,12625,500,4270,NULL,17395,0,0,0,NULL,0,0,0,13125,17395,17395,0
50209944,SP2022 ,7170,257,NULL,NULL,7427,0,0,0,NULL,0,0,0,7427,7427,7427,0
50208997,FA2021 ,19340,860,4600,1080,25020,9850,9850,0,15803,11350,0,27153,8850,13670,-2133,0
50208997,FA2022 ,13005,6590,6590,NULL,19595,750,750,0,19857,750,0,20607,18845,18845,-1012,0
50208997,SP2021 ,19340,860,4600,2110,26050,9850,9850,0,15803,9850,0,25653,10350,16200,397,0
50208997,SP2022 ,19910,890,5150,1140,26200,9850,9850,0,17254,9850,0,27104,10950,16350,-904,0
50193805,FA2022 ,13005,515,3855,1140,18515,9000,7000,2000,NULL,9000,0,9000,4520,9515,9515,0
50193805,FA2023 ,13500,550,4000,2325,20375,10000,7000,3000,NULL,10000,0,10000,4050,10375,10375,0
50193805,SP2022 ,13005,515,3855,1140,18515,7000,7000,0,NULL,7000,0,7000,6520,11515,11515,0
50209811,FA2021 ,12625,500,4270,NULL,17395,0,0,0,8750,7813,6313,16563,5312,9582,832,0
50209811,FA2022 ,13005,515,NULL,NULL,13520,0,0,0,3750,9754,9754,13504,3766,3766,16,0
50209811,SP2021 ,12625,500,4270,NULL,17395,0,0,0,13750,6312,6312,20062,6813,11083,-2667,0
50209811,SP2022 ,13005,515,NULL,NULL,13520,0,0,0,3750,9754,9754,13504,3766,3766,16,0
50222941,FA2023 ,13500,550,4000,2325,20375,0,0,0,7750,13500,13500,21250,550,6875,-875,-1799
50222941,FA2024 ,14750,600,5720,1270,22340,0,0,0,8250,14750,14750,23000,600,7590,-660,-1799
50222941,SP2023 ,13500,550,4000,2325,20375,0,0,0,7750,13500,13500,21250,550,6875,-875,-1799
50222941,SP2024 ,14750,600,5720,1270,22340,0,0,0,8250,14750,14750,23000,600,7590,-660,-1799
50225514,FA2022 ,13005,515,NULL,NULL,13520,0,0,0,2750,9754,9754,12504,3766,3766,1016,-946
50225514,FA2023 ,13500,550,5150,2325,21525,0,0,0,7973,13500,13500,21473,550,8025,52,-946
50225514,FA2024 ,14750,600,4200,2450,22000,0,0,0,8750,14750,14750,23500,600,7250,-1500,-946
50225514,SP2021 ,12625,500,NULL,NULL,13125,0,0,0,8000,6313,6313,14313,6812,6812,-1188,-946
50225514,SP2022 ,7170,257,NULL,NULL,7427,0,0,0,2750,5378,5378,8128,2049,2049,-701,-946
50225514,SP2023 ,13500,550,5440,1200,20690,0,0,0,7974,13500,13500,21474,550,7190,-784,-946
50209503,FA2021 ,12625,500,3740,2550,19415,7575,6075,1500,3750,13198,0,16948,-73,6217,2467,0
50209503,FA2022 ,13005,6590,6590,NULL,19595,5750,3750,2000,3750,8823,0,12573,10772,10772,7022,0
50209503,SP2021 ,12625,500,3740,2550,19415,9575,6075,3500,3750,13197,0,16947,-72,6218,2468,0
50209503,SP2022 ,13005,515,5080,2690,21290,6825,6825,0,3750,9897,0,13647,3623,11393,7643,0
50228775,FA2023 ,13500,550,5150,2325,21525,6000,6000,0,NULL,6000,0,6000,8050,15525,15525,40
50228775,FA2024 ,14750,600,5410,2450,23210,6000,6000,0,NULL,6000,0,6000,9350,17210,17210,40
50228775,SP2023 ,13500,550,5150,2325,21525,6000,6000,0,NULL,6000,0,6000,8050,15525,15525,40
50228775,SP2024 ,14750,600,5410,2450,23210,6000,6000,0,NULL,6000,0,6000,9350,17210,17210,40
50066203,FA2021 ,19340,860,4600,2110,26050,12250,12250,0,NULL,14000,0,14000,6200,12050,12050,0
50066203,FA2022 ,19910,890,4745,2220,26875,12250,12250,0,NULL,14000,0,14000,6800,12875,12875,0
50066203,SP2021 ,19340,860,4600,2110,26050,12250,12250,0,NULL,12250,0,12250,7950,13800,13800,0
50066203,SP2022 ,19910,890,4745,2220,26875,12250,12250,0,NULL,12250,0,12250,8550,14625,14625,0
50228560,FA2023 ,13500,550,4000,2325,20375,10950,8950,2000,5750,12823,0,18573,1227,7552,1802,0
50228560,FA2024 ,14750,600,4200,2450,22000,10950,7000,3950,3250,13820,0,17070,1530,8180,4930,0
50228560,SP2023 ,13500,550,4000,2325,20375,8950,8950,0,4780,10822,0,15602,3228,9553,4773,0
50228560,SP2024 ,14750,600,4200,2450,22000,8950,7000,1950,3250,10320,0,13570,5030,11680,8430,0
50228498,FA2023 ,13500,550,4000,2535,20585,9500,7000,2500,2750,16198,0,18948,-2148,4387,1637,1675.33
50228498,FA2024 ,14750,600,4200,2680,22230,9000,7000,2000,3250,15698,0,18948,-348,6532,3282,1675.33
50228498,SP2023 ,13500,550,4000,2325,20375,7500,7000,500,2750,12697,0,15447,1353,7678,4928,1675.33
50228498,SP2024 ,14750,600,4200,2450,22000,7000,7000,0,3250,12197,0,15447,3153,9803,6553,1675.33
50228868,FA2023 ,13500,550,4560,2325,20935,7000,7000,0,2750,9500,0,12250,4550,11435,8685,0
50228868,FA2024 ,14750,600,5720,2450,23520,7000,6000,1000,3250,12500,0,15750,2850,11020,7770,0
50228868,SP2023 ,13500,550,4560,2325,20935,7000,7000,0,2750,9500,0,12250,4550,11435,8685,0
50228868,SP2024 ,14750,600,5720,2450,23520,7000,6000,1000,3250,7000,0,10250,8350,16520,13270,0
50233569,FA2024 ,14750,600,4790,2450,22590,10900,10900,0,11675,10900,0,22575,4450,11690,15,0
50233569,SP2024 ,14750,600,4790,2450,22590,10900,10900,0,11675,10900,0,22575,4450,11690,15,0
50221041,FA2023 ,14500,7000,7000,NULL,21500,0,0,0,NULL,0,0,0,21500,21500,21500,0
50204312,FA2021 ,12625,500,3740,2110,18975,925,0,925,3750,1925,0,5675,11200,17050,13300,0
50204312,FA2022 ,13005,515,3855,2220,19595,1175,250,925,3750,1175,0,4925,12345,18420,14670,0
50204312,SP2021 ,12625,500,3740,2110,18975,925,0,925,3750,925,0,4675,12200,18050,14300,0
50217218,FA2021 ,12625,500,NULL,NULL,13125,1925,1925,0,NULL,3425,0,3425,9700,9700,9700,0
50217218,FA2022 ,13005,515,3855,2220,19595,3425,30,3395,NULL,3425,0,3425,10095,16170,16170,0
50217218,FA2023 ,13500,550,5150,2325,21525,3425,30,3395,NULL,3425,0,3425,10625,18100,18100,0
50217218,SP2021 ,12625,500,4580,2110,19815,1925,1925,0,NULL,1925,0,1925,11200,17890,17890,0
50217218,SP2022 ,13005,515,3855,2220,19595,3425,30,3395,NULL,3425,0,3425,10095,16170,16170,0
50217218,SP2023 ,14380,550,5150,2325,22405,3425,30,3395,NULL,3425,0,3425,11505,18980,18980,0
50222974,FA2021 ,13866,6974,6974,NULL,20840,0,0,0,NULL,0,0,0,20840,20840,20840,0
50203153,FA2021 ,12625,500,NULL,NULL,13125,675,675,0,0,6773,0,6773,6352,6352,6352,0
50203153,FA2022 ,13005,515,NULL,NULL,13520,3425,3425,0,NULL,6873,0,6873,6647,6647,6647,0
50203153,SP2021 ,12625,500,NULL,NULL,13125,675,675,0,0,7332,0,7332,5793,5793,5793,0
50203153,SP2022 ,13005,515,NULL,NULL,13520,3425,3425,0,NULL,6872,0,6872,6648,6648,6648,0
50204230,FA2021 ,12625,500,NULL,NULL,13125,4775,0,4775,3750,7648,0,11398,5477,5477,1727,0
50215149,SP2021 ,12625,500,NULL,NULL,13125,0,0,0,0,4347,0,4347,8778,8778,8778,0
50229436,FA2023 ,13500,550,5150,2325,21525,7000,7000,0,2750,7000,0,9750,7050,14525,11775,382.88
50229436,FA2024 ,14750,600,5410,2450,23210,7000,7000,0,3250,7000,0,10250,8350,16210,12960,382.88
50229436,SP2023 ,13500,550,5150,2325,21525,7000,7000,0,2750,7000,0,9750,7050,14525,11775,382.88
50229436,SP2024 ,14750,600,5410,2450,23210,7000,7000,0,3250,7000,0,10250,8350,16210,12960,382.88
50232381,FA2024 ,14750,600,5410,2450,23210,8500,8500,0,0,8500,0,8500,6850,14710,14710,0
50232381,SP2024 ,14750,600,5410,2450,23210,8500,8500,0,0,8500,0,8500,6850,14710,14710,0
50215846,FA2021 ,12625,500,4580,2110,19815,9175,7175,2000,3250,20173,0,23423,-7048,-358,-3608,0
50215846,FA2022 ,13005,515,4810,2220,20550,12675,9925,2750,0,21350,0,21350,-7830,-800,-800,0
50215846,FA2023 ,13500,550,4790,1200,20040,11425,9425,2000,0,20040,0,20040,-5990,0,0,0
50215846,SP2021 ,12625,500,4580,2110,19815,7175,7175,0,3250,13832,0,17082,-707,5983,2733,0
50215846,SP2022 ,13005,515,4810,2220,20550,10175,9425,750,0,19910,0,19910,-6390,640,640,0
50215846,SP2023 ,13500,550,4790,1200,20040,9425,9425,0,0,20324,0,20324,-6274,-284,-284,0
50232818,FA2024 ,14750,600,5410,2450,23210,9000,9000,0,NULL,11500,0,11500,3850,11710,11710,0
50232818,SP2024 ,14750,600,5410,2450,23210,9000,9000,0,NULL,9000,0,9000,6350,14210,14210,0
50223613,FA2021 ,12625,500,4580,2110,19815,21333,21333,0,NULL,21333,0,21333,-8208,-1518,-1518,0
50203619,FA2021 ,12625,500,4270,NULL,17395,0,0,0,18953,500,0,19453,12625,16895,-2058,0
50203619,FA2022 ,13005,515,3855,1140,18515,0,0,0,22168,0,0,22168,13520,18515,-3653,0
50203619,FA2023 ,3720,NULL,NULL,NULL,3720,0,0,0,NULL,924,0,924,2796,2796,2796,0
50203619,SP2021 ,12625,500,4270,NULL,17395,0,0,0,18954,0,0,18954,13125,17395,-1559,0
50203619,SP2022 ,13005,515,3855,1140,18515,0,0,0,20160,0,0,20160,13520,18515,-1645,0
50225741,FA2022 ,13005,515,4810,2220,20550,6000,6000,0,NULL,6000,0,6000,7520,14550,14550,0
50225741,FA2023 ,13500,6825,6825,NULL,20325,1500,1500,0,NULL,1500,0,1500,18825,18825,18825,0
50225741,SP2021 ,12625,500,4050,2110,19285,6500,6500,0,NULL,6500,0,6500,6625,12785,12785,0
50225741,SP2022 ,13005,515,4810,2220,20550,6000,6000,0,NULL,6000,0,6000,7520,14550,14550,0
50225741,SP2023 ,13500,550,5800,NULL,19850,6000,6000,0,NULL,6000,0,6000,8050,13850,13850,0
50228887,FA2023 ,13500,550,4000,2325,20375,8850,6500,2350,2750,13573,0,16323,477,6802,4052,0
50228887,FA2024 ,14750,600,4200,2450,22000,9850,6500,3350,3250,16548,0,19798,-1198,5452,2202,0
50228887,SP2023 ,13500,550,4000,2325,20375,8850,6500,2350,2750,11072,0,13822,2978,9303,6553,0
50228887,SP2024 ,14750,600,4200,2450,22000,9850,6500,3350,3250,13547,0,16797,1803,8453,5203,0
50199836,FA2021 ,6960,500,3740,2110,13310,4715,4215,500,6250,9682,0,15932,-2222,3628,-2622,10198.31
50199836,FA2022 ,13005,515,5420,1140,20080,0,0,0,6625,5097,0,11722,8423,14983,8358,10198.31
50199836,SP2021 ,12625,500,3740,2110,18975,5425,4925,500,8250,11197,0,19447,1928,7778,-472,10198.31
50204483,FA2021 ,12625,500,4270,1080,18475,6675,0,6675,13400,8175,0,21575,4950,10300,-3100,1245
50204483,SP2021 ,15840,500,4270,1080,21690,6675,0,6675,14739,6675,0,21414,9665,15015,276,1245
50220973,FA2021 ,12625,500,4580,2550,20255,8500,8500,0,10000,9500,0,19500,3625,10755,755,0
50220973,FA2022 ,13005,515,4810,2220,20550,8000,8000,0,17329,8000,0,25329,5520,12550,-4779,0
50220973,FA2023 ,13500,6825,6825,NULL,20325,8000,8000,0,17899,10000,0,27899,10325,10325,-7574,0
50220973,SP2021 ,12625,500,4580,2550,20255,8500,8500,0,10000,8500,0,18500,4625,11755,1755,0
50220973,SP2022 ,13005,515,4810,2220,20550,8000,8000,0,14171,8000,0,22171,5520,12550,-1621,0
50220973,SP2023 ,13500,550,5440,24.9,19514.9,8000,8000,0,13601,8000,0,21601,6050,11514.9,-2086.1,0
50232733,FA2024 ,14750,600,5410,2450,23210,6000,6000,0,NULL,6000,0,6000,9350,17210,17210,0
50232733,SP2024 ,14750,600,5410,2450,23210,6000,6000,0,NULL,6000,0,6000,9350,17210,17210,0
50204133,FA2021 ,12625,500,4830,1080,19035,3425,0,3425,3750,4425,0,8175,8700,14610,10860,0
50204133,SP2021 ,12625,500,4830,1080,19035,3425,0,3425,3750,3425,0,7175,9700,15610,11860,0
50215353,FA2021 ,12625,500,3740,2110,18975,4925,4925,0,3250,9665,0,12915,3460,9310,6060,0
50215353,FA2022 ,13005,515,3855,1140,18515,4925,4925,0,3750,6852,0,10602,6668,11663,7913,0
50215353,SP2021 ,12625,500,3740,2110,18975,4925,4925,0,3250,8665,0,11915,4460,10310,7060,0
50215353,SP2022 ,13005,515,3855,1140,18515,4925,4925,0,3750,6853,0,10603,6667,11662,7912,0
50226867,FA2024 ,14750,600,4200,2450,22000,9500,7500,2000,2750,9500,0,12250,5850,12500,9750,0
50226867,SP2024 ,14750,600,4200,2450,22000,9500,7500,2000,2750,9500,0,12250,5850,12500,9750,0
50210208,FA2021 ,12625,500,4580,2110,19815,9725,4725,5000,1785,19578,0,21363,-6453,237,-1548,0
50210208,FA2022 ,13005,515,4610,1140,19270,11125,1400,9725,8235,14972,0,23207,-1452,4298,-3937,0
50210208,SP2021 ,12625,500,4580,2110,19815,9725,4725,5000,1798,17577,0,19375,-4452,2238,440,0
50210208,SP2022 ,13005,515,4610,1140,19270,10625,900,9725,8234,14473,0,22707,-953,4797,-3437,0
50214108,FA2021 ,12625,500,3740,2110,18975,7250,7250,0,7191,12473,0,19664,652,6502,-689,-35.54
50214108,FA2022 ,13005,515,3855,2220,19595,6750,6750,0,8250,13358,0,21608,162,6237,-2013,-35.54
50214108,FA2023 ,13500,550,4550,2325,20925,6750,6750,0,9005,10848,0,19853,3202,10077,1072,-35.54
50214108,FA2024 ,14750,600,4200,2450,22000,7250,7250,0,15125,11348,0,26473,4002,10652,-4473,-35.54
50214108,SP2021 ,12625,500,3740,2110,18975,7250,7250,0,7971,10972,0,18943,2153,8003,32,-35.54
50214108,SP2022 ,13005,515,3855,2220,19595,6750,6750,0,8250,11997,0,20247,1523,7598,-652,-35.54
50214108,SP2023 ,13500,550,4550,2325,20925,6750,6750,0,9005,10847,0,19852,3203,10078,1073,-35.54
50214108,SP2024 ,14750,600,4200,2450,22000,7250,7250,0,12523,11347,0,23870,4003,10653,-1870,-35.54
50220929,FA2021 ,12625,500,4580,2110,19815,9500,0,9500,2750,22500,0,25250,-9375,-2685,-5435,0
50220929,FA2022 ,13005,515,4810,2220,20550,10000,500,9500,NULL,16000,0,16000,-2480,4550,4550,0
50220929,FA2023 ,13500,550,4790,1200,20040,9550,0,9550,NULL,21550,0,21550,-7500,-1510,-1510,0
50220929,FA2024 ,14750,7250,7250,NULL,22000,3000,0,3000,NULL,15000,0,15000,7000,7000,7000,0
50220929,SP2021 ,12625,500,4580,2110,19815,9800,300,9500,2750,9800,0,12550,3325,10015,7265,0
50220929,SP2022 ,13005,515,4810,2220,20550,10000,500,9500,NULL,16000,0,16000,-2480,4550,4550,0
50220929,SP2023 ,13500,550,4790,1200,20040,9500,0,9500,NULL,10450,0,10450,3600,9590,9590,0
50220929,SP2024 ,14750,600,4790,1270,21410,9500,0,9500,NULL,9500,0,9500,5850,11910,11910,0
50222683,FA2021 ,12625,500,4580,2110,19815,9450,7450,2000,2750,14198,0,16948,-1073,5617,2867,0
50216973,FA2021 ,12625,500,4580,2110,19815,6675,6675,0,13500,8175,0,21675,4950,11640,-1860,8705
50216973,FA2022 ,13005,515,5080,1140,19740,6675,6675,0,13750,6675,0,20425,6845,13065,-685,8705
50216973,FA2023 ,13500,550,5440,1200,20690,6675,0,6675,14945,6675,0,21620,7375,14015,-930,8705
50216973,FA2024 ,8140,300,NULL,NULL,8440,2856,0,2856,3750,2856,0,6606,5584,5584,1834,8705
50216973,SP2021 ,12625,500,4580,2110,19815,6675,6675,0,13500,6675,0,20175,6450,13140,-360,8705
50216973,SP2022 ,13005,515,5080,1140,19740,6675,6675,0,17750,6675,0,24425,6845,13065,-4685,8705
50216973,SP2023 ,13500,550,5440,1200,20690,6675,0,6675,12050,6675,0,18725,7375,14015,1965,8705
50216973,SP2024 ,8140,300,NULL,NULL,8440,0,0,0,2229,0,0,2229,8440,8440,6211,8705
50234551,FA2024 ,14750,600,5720,1270,22340,5500,5500,0,18750,5500,0,24250,9850,16840,-1910,-131
50234551,SP2024 ,14750,600,5720,1270,22340,5500,5500,0,18750,5500,0,24250,9850,16840,-1910,-131
50204311,FA2021 ,12625,6350,6350,NULL,18975,7675,5950,1725,3750,9175,0,12925,9800,9800,6050,0
50204311,SP2021 ,12625,500,4580,2110,19815,8675,5950,2725,3750,8675,0,12425,4450,11140,7390,0
50203952,FA2021 ,12625,500,4830,1080,19035,5425,0,5425,NULL,5425,0,5425,7700,13610,13610,0
50203952,SP2021 ,12625,500,4830,1080,19035,5425,0,5425,NULL,5425,0,5425,7700,13610,13610,0
50209033,FA2021 ,12625,500,5160,1080,19365,925,925,0,3750,2425,0,6175,10700,16940,13190,0
50209033,FA2022 ,13005,515,5080,1140,19740,925,925,0,3750,925,0,4675,12595,18815,15065,0
50209033,SP2021 ,12625,500,5160,1080,19365,925,925,0,3750,925,0,4675,12200,18440,14690,0
50209033,SP2022 ,13005,515,5080,1140,19740,925,925,0,3750,925,0,4675,12595,18815,15065,0
50224558,FA2022 ,13005,515,3855,2220,19595,0,0,0,2750,13578,13005,16328,-58,6017,3267,2300.5
50224558,FA2023 ,13500,550,4000,2325,20375,0,0,0,3250,13500,13500,16750,550,6875,3625,2300.5
50224558,FA2024 ,14750,7250,7250,NULL,22000,7900,6900,1000,3250,7900,0,11150,14100,14100,10850,2300.5
50224558,SP2022 ,13005,515,3855,2220,19595,0,0,0,2750,13577,13005,16327,-57,6018,3268,2300.5
50224558,SP2023 ,13500,550,4000,2325,20375,0,0,0,3250,13500,13500,16750,550,6875,3625,2300.5
50224558,SP2024 ,14750,600,5720,1270,22340,0,0,0,3250,14750,14750,18000,600,7590,4340,2300.5
50229057,FA2023 ,13500,550,4000,2325,20375,9000,9000,0,2750,9000,0,11750,5050,11375,8625,0
50229057,FA2024 ,14750,600,5410,2450,23210,9000,9000,0,0,9000,0,9000,6350,14210,14210,0
50229057,SP2023 ,13500,550,4000,2325,20375,9000,9000,0,2750,9000,0,11750,5050,11375,8625,0
50229057,SP2024 ,14750,600,5410,2450,23210,9000,9000,0,3250,9000,0,12250,6350,14210,10960,0
50212187,FA2021 ,12625,500,NULL,NULL,13125,6925,6925,0,NULL,8425,0,8425,4700,4700,4700,0
50212187,FA2022 ,13005,515,NULL,NULL,13520,6925,5815,1110,NULL,6925,0,6925,6595,6595,6595,0
50212187,FA2023 ,13500,550,NULL,NULL,14050,9425,6925,2500,NULL,9425,0,9425,4625,4625,4625,0
50212187,FA2024 ,8140,300,NULL,NULL,8440,7322,0,7322,NULL,7322,0,7322,1118,1118,1118,0
50212187,SP2021 ,12625,500,NULL,NULL,13125,11925,6925,5000,NULL,11925,0,11925,1200,1200,1200,0
50212187,SP2022 ,13005,515,NULL,NULL,13520,13925,5815,8110,NULL,13925,0,13925,-405,-405,-405,0
50212187,SP2023 ,13500,550,NULL,NULL,14050,10425,6925,3500,NULL,10425,0,10425,3625,3625,3625,0
50225177,FA2022 ,13005,515,4810,2220,20550,8000,8000,0,2750,8000,0,10750,5520,12550,9800,0
50225177,SP2022 ,13005,515,4810,2220,20550,8000,8000,0,2750,8000,0,10750,5520,12550,9800,0
50230360,FA2023 ,13500,550,5150,2745,21945,7550,7550,0,2750,11123,0,13873,2927,10822,8072,0
50230360,SP2023 ,2700,110,1545,549,4904,1510,1510,0,0,2076,0,2076,734,2828,2828,0
50204801,FA2021 ,12625,500,4580,2550,20255,0,0,0,3750,1500,0,5250,11625,18755,15005,0
50204801,SP2021 ,12625,500,NULL,NULL,13125,0,0,0,3750,0,0,3750,13125,13125,9375,0
50222062,FA2021 ,12625,500,4580,2110,19815,10000,9000,1000,2750,10000,0,12750,3125,9815,7065,0
50222062,FA2022 ,13005,515,4810,2220,20550,8250,8250,0,3750,8250,0,12000,5270,12300,8550,0
50222062,FA2023 ,13500,550,4790,NULL,18840,9250,8750,500,3750,9250,0,13000,4800,9590,5840,0
50222062,SP2021 ,12625,500,4580,2110,19815,10000,9000,1000,2750,10000,0,12750,3125,9815,7065,0
50222062,SP2022 ,13005,515,4810,2220,20550,8250,8250,0,3750,8250,0,12000,5270,12300,8550,0
50222062,SP2023 ,13500,550,4790,NULL,18840,9250,8750,500,3750,9250,0,13000,4800,9590,5840,0
50229777,FA2023 ,13500,550,5150,2325,21525,8750,6500,2250,2750,12923,0,15673,1127,8602,5852,4549.33
50229777,FA2024 ,14750,600,5410,2450,23210,9250,7000,2250,3250,13848,0,17098,1502,9362,6112,4549.33
50229777,SP2023 ,13500,550,5150,2325,21525,8750,6500,2250,2750,12922,0,15672,1128,8603,5853,4549.33
50229777,SP2024 ,14750,600,5410,2450,23210,9250,7000,2250,3250,13847,0,17097,1503,9363,6113,4549.33
50221815,FA2021 ,12625,500,4580,2110,19815,6000,6000,0,2750,6000,0,8750,7125,13815,11065,0
50221815,FA2022 ,13005,515,4810,2220,20550,6000,6000,0,3250,6000,0,9250,7520,14550,11300,0
50221815,SP2021 ,12625,500,4580,2110,19815,6000,6000,0,2750,6000,0,8750,7125,13815,11065,0
50221815,SP2022 ,13005,515,4810,2220,20550,6000,6000,0,3250,6000,0,9250,7520,14550,11300,0
50221475,FA2021 ,12625,500,3740,2110,18975,10300,10300,0,2750,11600,0,14350,1525,7375,4625,100
50221475,FA2022 ,13005,515,3855,2220,19595,11800,8500,3300,3250,12100,0,15350,1420,7495,4245,100
50221475,FA2023 ,13500,550,4790,1200,20040,11800,8500,3300,2750,12100,0,14850,1950,7940,5190,100
50221475,FA2024 ,14750,600,5030,1270,21650,11800,8500,3300,3750,12100,0,15850,3250,9550,5800,100
50221475,SP2021 ,12625,500,3740,2110,18975,12300,10300,2000,2750,12600,0,15350,525,6375,3625,100
50221475,SP2022 ,13005,515,3855,2220,19595,9800,8500,1300,3250,10100,0,13350,3420,9495,6245,100
50221475,SP2023 ,13500,6825,6825,NULL,20325,9800,8500,1300,2750,10100,0,12850,10225,10225,7475,100
50221475,SP2024 ,14750,600,5030,1270,21650,9800,8500,1300,3750,10100,0,13850,5250,11550,7800,100
50153933,FA2021 ,12625,500,3740,2110,18975,6425,6425,0,NULL,7925,0,7925,5200,11050,11050,9418.2
50153933,FA2022 ,13005,515,3855,2220,19595,21300,6425,14875,NULL,21300,0,21300,-7780,-1705,-1705,9418.2
50153933,FA2023 ,13500,550,NULL,NULL,14050,5925,4925,1000,NULL,5925,0,5925,8125,8125,8125,9418.2
50153933,SP2021 ,12625,500,3740,2110,18975,13305,6425,6880,NULL,13305,0,13305,-180,5670,5670,9418.2
50153933,SP2022 ,13005,515,3855,2220,19595,19700,6425,13275,NULL,19700,0,19700,-6180,-105,-105,9418.2
50199498,FA2021 ,19340,860,5130,NULL,24470,11500,11500,0,NULL,13000,0,13000,7200,11470,11470,33653.31
50199498,FA2022 ,19910,890,5500,NULL,25410,21500,11500,10000,NULL,21500,0,21500,-700,3910,3910,33653.31
50199498,FA2023 ,3720,NULL,NULL,NULL,3720,2187,2187,0,NULL,2187,0,2187,1533,1533,1533,33653.31
50199498,SP2021 ,19340,860,5130,NULL,24470,11500,11500,0,NULL,11500,0,11500,8700,12970,12970,33653.31
50199498,SP2022 ,19910,890,5500,NULL,25410,11500,11500,0,NULL,11500,0,11500,9300,13910,13910,33653.31
50209754,FA2021 ,12625,500,4270,NULL,17395,5925,3925,2000,NULL,7425,0,7425,5700,9970,9970,0
50209754,FA2022 ,13005,515,4610,NULL,18130,6925,3925,3000,NULL,6925,0,6925,6595,11205,11205,0
50209754,FA2023 ,7450,275,NULL,NULL,7725,4890,0,4890,NULL,4890,0,4890,2835,2835,2835,0
50209754,SP2021 ,12625,500,4270,NULL,17395,3925,3925,0,NULL,3925,0,3925,9200,13470,13470,0
50209754,SP2022 ,13005,515,4610,NULL,18130,8925,3925,5000,NULL,8925,0,8925,4595,9205,9205,0
50211098,FA2021 ,12625,500,NULL,NULL,13125,6425,5425,1000,NULL,7925,0,7925,5200,5200,5200,0
50211098,FA2022 ,13005,515,5080,NULL,18600,7175,6175,1000,NULL,12550,0,12550,970,6050,6050,0
50211098,FA2023 ,13500,550,5800,NULL,19850,7175,6175,1000,3750,12873,0,16623,1177,6977,3227,0
50211098,SP2021 ,12625,500,4580,2110,19815,6925,6925,0,NULL,6925,0,6925,6200,12890,12890,0
50211098,SP2022 ,13005,515,5080,NULL,18600,6175,6175,0,NULL,11550,0,11550,1970,7050,7050,0
50211098,SP2023 ,7450,550,5800,NULL,13800,3409,3409,0,3750,7258,0,11008,742,6542,2792,0
50216858,FA2021 ,12625,500,4580,2550,20255,5925,5925,0,0,7425,0,7425,5700,12830,12830,0
50216858,FA2022 ,13005,515,3855,2690,20065,5925,5925,0,3750,5925,0,9675,7595,14140,10390,0
50216858,SP2021 ,12625,500,4580,2550,20255,5925,5925,0,0,5925,0,5925,7200,14330,14330,0
50216858,SP2022 ,13005,515,3855,2690,20065,5925,5925,0,3750,5925,0,9675,7595,14140,10390,0
50216858,SP2023 ,7450,550,4560,1200,13760,3270,0,3270,0,3270,0,3270,4730,10490,10490,0
50216890,FA2021 ,12625,500,4580,2110,19815,8425,8425,0,NULL,9925,0,9925,3200,9890,9890,0
50216890,FA2022 ,13005,515,5420,1140,20080,8425,8425,0,NULL,8425,0,8425,5095,11655,11655,0
50216890,FA2023 ,13500,550,5440,1200,20690,8425,0,8425,NULL,8425,0,8425,5625,12265,12265,0
50216890,SP2021 ,12625,500,4580,2110,19815,8425,8425,0,NULL,8425,0,8425,4700,11390,11390,0
50216890,SP2022 ,13005,515,5420,1140,20080,8425,8425,0,NULL,8425,0,8425,5095,11655,11655,0
50218825,FA2021 ,12625,500,3740,2110,18975,5625,5625,0,NULL,7125,0,7125,6000,11850,11850,2240
50218825,FA2022 ,13005,515,3855,2220,19595,5625,5625,0,NULL,5625,0,5625,7895,13970,13970,2240
50218825,FA2023 ,13500,550,4000,2325,20375,7625,5625,2000,NULL,7625,0,7625,6425,12750,12750,2240
50218825,FA2024 ,14750,600,4200,2450,22000,5625,0,5625,NULL,5625,0,5625,9725,16375,16375,2240
50218825,SP2021 ,12625,500,3740,2110,18975,5625,5625,0,NULL,5625,0,5625,7500,13350,13350,2240
50218825,SP2022 ,13005,515,3855,2220,19595,5625,5625,0,NULL,5625,0,5625,7895,13970,13970,2240
50218825,SP2023 ,13500,550,4000,2325,20375,5625,5625,0,NULL,5625,0,5625,8425,14750,14750,2240
50218825,SP2024 ,14750,600,4200,2450,22000,7625,0,7625,NULL,7625,0,7625,7725,14375,14375,2240
50218864,FA2021 ,12625,500,3740,2110,18975,6125,4125,2000,NULL,7625,0,7625,5500,11350,11350,6070
50218864,FA2024 ,14750,600,4200,2450,22000,4125,4125,0,NULL,4125,0,4125,11225,17875,17875,6070
50218864,SP2021 ,12625,500,3740,2110,18975,4125,4125,0,NULL,4125,0,4125,9000,14850,14850,6070
50218864,SP2024 ,14750,600,4200,2450,22000,4125,4125,0,NULL,4125,0,4125,11225,17875,17875,6070
50223244,FA2021 ,12625,500,3740,2110,18975,8500,6500,2000,NULL,9500,0,9500,3625,9475,9475,200
50223244,FA2022 ,13005,515,4260,2220,20000,6000,6000,0,NULL,6000,0,6000,7520,14000,14000,200
50223244,SP2021 ,12625,500,3740,2110,18975,6500,6500,0,NULL,6500,0,6500,6625,12475,12475,200
50223244,SP2022 ,13005,515,4260,2220,20000,6000,6000,0,NULL,6000,0,6000,7520,14000,14000,200
50223245,FA2021 ,12625,500,3740,2110,18975,7000,7000,0,NULL,8000,0,8000,5125,10975,10975,7911.19
50223245,FA2022 ,13005,515,3855,2220,19595,6500,6500,0,NULL,6500,0,6500,7020,13095,13095,7911.19
50223245,FA2023 ,13500,550,4000,2325,20375,6500,6500,0,NULL,10500,0,10500,3550,9875,9875,7911.19
50223245,FA2024 ,14750,600,4790,NULL,20140,8500,500,8000,NULL,10600,0,10600,4750,9540,9540,7911.19
50223245,SP2021 ,12625,500,3740,2110,18975,7300,7300,0,NULL,7300,0,7300,5825,11675,11675,7911.19
50223245,SP2022 ,13005,515,3855,2220,19595,6500,6500,0,NULL,6500,0,6500,7020,13095,13095,7911.19
50223245,SP2023 ,13500,550,4000,2325,20375,6500,6500,0,NULL,10500,0,10500,3550,9875,9875,7911.19
50223245,SP2024 ,14750,600,4790,NULL,20140,8500,500,8000,NULL,10600,0,10600,4750,9540,9540,7911.19
50223246,FA2021 ,12625,500,3740,2110,18975,5500,5500,0,NULL,6500,0,6500,6625,12475,12475,12672.23
50223246,FA2022 ,13005,515,3855,2220,19595,5000,5000,0,NULL,5000,0,5000,8520,14595,14595,12672.23
50223246,FA2023 ,13500,550,4790,1200,20040,5000,5000,0,NULL,5000,0,5000,9050,15040,15040,12672.23
50223246,FA2024 ,14750,600,4790,NULL,20140,5000,4500,500,NULL,5000,0,5000,10350,15140,15140,12672.23
50223246,SP2021 ,12625,500,3740,2110,18975,5500,5500,0,NULL,5500,0,5500,7625,13475,13475,12672.23
50223246,SP2022 ,13005,515,3855,2220,19595,5000,5000,0,NULL,5000,0,5000,8520,14595,14595,12672.23
50223246,SP2023 ,13500,550,4790,1200,20040,5000,5000,0,NULL,5000,0,5000,9050,15040,15040,12672.23
50223246,SP2024 ,14750,600,4790,NULL,20140,5000,4500,500,NULL,5000,0,5000,10350,15140,15140,12672.23
50223247,FA2021 ,12625,500,3740,2110,18975,7750,7750,0,NULL,8750,0,8750,4375,10225,10225,15
50223247,FA2022 ,13005,515,3855,2220,19595,7250,7250,0,NULL,7250,0,7250,6270,12345,12345,15
50223247,SP2021 ,12625,500,3740,2110,18975,7750,7750,0,NULL,7750,0,7750,5375,11225,11225,15
50223247,SP2022 ,13005,515,3855,2220,19595,7250,7250,0,NULL,7250,0,7250,6270,12345,12345,15
50225847,FA2022 ,13005,515,4810,2220,20550,9000,9000,0,2750,12448,0,15198,1072,8102,5352,2887
50225847,FA2023 ,13500,550,4000,2325,20375,9000,9000,0,2750,13098,0,15848,952,7277,4527,2887
50225847,FA2024 ,14750,600,4200,1270,20820,9000,0,9000,3750,13098,0,16848,2252,7722,3972,2887
50225847,SP2022 ,13005,515,4810,2220,20550,9000,9000,0,2750,12447,0,15197,1073,8103,5353,2887
50225847,SP2023 ,13500,550,4000,2325,20375,9000,9000,0,2750,13097,0,15847,953,7278,4528,2887
50225847,SP2024 ,14750,600,4200,1270,20820,9000,0,9000,3750,13097,0,16847,2253,7723,3973,2887
50226613,FA2022 ,13005,515,3855,2220,19595,8250,8250,0,NULL,8250,0,8250,5270,11345,11345,410
50226613,FA2023 ,13500,550,4000,2325,20375,8750,8750,0,NULL,8750,0,8750,5300,11625,11625,410
50226613,FA2024 ,14750,600,4200,2450,22000,9250,9250,0,NULL,9250,0,9250,6100,12750,12750,410
50226613,SP2022 ,13005,515,3855,2220,19595,8250,8250,0,NULL,8250,0,8250,5270,11345,11345,410
50226613,SP2023 ,13500,550,4000,2325,20375,8750,8750,0,NULL,8750,0,8750,5300,11625,11625,410
50226613,SP2024 ,14750,600,4200,2450,22000,8750,8750,0,NULL,8750,0,8750,6600,13250,13250,410
50229649,FA2023 ,13500,550,4000,2325,20375,9500,9000,500,NULL,9500,0,9500,4550,10875,10875,2343
50229649,FA2024 ,14750,600,4790,2450,22590,9500,8000,1500,NULL,14290,0,14290,1060,8300,8300,2343
50229649,SP2023 ,13500,550,4000,2325,20375,9500,9000,500,NULL,9500,0,9500,4550,10875,10875,2343
50229649,SP2024 ,14750,600,4790,2450,22590,9500,8000,1500,NULL,14290,0,14290,1060,8300,8300,2343
50230456,FA2023 ,13500,550,4000,2325,20375,10000,8000,2000,NULL,10000,0,10000,4050,10375,10375,2245
50230456,FA2024 ,14750,600,4200,2450,22000,8000,8000,0,NULL,8000,0,8000,7350,14000,14000,2245
50230456,SP2023 ,13500,550,4000,2325,20375,8000,8000,0,NULL,8000,0,8000,6050,12375,12375,2245
50230456,SP2024 ,14750,600,4200,2450,22000,10000,8000,2000,NULL,10000,0,10000,5350,12000,12000,2245
50230461,FA2023 ,13500,550,4000,2325,20375,10000,9000,1000,NULL,10000,0,10000,4050,10375,10375,0
50230461,FA2024 ,14750,600,5410,2450,23210,12500,8500,4000,NULL,17910,0,17910,-2560,5300,5300,0
50230461,SP2023 ,13500,550,4000,2325,20375,10250,9250,1000,NULL,10250,0,10250,3800,10125,10125,0
50230461,SP2024 ,14750,600,5410,1270,22030,10500,8500,2000,NULL,15910,0,15910,-560,6120,6120,0
50232687,FA2024 ,14750,600,4200,2450,22000,9000,9000,0,2750,14000,0,16750,1350,8000,5250,0
50232687,SP2024 ,14750,600,4200,2450,22000,9000,9000,0,2750,9000,0,11750,6350,13000,10250,0
50230349,FA2023 ,13500,550,4560,2325,20935,7000,7000,0,NULL,7000,0,7000,7050,13935,13935,335
50230349,FA2024 ,14750,600,4790,2450,22590,7000,7000,0,NULL,7000,0,7000,8350,15590,15590,335
50230349,SP2023 ,13500,550,4560,2325,20935,7000,7000,0,NULL,7000,0,7000,7050,13935,13935,335
50230349,SP2024 ,14750,600,4790,2450,22590,7000,7000,0,NULL,7000,0,7000,8350,15590,15590,335
50218332,FA2021 ,19340,860,5440,2110,26890,14000,14000,0,3250,15500,0,18750,4700,11390,8140,0
50218332,FA2022 ,19910,890,5700,2220,27830,14000,12025,1975,3750,14000,0,17750,6800,13830,10080,0
50218332,FA2023 ,20670,950,6390,NULL,27060,14000,7000,7000,3750,14000,0,17750,7620,13060,9310,0
50218332,SP2021 ,19340,860,5440,2110,26890,14000,14000,0,3250,14000,0,17250,6200,12890,9640,0
50218332,SP2022 ,19910,890,5700,2220,27830,14000,12025,1975,3750,14000,0,17750,6800,13830,10080,0
50218332,SP2023 ,20670,950,6390,NULL,27060,14000,7000,7000,3750,14000,0,17750,7620,13060,9310,0
50212143,FA2021 ,12625,500,NULL,NULL,13125,0,0,0,13650,1500,0,15150,11625,11625,-2025,0
50212143,FA2022 ,13005,515,NULL,NULL,13520,0,0,0,15750,0,0,15750,13520,13520,-2230,0
50212143,SP2021 ,12625,500,NULL,NULL,13125,0,0,0,13650,0,0,13650,13125,13125,-525,0
50212143,SP2022 ,13005,515,NULL,NULL,13520,0,0,0,15750,0,0,15750,13520,13520,-2230,0
50224954,FA2022 ,13005,515,NULL,NULL,13520,4485,4485,0,11750,4485,0,16235,9035,9035,-2715,0
50224954,FA2023 ,13500,550,NULL,NULL,14050,4485,4485,0,10000,4485,0,14485,9565,9565,-435,0
50224954,FA2024 ,14750,600,NULL,NULL,15350,4485,4485,0,12250,4485,0,16735,10865,10865,-1385,0
50224954,SP2022 ,13005,515,NULL,NULL,13520,4485,4485,0,11750,4485,0,16235,9035,9035,-2715,0
50224954,SP2023 ,13500,550,NULL,NULL,14050,4485,4485,0,10000,4485,0,14485,9565,9565,-435,0
50224954,SP2024 ,14750,600,NULL,NULL,15350,4485,4485,0,12250,4485,0,16735,10865,10865,-1385,0
50210969,FA2021 ,12625,500,3740,NULL,16865,7300,7300,0,3750,10670,0,14420,2455,6195,2445,0
50210969,SP2021 ,12625,500,3740,NULL,16865,7300,7300,0,3750,9170,0,12920,3955,7695,3945,0
50226369,FA2022 ,13005,515,4810,2220,20550,4500,4500,0,15250,4500,0,19750,9020,16050,800,-2685.5
50226369,FA2023 ,13500,550,4000,2325,20375,4500,4500,0,12500,4500,0,17000,9550,15875,3375,-2685.5
50226369,FA2024 ,14750,600,4200,2450,22000,4500,4500,0,12500,4500,0,17000,10850,17500,5000,-2685.5
50226369,SP2022 ,13005,515,4810,2220,20550,4500,4500,0,15250,4500,0,19750,9020,16050,800,-2685.5
50226369,SP2023 ,13500,550,4000,2325,20375,4500,4500,0,12500,4500,0,17000,9550,15875,3375,-2685.5
50226369,SP2024 ,14750,600,4200,2450,22000,4500,4500,0,12500,4500,0,17000,10850,17500,5000,-2685.5
50225848,SP2023 ,13500,550,NULL,NULL,14050,6500,6500,0,4750,11198,0,15948,2852,2852,-1898,0
50229302,FA2023 ,13500,550,NULL,NULL,14050,10000,0,10000,6250,13323,0,19573,727,727,-5523,0
50229302,SP2023 ,13500,550,NULL,NULL,14050,10000,0,10000,6250,13322,0,19572,728,728,-5522,0
50216300,FA2021 ,12625,500,3740,2110,18975,6475,6475,0,6650,7975,0,14625,5150,11000,4350,0
50209659,FA2021 ,12625,500,4050,2110,19285,3625,3625,0,3750,5125,0,8875,8000,14160,10410,0
50209659,FA2022 ,13005,515,4610,1140,19270,3625,1500,2125,19885,3625,0,23510,9895,15645,-4240,0
50209659,SP2021 ,12625,500,4050,2110,19285,3625,3625,0,3750,3625,0,7375,9500,15660,11910,0
50209659,SP2022 ,13005,515,4610,1140,19270,3625,1500,2125,14250,3625,0,17875,9895,15645,1395,0
50232935,FA2024 ,14750,600,5410,2450,23210,10500,1000,9500,NULL,10500,0,10500,4850,12710,12710,3280
50232935,SP2024 ,14750,600,5410,2450,23210,12500,1000,11500,NULL,12500,0,12500,2850,10710,10710,3280
40001000,FA2021 ,12625,500,3740,2110,18975,0,0,0,NULL,12625,12625,12625,500,6350,6350,0
40001000,FA2022 ,13005,515,3855,2220,19595,0,0,0,NULL,13005,13005,13005,515,6590,6590,0
40001000,FA2023 ,13500,550,4790,1200,20040,0,0,0,NULL,14500,13500,14500,-450,5540,5540,0
40001000,FA2024 ,14750,600,5030,1270,21650,0,0,0,NULL,15750,14750,15750,-400,5900,5900,0
40001000,SP2021 ,12625,500,3740,2110,18975,0,0,0,NULL,12625,12625,12625,500,6350,6350,0
40001000,SP2022 ,13005,515,4610,1140,19270,0,0,0,NULL,13005,13005,13005,515,6265,6265,0
40001000,SP2023 ,13500,550,4790,1200,20040,0,0,0,NULL,13500,13500,13500,550,6540,6540,0
40001000,SP2024 ,14750,600,5030,1270,21650,0,0,0,NULL,14750,14750,14750,600,6900,6900,0
50235931,SP2024 ,15000,7500,7500,NULL,22500,0,0,0,NULL,0,0,0,22500,22500,22500,0
50203212,FA2021 ,12625,500,4830,NULL,17955,8425,6825,1600,3750,9925,0,13675,3200,8030,4280,0
50203212,SP2021 ,12625,500,4830,NULL,17955,8425,6825,1600,3750,8425,0,12175,4700,9530,5780,0
50204425,FA2021 ,12625,500,4270,1080,18475,7175,7175,0,3750,8175,0,11925,4950,10300,6550,0
50221007,FA2021 ,12625,500,4050,2550,19725,7700,7700,0,2750,8700,0,11450,4425,11025,8275,0
50221007,FA2022 ,13005,515,4260,2220,20000,7550,7550,0,3250,7550,0,10800,5970,12450,9200,0
50221007,FA2023 ,13500,550,5440,2325,21815,8200,7700,500,3750,8200,0,11950,5850,13615,9865,0
50221007,FA2024 ,14750,600,5720,1270,22340,7550,6500,1050,3750,11275,0,15025,4075,11065,7315,0
50221007,SP2021 ,12625,500,4050,2550,19725,7700,7700,0,2750,7700,0,10450,5425,12025,9275,0
50221007,SP2022 ,13005,515,4260,2220,20000,7550,7550,0,3250,7550,0,10800,5970,12450,9200,0
50221007,SP2023 ,13500,550,5440,1200,20690,8200,7700,500,3750,8200,0,11950,5850,12490,8740,0
50221007,SP2024 ,14750,600,5720,1270,22340,7550,6500,1050,3750,11275,0,15025,4075,11065,7315,0
50216386,FA2021 ,12625,500,3740,2110,18975,9125,9125,0,3750,10625,0,14375,2500,8350,4600,0
50216386,FA2022 ,13005,515,3855,2220,19595,9125,9125,0,NULL,9125,0,9125,4395,10470,10470,0
50216386,SP2021 ,12625,500,3740,2110,18975,9125,9125,0,3750,9125,0,12875,4000,9850,6100,0
50216386,SP2022 ,13005,515,3855,2220,19595,9125,9125,0,NULL,9125,0,9125,4395,10470,10470,0
50225717,FA2022 ,13005,515,3855,2220,19595,7000,5000,2000,2750,7000,0,9750,6520,12595,9845,0
50225717,SP2022 ,13005,515,3855,2220,19595,5000,5000,0,2750,5000,0,7750,8520,14595,11845,0
50225849,FA2022 ,13005,515,3855,2220,19595,10600,10600,0,2750,10600,0,13350,2920,8995,6245,-1950
50225849,FA2023 ,13500,550,4000,2325,20375,10600,10000,600,3250,10600,0,13850,3450,9775,6525,-1950
50225849,FA2024 ,14750,600,4200,2450,22000,10600,7500,3100,3750,14298,0,18048,1052,7702,3952,-1950
50225849,SP2022 ,13005,515,3855,2220,19595,10600,10600,0,2750,10600,0,13350,2920,8995,6245,-1950
50225849,SP2023 ,13500,550,4000,2325,20375,10600,10000,600,3250,10600,0,13850,3450,9775,6525,-1950
50225849,SP2024 ,14750,600,4200,2450,22000,10600,7500,3100,3750,14297,0,18047,1053,7703,3953,-1950
50231646,FA2024 ,14750,600,4200,2680,22230,9000,9000,0,2750,9000,0,11750,6350,13230,10480,-250
50231646,SP2024 ,14750,600,4200,2450,22000,9250,9250,0,2750,9250,0,12000,6100,12750,10000,-250
50231777,FA2024 ,14750,600,5410,2450,23210,7000,7000,0,2750,7000,0,9750,8350,16210,13460,0
50231777,SP2024 ,14750,600,5410,2450,23210,7000,7000,0,2750,7000,0,9750,8350,16210,13460,0
50231975,FA2024 ,14750,600,4200,2450,22000,11250,11250,0,2750,14750,0,17500,600,7250,4500,0
50231975,SP2024 ,14750,600,4200,2450,22000,11250,11250,0,2750,11250,0,14000,4100,10750,8000,0
50209859,FA2021 ,12625,500,NULL,NULL,13125,2925,0,2925,NULL,4425,0,4425,8700,8700,8700,0
50209859,FA2022 ,5360,257,NULL,NULL,5617,1206,0,1206,NULL,1206,0,1206,4411,4411,4411,0
50209859,SP2021 ,12625,500,NULL,NULL,13125,2925,0,2925,NULL,2925,0,2925,10200,10200,10200,0
50221498,FA2021 ,12625,500,4580,2550,20255,8000,8000,0,2750,8000,0,10750,5125,12255,9505,0
50221498,FA2022 ,13005,515,3855,2220,19595,7500,7500,0,3250,7500,0,10750,6020,12095,8845,0
50221498,FA2023 ,13500,550,4790,1200,20040,8000,8000,0,NULL,8000,0,8000,6050,12040,12040,0
50221498,FA2024 ,14750,600,5030,1270,21650,7500,7500,0,NULL,7500,0,7500,7850,14150,14150,0
50221498,SP2021 ,12625,500,4580,2110,19815,8000,8000,0,2750,8000,0,10750,5125,11815,9065,0
50221498,SP2022 ,13005,515,3855,2220,19595,7500,7500,0,3250,7500,0,10750,6020,12095,8845,0
50221498,SP2023 ,13500,550,4790,1200,20040,8000,8000,0,NULL,8000,0,8000,6050,12040,12040,0
50221498,SP2024 ,14750,600,5030,1270,21650,7500,7500,0,NULL,7500,0,7500,7850,14150,14150,0
50225707,FA2022 ,13005,515,3855,2220,19595,9000,9000,0,NULL,9000,0,9000,4520,10595,10595,3925.99
50225707,FA2023 ,13500,550,4000,2325,20375,9205,9205,0,NULL,9205,0,9205,4845,11170,11170,3925.99
50225707,FA2024 ,14750,600,4790,NULL,20140,9000,5500,3500,NULL,9000,0,9000,6350,11140,11140,3925.99
50225707,SP2022 ,13005,515,3855,2220,19595,9000,9000,0,NULL,9000,0,9000,4520,10595,10595,3925.99
50225707,SP2023 ,13500,550,4000,2325,20375,9229,9229,0,NULL,9229,0,9229,4821,11146,11146,3925.99
50225707,SP2024 ,14750,600,4790,2450,22590,9000,5500,3500,NULL,9000,0,9000,6350,13590,13590,3925.99
50226653,FA2022 ,13005,515,4810,2220,20550,7000,7000,0,NULL,7000,0,7000,6520,13550,13550,-915
50226653,FA2023 ,13500,550,5150,2325,21525,7000,7000,0,NULL,7000,0,7000,7050,14525,14525,-915
50226653,FA2024 ,14750,600,5720,NULL,21070,7000,5000,2000,NULL,7000,0,7000,8350,14070,14070,-915
50226653,SP2022 ,13005,515,4810,2220,20550,7000,7000,0,NULL,7000,0,7000,6520,13550,13550,-915
50226653,SP2023 ,13500,550,5150,2325,21525,7000,7000,0,NULL,7000,0,7000,7050,14525,14525,-915
50226653,SP2024 ,14750,600,4790,1270,21410,7000,5000,2000,NULL,7000,0,7000,8350,14410,14410,-915
50229504,FA2023 ,13500,550,4000,2325,20375,9000,9000,0,2750,9000,0,11750,5050,11375,8625,6230.38
50229504,FA2024 ,14750,600,5240,2450,23040,9000,7000,2000,3250,11503,0,14753,3847,11537,8287,6230.38
50229504,SP2023 ,13500,550,4990,2325,21365,9000,9000,0,2750,9000,0,11750,5050,12365,9615,6230.38
50229504,SP2024 ,14750,600,5240,2450,23040,9000,7000,2000,3250,11502,0,14752,3848,11538,8288,6230.38
50234906,FA2024 ,14750,600,5720,1270,22340,15350,15350,0,NULL,15350,0,15350,0,6990,6990,-200
50216659,FA2021 ,12625,500,3740,2110,18975,4250,4250,0,10709,9723,0,20432,3402,9252,-1457,0
50216659,SP2021 ,12625,500,3740,2110,18975,4250,4250,0,10710,9722,0,20432,3403,9253,-1457,0
50206877,FA2021 ,12625,500,NULL,NULL,13125,3925,0,3925,NULL,5425,0,5425,7700,7700,7700,0
50206877,SP2021 ,15060,500,NULL,NULL,15560,3925,0,3925,NULL,3925,0,3925,11635,11635,11635,0
50209850,FA2021 ,12625,500,4580,2110,19815,7425,7425,0,NULL,8925,0,8925,4200,10890,10890,0
50209850,SP2021 ,12625,500,4580,2110,19815,7425,7425,0,NULL,7425,0,7425,5700,12390,12390,0
50227764,FA2023 ,13500,550,4000,2325,20375,9000,7750,1250,NULL,9000,0,9000,5050,11375,11375,0
50227764,FA2024 ,14750,600,4790,1270,21410,9000,6500,2500,NULL,9000,0,9000,6350,12410,12410,0
50227764,SP2022 ,13005,515,3855,2220,19595,9000,9000,0,NULL,9000,0,9000,4520,10595,10595,0
50227764,SP2023 ,13500,550,4000,2325,20375,9000,7750,1250,NULL,9000,0,9000,5050,11375,11375,0
50227764,SP2024 ,14750,600,4200,NULL,19550,9000,6500,2500,NULL,9000,0,9000,6350,10550,10550,0
50229162,FA2023 ,13500,550,4000,2325,20375,8000,8000,0,NULL,8000,0,8000,6050,12375,12375,0
50229162,FA2024 ,14750,600,4200,2450,22000,8000,7000,1000,NULL,8000,0,8000,7350,14000,14000,0
50229162,SP2023 ,13500,550,4000,2325,20375,8000,8000,0,NULL,8000,0,8000,6050,12375,12375,0
50229162,SP2024 ,14750,600,4200,2450,22000,8000,7000,1000,NULL,8000,0,8000,7350,14000,14000,0
50222787,FA2021 ,12625,500,NULL,NULL,13125,3450,3450,0,2750,3450,0,6200,9675,9675,6925,0
50222787,FA2022 ,13005,515,NULL,2220,15740,3105,3105,0,3250,3105,0,6355,10415,12635,9385,0
50222787,FA2023 ,13500,550,NULL,2325,16375,3105,3105,0,3750,3105,0,6855,10945,13270,9520,0
50222787,FA2024 ,14750,600,NULL,2450,17800,3105,3105,0,3750,3105,0,6855,12245,14695,10945,0
50222787,SP2021 ,12625,500,NULL,NULL,13125,3450,3450,0,2750,3450,0,6200,9675,9675,6925,0
50222787,SP2022 ,13005,515,NULL,2220,15740,3105,3105,0,3250,3105,0,6355,10415,12635,9385,0
50222787,SP2023 ,13500,550,NULL,2325,16375,3105,3105,0,3750,3105,0,6855,10945,13270,9520,0
50222787,SP2024 ,14750,600,NULL,2450,17800,3105,3105,0,3750,3105,0,6855,12245,14695,10945,0
50228091,FA2023 ,13500,550,4560,2325,20935,9000,9000,0,2750,9000,0,11750,5050,11935,9185,0
50228091,FA2024 ,14750,600,4790,2450,22590,9000,9000,0,NULL,9000,0,9000,6350,13590,13590,0
50228091,SP2023 ,13500,550,4560,2325,20935,9000,9000,0,2750,9000,0,11750,5050,11935,9185,0
50228091,SP2024 ,14750,600,4790,2450,22590,9000,9000,0,NULL,9000,0,9000,6350,13590,13590,0
50231404,FA2024 ,14750,600,4790,2450,22590,9500,0,9500,2750,12500,0,15250,2850,10090,7340,2656.32
50231404,SP2024 ,14750,600,4790,2450,22590,9500,0,9500,2750,10500,0,13250,4850,12090,9340,2656.32
50222347,FA2021 ,12625,500,4650,2110,19885,7500,7500,0,2750,18348,0,21098,-5223,1537,-1213,0
50222347,FA2022 ,13005,515,3855,2220,19595,6000,6000,0,4810,16248,0,21058,-2728,3347,-1463,0
50222347,SP2021 ,12625,500,4650,2110,19885,7000,7000,0,2750,12407,0,15157,718,7478,4728,0
50222347,SP2022 ,13005,515,3855,2220,19595,6000,6000,0,4810,16247,0,21057,-2727,3348,-1462,0
50229429,FA2024 ,14750,600,4790,2450,22590,9800,9800,0,2750,13295,0,16045,2055,9295,6545,2069.17
50229429,SP2024 ,14750,600,4790,2450,22590,9800,9800,0,2750,13295,0,16045,2055,9295,6545,2069.17
50225754,FA2023 ,13500,550,4000,2325,20375,5000,5000,0,NULL,5000,0,5000,9050,15375,15375,105
50225754,FA2024 ,14750,600,4200,2450,22000,5000,5000,0,NULL,5000,0,5000,10350,17000,17000,105
50225754,SP2023 ,13500,550,4000,2325,20375,5000,5000,0,NULL,5000,0,5000,9050,15375,15375,105
50225754,SP2024 ,14750,600,4200,2450,22000,5000,5000,0,NULL,5000,0,5000,10350,17000,17000,105
50222661,FA2021 ,12625,500,4580,2110,19815,4000,4000,0,2750,4000,0,6750,9125,15815,13065,0
50222661,FA2022 ,13005,515,3855,2220,19595,4000,4000,0,3250,4000,0,7250,9520,15595,12345,0
50222661,FA2023 ,13500,550,4790,1200,20040,4000,4000,0,3750,4000,0,7750,10050,16040,12290,0
50222661,FA2024 ,14750,600,NULL,1270,16620,2760,2760,0,NULL,2760,0,2760,12590,13860,13860,0
50222661,SP2021 ,12625,500,4580,2110,19815,4000,4000,0,2750,4000,0,6750,9125,15815,13065,0
50222661,SP2022 ,13005,515,3855,2220,19595,4000,4000,0,3250,4000,0,7250,9520,15595,12345,0
50222661,SP2023 ,13500,550,4790,1200,20040,4000,4000,0,3750,4000,0,7750,10050,16040,12290,0
50222661,SP2024 ,14750,600,NULL,1270,16620,2760,2760,0,NULL,2760,0,2760,12590,13860,13860,0
50202857,FA2021 ,12625,500,4830,1080,19035,6675,6675,0,8989,8175,0,17164,4950,10860,1871,0
50216066,FA2021 ,12625,500,3740,2110,18975,8425,8425,0,2750,9925,0,12675,3200,9050,6300,0
50216066,FA2022 ,13005,515,3855,2220,19595,8425,8425,0,3750,8425,0,12175,5095,11170,7420,0
50216066,SP2021 ,12625,500,3740,2110,18975,8425,8425,0,2750,8425,0,11175,4700,10550,7800,0
50216066,SP2022 ,13005,515,3855,2220,19595,8425,8425,0,11400,8425,0,19825,5095,11170,-230,0
50210747,FA2021 ,12625,500,4270,1080,18475,6625,4625,2000,14700,10011,0,24711,3114,8464,-6236,0
50210747,FA2022 ,13005,515,4810,2220,20550,6625,4625,2000,14936,8511,0,23447,5009,12039,-2897,0
50210747,SP2021 ,12625,500,4270,1080,18475,4625,4625,0,12700,6511,0,19211,6614,11964,-736,0
50223789,FA2023 ,13500,550,4990,2535,21575,10500,9500,1000,2750,13700,0,16450,350,7875,5125,-662
50223789,FA2024 ,14750,600,4780,2450,22580,10000,9000,1000,3250,10000,0,13250,5350,12580,9330,-662
50223789,SP2023 ,13500,550,4990,2325,21365,9500,9500,0,2750,12500,0,15250,1550,8865,6115,-662
50223789,SP2024 ,14750,600,4780,2450,22580,10000,9000,1000,3250,11600,0,14850,3750,10980,7730,-662
50234377,FA2024 ,15000,7500,7500,NULL,22500,0,0,0,NULL,0,0,0,22500,22500,22500,0
50214441,FA2021 ,12625,500,4580,2110,19815,8425,8425,0,3750,13748,0,17498,-623,6067,2317,0
50214441,SP2021 ,12625,500,4580,2110,19815,8425,8425,0,3750,11747,0,15497,1378,8068,4318,0
50149329,FA2021 ,12625,6350,6350,NULL,18975,2588,2588,0,11750,4088,0,15838,14887,14887,3137,0
50149329,SP2021 ,12625,500,4270,1080,18475,5175,2000,3175,11750,5175,0,16925,7950,13300,1550,0
50225595,FA2022 ,13005,515,4810,2220,20550,6000,6000,0,2750,6000,0,8750,7520,14550,11800,-1140
50225595,FA2023 ,13500,550,5150,2325,21525,6000,6000,0,3250,6000,0,9250,8050,15525,12275,-1140
50225595,FA2024 ,14750,600,5720,1270,22340,6000,5000,1000,3250,6000,0,9250,9350,16340,13090,-1140
50225595,SP2022 ,13005,515,4810,2220,20550,6000,6000,0,2750,6000,0,8750,7520,14550,11800,-1140
50225595,SP2023 ,13500,550,5150,2325,21525,6000,6000,0,3250,7500,0,10750,6550,14025,10775,-1140
50225595,SP2024 ,14750,600,5720,NULL,21070,6000,5000,1000,3250,6000,0,9250,9350,15070,11820,-1140
50231754,FA2024 ,14750,600,5410,2450,23210,6000,6000,0,2750,6000,0,8750,9350,17210,14460,0
50221042,FA2021 ,12625,500,3740,2110,18975,5500,5500,0,2750,6000,0,8750,7125,12975,10225,0
50221042,SP2021 ,12625,500,3740,2110,18975,5500,5500,0,2750,5500,0,8250,7625,13475,10725,0
50221042,SP2022 ,13005,515,3855,2220,19595,5000,5000,0,NULL,5000,0,5000,8520,14595,14595,0
50232476,SP2024 ,14750,600,4200,2450,22000,8500,8500,0,NULL,8500,0,8500,6850,13500,13500,0
50231609,FA2024 ,14750,600,4200,2450,22000,7000,7000,0,2750,7750,0,10500,7600,14250,11500,0
50231609,SP2024 ,14750,600,4200,2450,22000,7000,7000,0,2750,7000,0,9750,8350,15000,12250,0
50227368,FA2022 ,13005,515,4810,2220,20550,6000,6000,0,1650,7873,0,9523,5647,12677,11027,0
50227368,SP2022 ,13005,515,4810,2220,20550,6000,6000,0,1650,7872,0,9522,5648,12678,11028,0
50051618,FA2021 ,12625,500,NULL,NULL,13125,925,425,500,11966,2425,0,14391,10700,10700,-1266,0
50051618,FA2022 ,13005,515,NULL,NULL,13520,925,925,0,10750,925,0,11675,12595,12595,1845,0
50051618,SP2021 ,12625,500,NULL,NULL,13125,925,425,500,12324,925,0,13249,12200,12200,-124,0
50051618,SP2022 ,13005,515,NULL,NULL,13520,925,925,0,10758,925,0,11683,12595,12595,1837,0
50225553,FA2022 ,13005,515,4810,2220,20550,8450,8450,0,14329,8950,0,23279,4570,11600,-2729,0
50225553,FA2023 ,13500,550,4560,2325,20935,6700,5700,1000,3250,11673,0,14923,2377,9262,6012,0
50225553,FA2024 ,14750,600,NULL,NULL,15350,5485,2035,3450,3750,9835,0,13585,5515,5515,1765,0
50225553,SP2022 ,13005,515,4810,2220,20550,7950,7950,0,13171,7950,0,21121,5570,12600,-571,0
50225553,SP2023 ,13500,550,4560,2325,20935,5700,5700,0,3250,12172,0,15422,1878,8763,5513,0
50225553,SP2024 ,14750,600,NULL,NULL,15350,5486,2036,3450,3750,9836,0,13586,5514,5514,1764,0
50226987,FA2022 ,13005,515,3855,2220,19595,7050,7050,0,0,7050,0,7050,6470,12545,12545,0
50226987,FA2023 ,13500,550,4000,2325,20375,9050,0,9050,0,9050,0,9050,5000,11325,11325,0
50226987,FA2024 ,14750,600,4200,2450,22000,7050,5000,2050,3750,7050,0,10800,8300,14950,11200,0
50226987,SP2022 ,13005,515,3855,2220,19595,9050,7050,2000,0,9050,0,9050,4470,10545,10545,0
50226987,SP2023 ,13500,550,4000,2325,20375,7050,0,7050,0,7050,0,7050,7000,13325,13325,0
50226987,SP2024 ,14750,600,4200,2450,22000,9050,5000,4050,3750,9050,0,12800,6300,12950,9200,0
50228566,FA2023 ,13500,550,5150,2535,21735,8200,8200,0,2750,11898,0,14648,2152,9837,7087,2655.66
50228566,FA2024 ,14750,600,4790,2680,22820,8700,8700,0,3250,12398,0,15648,2952,10422,7172,2655.66
50228566,SP2023 ,13500,550,5150,2535,21735,8200,8200,0,2750,11897,0,14647,2153,9838,7088,2655.66
50228566,SP2024 ,14750,600,4790,2680,22820,8700,8700,0,3250,12397,0,15647,2953,10423,7173,2655.66
50228567,FA2023 ,13500,550,5150,2535,21735,9000,9000,0,2750,12698,0,15448,1352,9037,6287,0
50228567,FA2024 ,14750,600,4790,2680,22820,9000,9000,0,3250,12698,0,15948,2652,10122,6872,0
50228567,SP2023 ,13500,550,5150,2535,21735,9000,9000,0,2750,12697,0,15447,1353,9038,6288,0
50228567,SP2024 ,14750,600,4790,2680,22820,9000,9000,0,3250,12697,0,15947,2653,10123,6873,0
50120156,FA2023 ,7450,275,NULL,1200,8925,0,0,0,NULL,7450,7450,7450,275,1475,1475,-300
50120156,FA2024 ,14750,600,NULL,NULL,15350,0,0,0,NULL,14750,14750,14750,600,600,600,-300
50120156,SP2023 ,5570,275,NULL,1200,7045,0,0,0,NULL,5570,5570,5570,275,1475,1475,-300
50120156,SP2024 ,8140,300,NULL,NULL,8440,0,0,0,NULL,8140,8140,8140,300,300,300,-300
50221477,FA2021 ,12625,500,4050,2550,19725,10000,8000,2000,2750,12000,0,14750,1125,7725,4975,0
50221477,FA2022 ,13005,515,4260,2690,20470,8750,6750,2000,0,8750,0,8750,4770,11720,11720,0
50221477,FA2023 ,13500,550,5800,2535,22385,6750,6750,0,NULL,6750,0,6750,7300,15635,15635,0
50221477,FA2024 ,14750,600,6090,1270,22710,6750,6750,0,0,6750,0,6750,8600,15960,15960,0
50221477,SP2021 ,12625,500,4050,2550,19725,8000,8000,0,2750,8000,0,10750,5125,11725,8975,0
50221477,SP2022 ,13005,515,4260,2690,20470,6750,6750,0,0,6750,0,6750,6770,13720,13720,0
50221477,SP2023 ,13500,550,5800,2325,22175,6750,6750,0,NULL,9250,0,9250,4800,12925,12925,0
50221477,SP2024 ,14750,600,6090,NULL,21440,6750,6750,0,10000,6750,0,16750,8600,14690,4690,0
50229664,FA2023 ,13500,550,4000,2325,20375,7000,7000,0,3250,8000,0,11250,6050,12375,9125,337.43
50229664,FA2024 ,14750,600,4200,2450,22000,9000,7000,2000,9070,9000,0,18070,6350,13000,3930,337.43
50229664,SP2023 ,13500,550,4000,2325,20375,7000,7000,0,3250,8000,0,11250,6050,12375,9125,337.43
50229664,SP2024 ,14750,7250,7250,NULL,22000,5400,4400,1000,9070,5400,0,14470,16600,16600,7530,337.43
50222218,FA2022 ,13005,515,4260,2220,20000,11000,9000,2000,NULL,11000,0,11000,2520,9000,9000,0
50211036,FA2021 ,12625,500,3740,NULL,16865,6050,6050,0,3750,12300,0,16050,825,4565,815,0
50211036,FA2022 ,13005,515,5080,NULL,18600,7300,7300,0,3750,10800,0,14550,2720,7800,4050,0
50211036,SP2021 ,12625,500,3740,NULL,16865,8050,6050,2000,3750,14800,0,18550,-1675,2065,-1685,0
50211036,SP2022 ,13005,515,5080,NULL,18600,9300,7300,2000,3750,12800,0,16550,720,5800,2050,0
50213255,FA2021 ,12625,500,3740,2110,18975,2525,2525,0,17736,6598,0,24334,6527,12377,-5359,3543.9
50213255,FA2022 ,13005,515,3855,2220,19595,2760,2760,0,6250,6608,0,12858,6912,12987,6737,3543.9
50213255,SP2021 ,12625,500,3740,2110,18975,2525,2525,0,15751,4597,0,20348,8528,14378,-1373,3543.9
50213255,SP2022 ,13005,515,3855,2220,19595,2822,2822,0,6250,6669,0,12919,6851,12926,6676,3543.9
50215307,FA2021 ,12625,500,4580,2110,19815,9625,8625,1000,5250,15273,0,20523,-2148,4542,-708,0
50215307,FA2022 ,13005,515,4810,1140,19470,11875,7225,4650,6250,14498,0,20748,-978,4972,-1278,0
50215307,FA2023 ,13500,550,5150,1200,20400,11655,6055,5600,6250,15752,0,22002,-1702,4648,-1602,0
50215307,SP2021 ,12625,500,4580,1080,18785,9625,8625,1000,5250,14332,0,19582,-1207,4453,-797,0
50215307,SP2022 ,13005,515,4810,1140,19470,11925,7275,4650,6250,14547,0,20797,-1027,4923,-1327,0
50215307,SP2023 ,13500,550,5150,1200,20400,10216,6116,4100,6250,14314,0,20564,-264,6086,-164,0
50232819,FA2024 ,14750,600,5410,2450,23210,6500,5000,1500,21186,10198,0,31384,5152,13012,-8174,-2
50232819,SP2024 ,14750,600,5410,2450,23210,6500,5000,1500,7328,10197,0,17525,5153,13013,5685,-2
50203449,FA2021 ,12625,500,4270,1080,18475,3925,2450,1475,3750,5425,0,9175,7700,13050,9300,0
50203449,SP2021 ,12625,500,4270,1080,18475,5925,2450,3475,3750,5925,0,9675,7200,12550,8800,0
50210975,FA2021 ,12625,500,3740,1080,17945,8300,8300,0,NULL,8800,0,8800,4325,9145,9145,0
50210975,SP2021 ,12625,500,3740,1080,17945,7800,7800,0,NULL,7800,0,7800,5325,10145,10145,0
50216418,FA2021 ,12625,500,3740,2110,18975,6750,6750,0,3250,6750,0,10000,6375,12225,8975,0
50216418,FA2022 ,13005,515,3855,2220,19595,100,100,0,NULL,13105,13005,13105,415,6490,6490,0
50216418,FA2023 ,14380,550,4560,1200,20690,0,0,0,NULL,13500,13500,13500,1430,7190,7190,0
50216418,SP2021 ,12625,500,3740,2110,18975,6750,6750,0,3250,6750,0,10000,6375,12225,8975,0
50229049,FA2023 ,13500,550,4000,2325,20375,8000,8000,0,2750,8000,0,10750,6050,12375,9625,-752.4
50229049,FA2024 ,14750,600,5720,1270,22340,8000,8000,0,NULL,13800,0,13800,1550,8540,8540,-752.4
50229049,SP2023 ,13500,550,4000,2325,20375,8000,8000,0,2750,8000,0,10750,6050,12375,9625,-752.4
50229049,SP2024 ,14750,7250,7250,NULL,22000,8000,8000,0,NULL,8000,0,8000,14000,14000,14000,-752.4
9578036,FA2021 ,12625,500,4830,NULL,17955,1425,0,1425,15750,2425,0,18175,10700,15530,-220,0
9578036,SP2021 ,12625,500,4830,NULL,17955,1425,0,1425,15750,1425,0,17175,11700,16530,780,0
50231953,FA2024 ,14750,600,4200,2450,22000,8050,8050,0,2750,8050,0,10800,7300,13950,11200,-2447
50231953,SP2024 ,14750,600,4200,2450,22000,8050,8050,0,2750,8050,0,10800,7300,13950,11200,-2447
50228907,FA2023 ,13500,550,4560,2325,20935,7000,7000,0,2750,7000,0,9750,7050,13935,11185,4236.32
50228907,FA2024 ,14750,600,4790,2450,22590,7000,7000,0,3250,7000,0,10250,8350,15590,12340,4236.32
50228907,SP2023 ,13500,550,4560,2325,20935,7000,7000,0,2750,7000,0,9750,7050,13935,11185,4236.32
50228907,SP2024 ,14750,600,4790,2450,22590,7000,7000,0,3250,7000,0,10250,8350,15590,12340,4236.32
50222898,FA2021 ,12625,500,4580,2110,19815,5500,5500,0,2750,6000,0,8750,7125,13815,11065,0
50222898,FA2022 ,13005,515,4610,1140,19270,5000,5000,0,15750,5000,0,20750,8520,14270,-1480,0
50222898,FA2023 ,13500,550,5150,2325,21525,5000,5000,0,3750,5000,0,8750,9050,16525,12775,0
50222898,FA2024 ,14750,600,6090,1270,22710,5000,5000,0,17655,5000,0,22655,10350,17710,55,0
50222898,SP2021 ,12625,500,4580,2110,19815,5500,5500,0,2750,5500,0,8250,7625,14315,11565,0
50222898,SP2022 ,13005,515,4610,1140,19270,5000,5000,0,15750,5000,0,20750,8520,14270,-1480,0
50222898,SP2023 ,13500,550,5150,2325,21525,5000,5000,0,17250,5000,0,22250,9050,16525,-725,0
50228001,FA2023 ,13500,550,4000,2535,20585,7000,6000,1000,2750,11923,0,14673,2127,8662,5912,0
50221538,FA2021 ,12625,500,3550,2110,18785,9750,8750,1000,2750,14498,0,17248,-1373,4287,1537,156
50221538,FA2022 ,13005,515,3855,2220,19595,8250,8250,0,2750,12098,0,14848,1422,7497,4747,156
50221538,FA2023 ,13500,550,4000,2325,20375,8250,8250,0,3750,8250,0,12000,5800,12125,8375,156
50221538,FA2024 ,14750,600,5030,1270,21650,8250,7750,500,3750,12643,0,16393,2707,9007,5257,156
50221538,SP2021 ,1800,NULL,NULL,NULL,1800,0,0,0,0,1872,0,1872,-72,-72,-72,156
50221538,SP2022 ,13005,515,3855,2220,19595,8250,8250,0,2750,12097,0,14847,1423,7498,4748,156
50221538,SP2023 ,13500,550,4000,2325,20375,8250,8250,0,3750,8250,0,12000,5800,12125,8375,156
50221538,SP2024 ,14750,600,5030,1270,21650,8250,7750,500,3750,11948,0,15698,3402,9702,5952,156
50225044,FA2022 ,13005,515,4810,2220,20550,7250,7250,0,13750,8900,0,22650,4620,11650,-2100,-3820
50225044,FA2023 ,13500,550,5150,2325,21525,7250,7250,0,11250,12250,0,23500,1800,9275,-1975,-3820
50225044,FA2024 ,14750,600,NULL,NULL,15350,5003,5003,0,8750,10003,0,18753,5347,5347,-3403,-3820
50225044,SP2022 ,13005,515,4810,2220,20550,7250,7250,0,2750,13150,0,15900,370,7400,4650,-3820
50225044,SP2023 ,13500,550,5150,2325,21525,7250,7250,0,9250,10250,0,19500,3800,11275,2025,-3820
50225044,SP2024 ,14750,600,NULL,NULL,15350,5002,5002,0,8750,8002,0,16752,7348,7348,-1402,-3820
40001065,FA2022 ,3580,NULL,NULL,NULL,3580,0,0,0,NULL,3580,3580,3580,0,0,0,0
40001065,FA2023 ,3720,NULL,NULL,NULL,3720,0,0,0,NULL,3720,3720,3720,0,0,0,0
50225178,FA2022 ,13005,515,4260,2220,20000,5500,5500,0,15465,5500,0,20965,8020,14500,-965,477
50225178,FA2023 ,13500,550,4000,1200,19250,5500,5500,0,14891,5500,0,20391,8550,13750,-1141,477
50225178,FA2024 ,14750,600,5720,1270,22340,5500,5500,0,18000,5500,0,23500,9850,16840,-1160,477
50225178,SP2022 ,13005,515,4260,2220,20000,5500,5500,0,14828,5500,0,20328,8020,14500,-328,477
50225178,SP2023 ,13500,550,4000,1200,19250,5500,5500,0,13375,5500,0,18875,8550,13750,375,477
50225178,SP2024 ,14750,600,5720,1270,22340,5500,5500,0,17710,5500,0,23210,9850,16840,-870,477
50233266,FA2024 ,14750,600,5410,2450,23210,8750,250,8500,8493,8750,0,17243,6600,14460,5967,3190
50233266,SP2024 ,14750,600,5410,2450,23210,8500,0,8500,8493,8500,0,16993,6850,14710,6217,3190
50216574,FA2021 ,12625,500,3740,2110,18975,10425,7322,3103,3250,14148,0,17398,-1023,4827,1577,0
50216574,SP2021 ,12625,500,NULL,NULL,13125,7925,5253,2672,3250,9647,0,12897,3478,3478,228,0
50218416,FA2022 ,13005,515,3855,2220,19595,8500,3550,4950,NULL,8500,0,8500,5020,11095,11095,3423.71
50218416,FA2023 ,13500,550,4000,NULL,18050,8500,3100,5400,NULL,8500,0,8500,5550,9550,9550,3423.71
50218416,FA2024 ,14750,600,4200,NULL,19550,8500,0,8500,NULL,8500,0,8500,6850,11050,11050,3423.71
50218416,SP2022 ,13005,515,3855,2220,19595,8500,3550,4950,NULL,8500,0,8500,5020,11095,11095,3423.71
50218416,SP2023 ,13500,550,4000,NULL,18050,8500,3100,5400,NULL,8500,0,8500,5550,9550,9550,3423.71
50218416,SP2024 ,14750,600,4200,NULL,19550,8500,0,8500,NULL,8500,0,8500,6850,11050,11050,3423.71
50216555,FA2021 ,12625,500,4050,2110,19285,6850,6850,0,3250,10375,0,13625,2750,8910,5660,0
50198495,FA2021 ,12625,500,3740,0,16865,0,0,0,NULL,0,0,0,13125,16865,16865,0
50204763,FA2021 ,12625,500,5160,NULL,18285,3925,0,3925,13176,6795,0,19971,6330,11490,-1686,0
50204763,SP2021 ,12625,500,5160,NULL,18285,3925,0,3925,12908,5795,0,18703,7330,12490,-418,0
50222026,FA2021 ,12625,500,3740,2110,18975,5000,5000,0,2750,6250,0,9000,6875,12725,9975,562
50222026,FA2022 ,13005,515,3855,2220,19595,4500,4500,0,3250,4500,0,7750,9020,15095,11845,562
50222026,FA2023 ,13500,550,4560,2325,20935,4500,4500,0,3750,9060,0,12810,4990,11875,8125,562
50222026,FA2024 ,14750,600,NULL,NULL,15350,0,0,0,NULL,14750,14750,14750,600,600,600,562
50222026,SP2021 ,12625,500,3740,2110,18975,5000,5000,0,2750,5000,0,7750,8125,13975,11225,562
50222026,SP2022 ,13005,515,3855,2220,19595,4500,4500,0,3250,4500,0,7750,9020,15095,11845,562
50222026,SP2023 ,13500,550,4560,2325,20935,4500,4500,0,3750,9060,0,12810,4990,11875,8125,562
50222026,SP2024 ,14750,600,NULL,NULL,15350,0,0,0,NULL,14750,14750,14750,600,600,600,562
50210972,FA2021 ,12625,500,4580,2110,19815,7925,7925,0,3250,9425,0,12675,3700,10390,7140,0
50210972,FA2022 ,13005,515,4610,1140,19270,8425,7425,1000,3750,8425,0,12175,5095,10845,7095,0
50210972,SP2021 ,12625,500,4580,2110,19815,7925,7925,0,3250,7925,0,11175,5200,11890,8640,0
50210972,SP2022 ,13005,515,4610,1140,19270,7925,6925,1000,3750,7925,0,11675,5595,11345,7595,0
50221700,FA2022 ,13005,515,3855,2220,19595,4500,4500,0,14250,4500,0,18750,9020,15095,845,8187
50221700,FA2023 ,13500,550,4000,2325,20375,4500,4500,0,16931,4500,0,21431,9550,15875,-1056,8187
50221700,FA2024 ,14750,600,4200,2450,22000,4500,4500,0,15948,8198,0,24146,7152,13802,-2146,8187
50221700,SP2021 ,12625,500,3740,2110,18975,4500,4500,0,0,4500,0,4500,8625,14475,14475,8187
50221700,SP2022 ,13005,515,3855,2220,19595,4500,4500,0,14250,4500,0,18750,9020,15095,845,8187
50221700,SP2024 ,14750,600,4200,2450,22000,4500,4500,0,4995,8197,0,13192,7153,13803,8808,8187
50228618,FA2024 ,14750,600,5410,2450,23210,8103,8103,0,17523,8103,0,25626,7247,15107,-2416,40
50232857,FA2024 ,14750,600,4200,2450,22000,9000,0,9000,2750,9300,0,12050,6050,12700,9950,-14
50225307,FA2022 ,13005,515,3855,2220,19595,11000,9500,1500,NULL,11000,0,11000,2520,8595,8595,0
50225307,FA2023 ,13500,550,4000,2325,20375,11000,8000,3000,NULL,11000,0,11000,3050,9375,9375,0
50225307,FA2024 ,14750,600,4200,NULL,19550,11000,8000,3000,NULL,11000,0,11000,4350,8550,8550,0
50225307,SP2022 ,13005,515,3855,2220,19595,11250,9750,1500,NULL,11250,0,11250,2270,8345,8345,0
50225307,SP2023 ,13500,550,4000,NULL,18050,11000,8000,3000,NULL,11000,0,11000,3050,7050,7050,0
50225307,SP2024 ,14750,600,4200,NULL,19550,11000,8000,3000,NULL,11000,0,11000,4350,8550,8550,0
50232339,FA2024 ,14750,600,4200,2450,22000,7500,7500,0,0,7500,0,7500,7850,14500,14500,0
50225780,SP2021 ,12625,500,4050,2110,19285,4000,4000,0,NULL,4000,0,4000,9125,15285,15285,0
50232383,FA2024 ,14750,600,4200,2450,22000,8500,8500,0,4750,13698,0,18448,1652,8302,3552,3293.5
50232383,SP2024 ,14750,600,4200,2450,22000,8500,8500,0,4750,13697,0,18447,1653,8303,3553,3293.5
50215519,FA2021 ,12625,500,3740,2110,18975,7000,7000,0,0,7000,0,7000,6125,11975,11975,0
50217520,FA2021 ,12625,500,NULL,NULL,13125,1000,1000,0,NULL,1500,0,1500,11625,11625,11625,0
50229603,FA2023 ,13500,550,NULL,NULL,14050,4485,3985,500,NULL,4485,0,4485,9565,9565,9565,1458.49
50229603,FA2024 ,14750,600,NULL,NULL,15350,7485,4485,3000,NULL,8235,0,8235,7115,7115,7115,1458.49
50229603,SP2023 ,13500,550,NULL,NULL,14050,4485,3985,500,NULL,4485,0,4485,9565,9565,9565,1458.49
50229603,SP2024 ,8140,300,NULL,NULL,8440,2476,2476,0,NULL,3226,0,3226,5214,5214,5214,1458.49
50225180,FA2022 ,13005,515,4260,2220,20000,8150,8150,0,2750,18088,0,20838,-4568,1912,-838,-6617.65
50225180,FA2023 ,13500,550,5150,2325,21525,7650,7650,0,3250,17247,0,20497,-3197,4278,1028,-6617.65
50225180,FA2024 ,14750,600,5030,1270,21650,8150,7150,1000,2750,24247,0,26997,-8897,-2597,-5347,-6617.65
50225180,SP2022 ,13005,515,4260,2220,20000,8150,8150,0,2750,18087,0,20837,-4567,1913,-837,-6617.65
50225180,SP2023 ,13500,550,5150,2325,21525,7650,7650,0,3250,21747,0,24997,-7697,-222,-3472,-6617.65
50225180,SP2024 ,2120,NULL,NULL,NULL,2120,0,0,0,0,629,0,629,1491,1491,1491,-6617.65
50194634,FA2021 ,6960,500,4470,1080,13010,0,0,0,0,4836,0,4836,2624,8174,8174,0
50210592,FA2021 ,12625,500,3740,2110,18975,8425,8425,0,3750,13665,0,17415,-540,5310,1560,0
50210592,FA2022 ,13005,6590,6590,NULL,19595,8425,8425,0,10139,9398,0,19537,10197,10197,58,0
50210592,SP2021 ,12625,500,3740,2110,18975,8425,8425,0,3750,12165,0,15915,960,6810,3060,0
50210592,SP2022 ,13005,515,3855,2220,19595,8425,0,8425,9672,9397,0,19069,4123,10198,526,0
50226453,FA2022 ,13005,515,NULL,NULL,13520,6485,4485,2000,2750,6485,0,9235,7035,7035,4285,0
50226453,FA2023 ,13500,550,NULL,NULL,14050,4485,4485,0,2750,4485,0,7235,9565,9565,6815,0
50226453,SP2022 ,13005,515,NULL,NULL,13520,4485,4485,0,2750,4485,0,7235,9035,9035,6285,0
50226453,SP2023 ,13500,550,NULL,NULL,14050,4485,4485,0,2750,4485,0,7235,9565,9565,6815,0
50226454,FA2022 ,3580,NULL,NULL,NULL,3580,0,0,0,0,0,0,0,3580,3580,3580,0
50226454,FA2023 ,13500,550,NULL,NULL,14050,3795,3795,0,NULL,8295,0,8295,5755,5755,5755,0
50226454,FA2024 ,14750,600,NULL,NULL,15350,3795,3795,0,3250,10545,0,13795,4805,4805,1555,0
50226454,SP2022 ,5360,257,NULL,NULL,5617,2093,2093,0,0,2093,0,2093,3524,3524,3524,0
50226454,SP2023 ,13500,550,NULL,NULL,14050,3795,3795,0,NULL,8295,0,8295,5755,5755,5755,0
50226454,SP2024 ,8140,300,NULL,NULL,8440,2094,2094,0,3250,8844,0,12094,-404,-404,-3654,0
50119340,FA2021 ,12625,500,3740,2110,18975,8700,8700,0,1750,9700,0,11450,3425,9275,7525,-2
50119340,FA2022 ,13005,515,3855,2220,19595,8200,8200,0,2250,8200,0,10450,5320,11395,9145,-2
50119340,FA2023 ,13500,550,4000,2325,20375,7200,7200,0,3750,9273,0,13023,4777,11102,7352,-2
50119340,FA2024 ,14750,600,4200,2450,22000,8200,6000,2200,3750,12298,0,16048,3052,9702,5952,-2
50119340,SP2021 ,12625,500,3740,2110,18975,8700,8700,0,1750,8700,0,10450,4425,10275,8525,-2
50119340,SP2022 ,13005,515,3855,2220,19595,8200,8200,0,9847,8200,0,18047,5320,11395,1548,-2
50119340,SP2023 ,13500,550,4000,2325,20375,7200,7200,0,9250,9272,0,18522,4778,11103,1853,-2
50119340,SP2024 ,14750,600,4200,2450,22000,8200,6000,2200,9750,12297,0,22047,3053,9703,-47,-2
50231656,FA2024 ,14750,600,NULL,NULL,15350,7000,7000,0,2750,10500,0,13250,4850,4850,2100,1406
50231656,SP2024 ,14750,600,NULL,NULL,15350,7000,7000,0,2750,8500,0,11250,6850,6850,4100,1406
50203152,FA2021 ,19340,860,5690,1080,26110,11000,10250,750,3750,12000,0,15750,8200,14110,10360,0
50203152,SP2021 ,19340,860,5690,1080,26110,11000,10250,750,3750,11000,0,14750,9200,15110,11360,0
50228384,SP2022 ,14269,7231,7231,NULL,21500,0,0,0,NULL,0,0,0,21500,21500,21500,0
50229863,SP2024 ,15000,7500,7500,NULL,22500,0,0,0,NULL,0,0,0,22500,22500,22500,0
50229263,FA2023 ,13500,550,4560,2535,21145,5500,5500,0,12750,5500,0,18250,8550,15645,2895,-6484.7
50229263,FA2024 ,14750,600,4790,2450,22590,5500,5500,0,15250,5500,0,20750,9850,17090,1840,-6484.7
50229263,SP2023 ,13500,550,4560,2535,21145,5500,5500,0,12750,5500,0,18250,8550,15645,2895,-6484.7
50229263,SP2024 ,14750,600,4790,2450,22590,5500,5500,0,15250,5500,0,20750,9850,17090,1840,-6484.7
50232559,FA2024 ,14750,600,5410,2450,23210,7500,7500,0,0,7500,0,7500,7850,15710,15710,0
50232559,SP2024 ,14750,600,5410,2450,23210,7500,7500,0,2750,8500,0,11250,6850,14710,11960,0
50209250,FA2021 ,12625,500,3740,1080,17945,1425,0,1425,NULL,3295,0,3295,9830,14650,14650,0
50209250,FA2022 ,13005,515,4610,NULL,18130,1425,0,1425,NULL,1425,0,1425,12095,16705,16705,0
50209250,SP2021 ,12625,500,3740,1080,17945,1425,0,1425,NULL,3295,0,3295,9830,14650,14650,0
50203620,FA2021 ,12625,500,4580,2550,20255,1425,0,1425,3750,2425,0,6175,10700,17830,14080,0
50203620,SP2021 ,12625,500,4580,2550,20255,1425,0,1425,3750,1425,0,5175,11700,18830,15080,0
50232113,FA2024 ,14750,600,5410,2450,23210,11500,8000,3500,2750,15698,0,18448,-348,7512,4762,0
50232113,SP2024 ,14750,600,5410,2450,23210,9500,8000,1500,2750,13697,0,16447,1653,9513,6763,0
50216185,FA2021 ,12625,500,4650,2110,19885,7125,7125,0,3250,8625,0,11875,4500,11260,8010,0
50216185,FA2022 ,13005,515,4800,2220,20540,7275,7275,0,NULL,7275,0,7275,6245,13265,13265,0
50216185,SP2021 ,12625,500,4650,2110,19885,7175,7175,0,3250,7175,0,10425,5950,12710,9460,0
50216185,SP2022 ,2600,103,1927,444,5074,1415,1415,0,NULL,1415,0,1415,1288,3659,3659,0
50199622,FA2021 ,6960,250,NULL,NULL,7210,593,593,0,2750,4819,0,7569,2391,2391,-359,0
50199622,SP2021 ,12625,500,NULL,NULL,13125,1075,1075,0,950,4147,0,5097,8978,8978,8028,0
50221990,FA2021 ,12625,500,4580,2110,19815,9250,9250,0,0,23648,0,23648,-10523,-3833,-3833,1880
50221990,FA2022 ,13005,515,4810,2220,20550,9200,8750,450,2250,16973,0,19223,-3453,3577,1327,1880
50221990,FA2023 ,7450,550,4790,NULL,12790,5072,4879,193,3750,7663,0,11413,337,5127,1377,1880
50221990,FA2024 ,14750,600,5720,NULL,21070,9200,8750,450,3750,17048,0,20798,-1698,4022,272,1880
50221990,SP2021 ,12625,500,4580,2110,19815,9250,9250,0,0,20107,0,20107,-6982,-292,-292,1880
50221990,SP2022 ,13005,515,4810,2220,20550,9200,8750,450,2250,16972,0,19222,-3452,3578,1328,1880
50221990,SP2023 ,13500,550,4790,NULL,18840,9100,8750,350,3750,17223,0,20973,-3173,1617,-2133,1880
50221990,SP2024 ,17620,600,5720,NULL,23940,9200,8750,450,3750,19547,0,23297,-1327,4393,643,1880
50222822,FA2021 ,12625,500,4580,2110,19815,7000,7000,0,4525,14511,0,19036,-1386,5304,779,0
50232821,FA2024 ,14750,600,NULL,NULL,15350,8300,8300,0,4750,13498,0,18248,1852,1852,-2898,0
50232821,SP2024 ,14750,600,NULL,NULL,15350,8300,8300,0,4750,13497,0,18247,1853,1853,-2897,0
50225792,FA2022 ,13005,515,4810,2220,20550,6500,6500,0,2750,6500,0,9250,7020,14050,11300,0
50225792,FA2023 ,13500,550,5440,1200,20690,6500,6500,0,NULL,6500,0,6500,7550,14190,14190,0
50225792,FA2024 ,14750,600,6090,1270,22710,6500,6500,0,NULL,6500,0,6500,8850,16210,16210,0
50225792,SP2022 ,13005,515,4810,2220,20550,6500,6500,0,2750,6500,0,9250,7020,14050,11300,0
50225792,SP2023 ,13500,550,5440,1200,20690,6500,6500,0,NULL,6500,0,6500,7550,14190,14190,0
50225792,SP2024 ,14750,600,6090,1270,22710,6500,6500,0,NULL,6500,0,6500,8850,16210,16210,0
50204069,FA2021 ,12625,500,3740,2110,18975,1425,1425,0,3250,7073,0,10323,6052,11902,8652,0
50204069,SP2021 ,12625,500,3740,1080,17945,1425,1425,0,3250,6132,0,9382,6993,11813,8563,0
50216421,FA2021 ,12625,500,3740,2110,18975,2425,2425,0,18403,3425,0,21828,9700,15550,-2853,0
50216421,FA2022 ,13005,515,4610,1140,19270,2425,2425,0,18750,2425,0,21175,11095,16845,-1905,0
50216421,FA2023 ,13500,550,5800,1200,21050,2425,2425,0,19750,2425,0,22175,11625,18625,-1125,0
50216421,SP2021 ,12625,500,3740,2110,18975,2425,2425,0,18403,2425,0,20828,10700,16550,-1853,0
50216421,SP2022 ,13005,515,4610,1140,19270,2425,2425,0,18750,2425,0,21175,11095,16845,-1905,0
50216421,SP2023 ,13500,550,5800,1200,21050,2425,2425,0,19750,2425,0,22175,11625,18625,-1125,0
50226494,FA2022 ,13005,515,4810,2220,20550,9500,9500,0,NULL,9500,0,9500,4020,11050,11050,0
50226494,SP2022 ,13005,515,4810,2220,20550,9500,9500,0,NULL,9500,0,9500,4020,11050,11050,0
50226250,FA2022 ,13005,515,4810,2220,20550,7050,7050,0,11586,10423,0,22009,3097,10127,-1459,0
50215051,FA2021 ,12625,500,3740,2110,18975,9775,9775,0,2250,15423,0,17673,-2298,3552,1302,0
50215051,FA2022 ,13005,515,4610,1140,19270,8625,8625,0,2750,12473,0,15223,1047,6797,4047,0
50215051,FA2023 ,13500,550,5440,1200,20690,8625,8625,0,2750,12723,0,15473,1327,7967,5217,0
50215051,SP2021 ,12625,500,3740,2110,18975,9525,9525,0,2250,14232,0,16482,-1107,4743,2493,0
50215051,SP2022 ,13005,515,4610,1140,19270,8625,8625,0,2750,12472,0,15222,1048,6798,4048,0
50215051,SP2023 ,13500,550,5440,1200,20690,8625,8625,0,2750,12722,0,15472,1328,7968,5218,0
50229009,FA2024 ,14750,600,4200,2450,22000,9750,0,9750,2750,14860,0,17610,490,7140,4390,2223.32
50229009,SP2024 ,14750,600,4200,2450,22000,12750,0,12750,2750,14860,0,17610,490,7140,4390,2223.32
50229714,FA2023 ,13500,550,4560,2325,20935,8200,8200,0,0,10423,0,10423,3627,10512,10512,0
50229714,FA2024 ,14750,600,4790,2450,22590,8200,6000,2200,1000,8200,0,9200,7150,14390,13390,0
50229714,SP2023 ,13500,550,4560,2325,20935,8200,8200,0,0,10422,0,10422,3628,10513,10513,0
50229714,SP2024 ,14750,600,4790,2450,22590,8200,6000,2200,1000,8200,0,9200,7150,14390,13390,0
50226821,FA2022 ,13005,515,3855,2220,19595,7000,7000,0,3750,7000,0,10750,6520,12595,8845,0
50226821,SP2022 ,13005,515,3855,2220,19595,7000,7000,0,3750,7000,0,10750,6520,12595,8845,0
50203854,FA2021 ,12625,500,4830,1080,19035,6675,4675,2000,3750,8675,0,12425,4450,10360,6610,0
50203854,SP2021 ,6960,500,4830,1080,13370,2577,2577,0,3750,2827,0,6577,4633,10543,6793,0
50214616,FA2021 ,12625,500,3740,2110,18975,4675,0,4675,3250,6175,0,9425,6950,12800,9550,0
50214616,FA2022 ,13005,515,4260,1140,18920,5425,0,5425,3750,5425,0,9175,8095,13495,9745,0
50214616,FA2023 ,13500,550,5440,1200,20690,3175,2550,625,3750,3175,0,6925,10875,17515,13765,0
50214616,SP2021 ,12625,6350,6350,NULL,18975,4675,3175,1500,3250,4675,0,7925,14300,14300,11050,0
50214616,SP2022 ,13005,515,4260,1140,18920,5425,0,5425,3750,5425,0,9175,8095,13495,9745,0
50215629,FA2021 ,12625,500,3740,2110,18975,7925,6559,1366,10750,9425,0,20175,3700,9550,-1200,0
50215629,FA2022 ,13005,6590,6590,NULL,19595,8925,7555,1370,12000,8925,0,20925,10670,10670,-1330,0
50215629,FA2023 ,13500,550,5440,1200,20690,8425,7055,1370,8750,8425,0,17175,5625,12265,3515,0
50215629,SP2021 ,12625,500,3740,2110,18975,7925,6550,1375,10750,7925,0,18675,5200,11050,300,0
50215629,SP2022 ,13005,515,4610,1140,19270,8925,7555,1370,12000,8925,0,20925,4595,10345,-1655,0
50215629,SP2023 ,13500,550,5440,1200,20690,8425,7055,1370,8750,8425,0,17175,5625,12265,3515,0
50225389,FA2022 ,13005,515,4810,2220,20550,8050,8050,0,2750,13498,0,16248,22,7052,4302,0
50225389,FA2023 ,13500,550,4000,2325,20375,7550,5500,2050,3250,13648,0,16898,402,6727,3477,0
50225389,FA2024 ,14750,600,5030,1270,21650,8050,1000,7050,3750,12148,0,15898,3202,9502,5752,0
50225389,SP2022 ,13005,515,4810,2220,20550,8050,8050,0,2750,11997,0,14747,1523,8553,5803,0
50225389,SP2023 ,13500,550,4000,2325,20375,7550,5500,2050,3250,12147,0,15397,1903,8228,4978,0
50225389,SP2024 ,14750,600,5030,1270,21650,8050,1000,7050,3750,13647,0,17397,1703,8003,4253,0
50211545,FA2021 ,12625,500,4580,2110,19815,425,0,425,3250,1425,0,4675,11700,18390,15140,0
50211545,FA2022 ,13005,6590,6590,NULL,19595,0,0,0,3750,0,0,3750,19595,19595,15845,0
50211545,SP2021 ,12625,500,4580,2110,19815,425,425,0,3250,425,0,3675,12700,19390,16140,0
50211545,SP2022 ,13005,515,4810,1140,19470,424,212,212,3750,424,0,4174,13096,19046,15296,0
50233219,FA2024 ,14750,600,4790,2450,22590,7500,7500,0,2750,7500,0,10250,7850,15090,12340,5211.66
50233219,SP2024 ,14750,600,4790,2450,22590,7500,7500,0,2750,7500,0,10250,7850,15090,12340,5211.66
50205431,FA2021 ,12625,500,3740,2110,18975,5825,5825,0,5750,9748,0,15498,3377,9227,3477,0
50205431,SP2021 ,12625,500,3740,2110,18975,5825,5825,0,5750,7747,0,13497,5378,11228,5478,0
50235684,SP2024 ,14750,600,0,0,15350,3450,3450,0,13250,3450,0,16700,11900,11900,-1350,-26
50209606,FA2021 ,12625,500,4270,NULL,17395,8425,8425,0,NULL,8925,0,8925,4200,8470,8470,0
50209606,FA2022 ,13005,515,NULL,NULL,13520,6925,0,6925,NULL,6925,0,6925,6595,6595,6595,0
50209606,SP2021 ,12625,500,4270,NULL,17395,8425,8425,0,NULL,8425,0,8425,4700,8970,8970,0
50209606,SP2022 ,13005,515,NULL,NULL,13520,6925,0,6925,NULL,6925,0,6925,6595,6595,6595,0
50210161,FA2021 ,12625,500,4270,2110,19505,11390,10675,715,0,14390,0,14390,-1265,5115,5115,0
50210161,FA2022 ,13005,6590,6590,NULL,19595,5800,5800,0,0,16073,0,16073,3522,3522,3522,0
50210161,SP2021 ,12625,500,4270,2110,19505,9675,9675,0,0,9675,0,9675,3450,9830,9830,0
50210161,SP2022 ,13005,515,3855,2220,19595,9675,9675,0,0,13447,0,13447,73,6148,6148,0
50228569,FA2023 ,13500,550,5150,2325,21525,9500,0,9500,2750,11500,0,14250,2550,10025,7275,0
50228569,FA2024 ,14750,600,5410,2450,23210,9500,0,9500,NULL,9500,0,9500,5850,13710,13710,0
50228569,SP2023 ,13500,550,5150,2325,21525,9500,0,9500,2750,9500,0,12250,4550,12025,9275,0
50228569,SP2024 ,14750,600,5410,2450,23210,9500,0,9500,NULL,9500,0,9500,5850,13710,13710,0
50118829,FA2021 ,12625,500,4050,2110,19285,1175,1175,0,NULL,1175,0,1175,11950,18110,18110,0
50118829,FA2022 ,13005,515,5080,1140,19740,1175,1175,0,NULL,1175,0,1175,12345,18565,18565,0
50118829,SP2021 ,12625,500,4050,2110,19285,1175,1175,0,NULL,1175,0,1175,11950,18110,18110,0
50118829,SP2022 ,13005,515,5080,1140,19740,1175,1175,0,NULL,1175,0,1175,12345,18565,18565,0
50119073,FA2021 ,12625,500,4580,2110,19815,6000,6000,0,2750,6000,0,8750,7125,13815,11065,0
50119073,FA2022 ,13005,515,4810,2220,20550,5500,5500,0,NULL,5500,0,5500,8020,15050,15050,0
50119073,SP2021 ,12625,500,4240,2110,19475,6000,6000,0,2750,6000,0,8750,7125,13475,10725,0
50221525,FA2021 ,12625,500,4580,2110,19815,5500,5500,0,NULL,5500,0,5500,7625,14315,14315,0
50221525,FA2022 ,13005,515,4810,2220,20550,5000,5000,0,NULL,5000,0,5000,8520,15550,15550,0
50221525,FA2023 ,13500,550,4790,1200,20040,5000,5000,0,NULL,5000,0,5000,9050,15040,15040,0
50221525,FA2024 ,14750,600,5030,1270,21650,5000,5000,0,NULL,5000,0,5000,10350,16650,16650,0
50221525,SP2021 ,12625,500,4580,2110,19815,5500,5500,0,NULL,5500,0,5500,7625,14315,14315,0
50221525,SP2022 ,13005,515,4810,2220,20550,5000,5000,0,NULL,5000,0,5000,8520,15550,15550,0
50221525,SP2023 ,13500,550,4790,1200,20040,5000,5000,0,NULL,5000,0,5000,9050,15040,15040,0
50221525,SP2024 ,14750,600,5030,1270,21650,5000,5000,0,NULL,5000,0,5000,10350,16650,16650,0
50209604,FA2021 ,12625,500,3740,2550,19415,1925,1250,675,3750,5925,0,9675,7200,13490,9740,0
50209604,FA2022 ,13005,515,3855,2220,19595,3925,1000,2925,2000,6425,0,8425,7095,13170,11170,0
50209604,SP2021 ,12625,500,3740,2550,19415,1925,1250,675,3750,1925,0,5675,11200,17490,13740,0
50209604,SP2022 ,13005,515,3855,2220,19595,1925,1000,925,3750,1925,0,5675,11595,17670,13920,0
50221499,FA2021 ,12625,500,4050,2110,19285,5750,5750,0,2750,5750,0,8500,7375,13535,10785,255
50221499,FA2022 ,13005,515,4260,2220,20000,5000,5000,0,3250,5000,0,8250,8520,15000,11750,255
50221499,FA2023 ,13500,550,4790,1200,20040,5000,5000,0,3750,5000,0,8750,9050,15040,11290,255
50221499,FA2024 ,18520,600,5720,1270,26110,5000,5000,0,NULL,5000,0,5000,14120,21110,21110,255
50221499,SP2021 ,12625,500,4050,2110,19285,5750,5750,0,2750,5750,0,8500,7375,13535,10785,255
50221499,SP2022 ,13005,515,4260,2220,20000,5000,5000,0,3250,5000,0,8250,8520,15000,11750,255
50221499,SP2023 ,13500,550,4790,1200,20040,5000,5000,0,3750,5000,0,8750,9050,15040,11290,255
50227611,FA2024 ,14750,600,4200,2450,22000,11000,9000,2000,2750,11000,0,13750,4350,11000,8250,3928
50227611,SP2024 ,14750,600,4200,2450,22000,9000,9000,0,2750,9000,0,11750,6350,13000,10250,3928
50220712,FA2021 ,12625,500,4580,2110,19815,8300,8300,0,7250,11973,0,19223,1152,7842,592,0
50220712,SP2021 ,12625,500,4580,2110,19815,8300,8300,0,7250,10472,0,17722,2653,9343,2093,0
50223810,FA2021 ,12625,500,3740,NULL,16865,6500,6500,0,6250,11348,0,17598,1777,5517,-733,0
50223810,FA2022 ,13005,515,4260,1140,18920,10000,7000,3000,6250,15247,0,21497,-1727,3673,-2577,0
50223810,SP2021 ,12625,500,3740,NULL,16865,6500,6500,0,6250,11907,0,18157,1218,4958,-1292,0
50223810,SP2022 ,13005,515,4260,1140,18920,10000,7000,3000,6250,15248,0,21498,-1728,3672,-2578,0
50224256,FA2021 ,5050,200,0,279,5529,2000,2000,0,0,2000,0,2000,3250,3529,3529,0
50118830,FA2021 ,12625,500,3740,2110,18975,3925,3925,0,3250,5425,0,8675,7700,13550,10300,0
50118830,SP2021 ,12625,500,3740,2110,18975,3925,3925,0,3250,3925,0,7175,9200,15050,11800,0
50196571,FA2021 ,3470,NULL,NULL,NULL,3470,0,0,0,NULL,0,0,0,3470,3470,3470,0
50203511,FA2021 ,19340,860,5130,1080,25550,9500,9000,500,NULL,9500,0,9500,10700,16050,16050,0
50203511,SP2021 ,19340,860,5130,1080,25550,9500,9000,500,NULL,9500,0,9500,10700,16050,16050,0
50214389,FA2021 ,12625,500,3740,2110,18975,9625,9625,0,3250,13548,0,16798,-423,5427,2177,0
50214389,FA2022 ,13005,515,3855,1140,18515,9625,9625,0,3750,11248,0,14998,2272,7267,3517,0
50214389,FA2023 ,13500,550,4790,NULL,18840,9625,0,9625,9549,9625,0,19174,4425,9215,-334,0
50214389,SP2021 ,12625,500,3740,2110,18975,9625,9625,0,3250,11547,0,14797,1578,7428,4178,0
50214389,SP2022 ,13005,515,3855,1140,18515,9625,9625,0,3750,11247,0,14997,2273,7268,3518,0
50220888,FA2021 ,12625,500,4050,2110,19285,7000,7000,0,2750,7000,0,9750,6125,12285,9535,0
50220888,FA2022 ,13005,515,3855,2220,19595,6350,6350,0,3250,6350,0,9600,7170,13245,9995,0
50220888,FA2023 ,13500,550,4000,1200,19250,6000,6000,0,0,6000,0,6000,8050,13250,13250,0
50220888,FA2024 ,14750,600,4200,1270,20820,6500,6000,500,3750,10198,0,13948,5152,10622,6872,0
50220888,SP2021 ,12625,500,4050,2110,19285,7050,7050,0,2750,7050,0,9800,6075,12235,9485,0
50220888,SP2022 ,13005,515,3855,2220,19595,6400,6400,0,3250,6400,0,9650,7120,13195,9945,0
50220888,SP2023 ,13500,550,4000,1200,19250,6000,6000,0,0,6000,0,6000,8050,13250,13250,0
50222210,FA2021 ,12625,500,4050,2110,19285,7250,7250,0,0,7250,0,7250,5875,12035,12035,0
50222210,FA2022 ,13005,515,3855,2220,19595,6750,6750,0,NULL,6750,0,6750,6770,12845,12845,0
50222210,FA2023 ,13500,550,5440,NULL,19490,6750,6750,0,NULL,6750,0,6750,7300,12740,12740,0
50222210,FA2024 ,14750,600,6090,NULL,21440,6750,6750,0,NULL,6750,0,6750,8600,14690,14690,0
50222210,SP2021 ,12625,500,4050,2110,19285,7250,7250,0,2750,7250,0,10000,5875,12035,9285,0
50222210,SP2022 ,13005,515,3855,2220,19595,6750,6750,0,NULL,6750,0,6750,6770,12845,12845,0
50222210,SP2023 ,13500,550,5440,NULL,19490,6750,6750,0,NULL,6750,0,6750,7300,12740,12740,0
50225614,FA2023 ,13500,550,5150,2325,21525,6500,6500,0,3250,6500,0,9750,7550,15025,11775,7511.49
50225614,FA2024 ,14750,600,5720,NULL,21070,6500,6500,0,NULL,6500,0,6500,8850,14570,14570,7511.49
50225614,SP2022 ,13005,515,4810,2220,20550,6500,6500,0,0,6500,0,6500,7020,14050,14050,7511.49
50225614,SP2023 ,13500,550,5150,2325,21525,6500,6500,0,3250,6500,0,9750,7550,15025,11775,7511.49
50225614,SP2024 ,15720,600,5720,NULL,22040,6500,6500,0,NULL,6500,0,6500,9820,15540,15540,7511.49
50229482,FA2023 ,13500,550,4560,2325,20935,7000,7000,0,2750,7000,0,9750,7050,13935,11185,0
50229482,FA2024 ,14750,600,4790,2450,22590,7000,7000,0,3250,7000,0,10250,8350,15590,12340,0
50229482,SP2023 ,13500,550,4560,2325,20935,7000,7000,0,2750,7000,0,9750,7050,13935,11185,0
50229482,SP2024 ,14750,600,4790,2450,22590,7000,7000,0,3250,7000,0,10250,8350,15590,12340,0
50233295,FA2024 ,14750,600,4200,2450,22000,6000,6000,0,NULL,6000,0,6000,9350,16000,16000,-65
50233295,SP2024 ,14750,600,4200,2450,22000,6000,6000,0,NULL,6000,0,6000,9350,16000,16000,-65
50225358,FA2022 ,13005,515,3855,2220,19595,10500,8500,2000,NULL,10500,0,10500,3020,9095,9095,18753
50225358,FA2023 ,13500,550,4000,2325,20375,10000,8500,1500,NULL,10000,0,10000,4050,10375,10375,18753
50225358,SP2022 ,13005,515,3855,2220,19595,8500,8500,0,NULL,8500,0,8500,5020,11095,11095,18753
50225358,SP2023 ,13500,550,4000,2325,20375,10000,8500,1500,NULL,10000,0,10000,4050,10375,10375,18753
50216410,FA2021 ,12625,500,3740,2110,18975,0,0,0,3250,14998,12625,18248,-1873,3977,727,0
50216410,FA2022 ,13005,515,3855,2220,19595,0,0,0,1813,18883,13005,20696,-5363,712,-1101,0
50216410,FA2023 ,13500,550,4000,2325,20375,0,0,0,2153,19323,13500,21476,-5273,1052,-1101,0
50216410,SP2021 ,12625,500,3740,2110,18975,0,0,0,3250,12997,12625,16247,128,5978,2728,0
50216410,SP2022 ,13005,515,3855,2220,19595,0,0,0,1812,18882,13005,20694,-5362,713,-1099,0
50216410,SP2023 ,13500,550,4000,2325,20375,0,0,0,2152,19322,13500,21474,-5272,1053,-1099,0
50204395,FA2021 ,19340,860,5690,NULL,25030,8500,7500,1000,19750,9000,0,28750,11200,16030,-3720,0
50204395,SP2021 ,19340,860,5690,NULL,25030,8500,7500,1000,16500,8500,0,25000,11700,16530,30,0
50211057,FA2021 ,12625,500,4580,2110,19815,0,0,0,NULL,500,0,500,12625,19315,19315,0
50211057,FA2022 ,13005,515,NULL,1140,14660,0,0,0,NULL,0,0,0,13520,14660,14660,0
50211057,SP2021 ,12625,500,4580,2110,19815,0,0,0,NULL,0,0,0,13125,19815,19815,0
50211057,SP2022 ,13005,515,NULL,1140,14660,0,0,0,NULL,0,0,0,13520,14660,14660,0
50225251,FA2022 ,13005,515,4810,2220,20550,6500,6500,0,NULL,6500,0,6500,7020,14050,14050,0
50225251,FA2023 ,13500,550,5150,2325,21525,6500,5850,650,NULL,6500,0,6500,7550,15025,15025,0
50225251,FA2024 ,14750,600,5720,1270,22340,6500,5500,1000,NULL,6500,0,6500,8850,15840,15840,0
50225251,SP2022 ,13005,515,4810,2220,20550,6500,6500,0,NULL,6500,0,6500,7020,14050,14050,0
50225251,SP2023 ,13500,550,5150,2325,21525,6500,5850,650,NULL,6500,0,6500,7550,15025,15025,0
50225251,SP2024 ,14750,600,5720,1270,22340,6500,5500,1000,NULL,6500,0,6500,8850,15840,15840,0
50232341,FA2024 ,14750,600,4790,2450,22590,7000,7000,0,NULL,7000,0,7000,8350,15590,15590,0
50232341,SP2024 ,14750,600,4790,2450,22590,7500,7500,0,NULL,7500,0,7500,7850,15090,15090,0
50204551,FA2021 ,12625,500,4830,1080,19035,6675,6675,0,3750,8175,0,11925,4950,10860,7110,0
50204551,SP2021 ,12625,500,4830,1080,19035,6675,6675,0,12625,6675,0,19300,6450,12360,-265,0
50222348,FA2024 ,14750,600,5240,2450,23040,0,0,0,NULL,14750,14750,14750,600,8290,8290,62
50222348,SP2024 ,14750,600,5240,2450,23040,0,0,0,NULL,14750,14750,14750,600,8290,8290,62
50206460,FA2021 ,12625,500,3740,1080,17945,9425,0,9425,3750,11925,0,15675,1200,6020,2270,0
50206460,SP2021 ,12625,500,3740,1080,17945,7425,0,7425,3750,7425,0,11175,5700,10520,6770,0
50209036,FA2021 ,19340,860,4910,1080,25330,15500,500,15000,NULL,16000,0,16000,4200,9330,9330,0
50209036,FA2022 ,19910,890,5500,1140,26550,15500,500,15000,NULL,15500,0,15500,5300,11050,11050,0
50209036,FA2023 ,13500,550,NULL,NULL,14050,0,0,0,NULL,0,0,0,14050,14050,14050,0
50209036,SP2021 ,19340,860,4910,1080,25330,15500,500,15000,NULL,15500,0,15500,4700,9830,9830,0
50209036,SP2022 ,19910,890,5500,1140,26550,15500,500,15000,NULL,15500,0,15500,5300,11050,11050,0
50225631,FA2022 ,13005,515,4810,2220,20550,6500,6500,0,14235,7500,0,21735,6020,13050,-1185,0
50225631,SP2022 ,13005,515,4810,2220,20550,6500,6500,0,15736,6500,0,22236,7020,14050,-1686,0
40000953,FA2021 ,3470,NULL,NULL,NULL,3470,0,0,0,NULL,3470,3470,3470,0,0,0,0
50221526,FA2021 ,12625,500,4050,2110,19285,5000,5000,0,14915,6000,0,20915,7125,13285,-1630,0
50221526,SP2021 ,12625,500,4050,2110,19285,5000,5000,0,14914,5000,0,19914,8125,14285,-629,0
50209279,FA2021 ,12625,500,4270,1080,18475,10400,6400,4000,3750,18323,0,22073,-5198,152,-3598,0
50209279,FA2022 ,13005,515,4610,1140,19270,13300,7300,6000,2750,20647,0,23397,-7127,-1377,-4127,0
50209279,SP2021 ,12625,500,4270,NULL,17395,6400,6400,0,3750,15322,0,19072,-2197,2073,-1677,0
50209279,SP2022 ,13005,515,4610,1140,19270,9300,7300,2000,2750,18148,0,20898,-4628,1122,-1628,0
50222420,FA2021 ,12625,500,4580,2110,19815,9000,8000,1000,2750,18723,0,21473,-5598,1092,-1658,0
50222420,SP2021 ,12625,500,4580,2110,19815,9000,8000,1000,2750,14972,0,17722,-1847,4843,2093,0
50222333,FA2021 ,12625,500,4580,2110,19815,5500,5500,0,NULL,6500,0,6500,6625,13315,13315,0
50222333,FA2022 ,13005,515,3855,2220,19595,5000,5000,0,NULL,5000,0,5000,8520,14595,14595,0
50222333,FA2023 ,13500,550,5150,2325,21525,5000,5000,0,NULL,5000,0,5000,9050,16525,16525,0
50222333,FA2024 ,14750,600,4790,2450,22590,5000,5000,0,NULL,5000,0,5000,10350,17590,17590,0
50222333,SP2021 ,12625,500,4580,2110,19815,5500,5500,0,NULL,5500,0,5500,7625,14315,14315,0
50222333,SP2022 ,13005,515,3855,2220,19595,5000,5000,0,NULL,5000,0,5000,8520,14595,14595,0
50222333,SP2023 ,13500,550,5150,2325,21525,5000,5000,0,NULL,5000,0,5000,9050,16525,16525,0
50222333,SP2024 ,14750,600,4790,2450,22590,5000,5000,0,NULL,5000,0,5000,10350,17590,17590,0
50222230,FA2021 ,12625,500,4050,2110,19285,6000,6000,0,NULL,7000,0,7000,6125,12285,12285,29521
50222230,FA2022 ,13005,515,4260,2220,20000,7000,5500,1500,NULL,7000,0,7000,6520,13000,13000,29521
50222230,FA2023 ,13500,550,4560,1200,19810,7000,5500,1500,NULL,7000,0,7000,7050,12810,12810,29521
50222230,FA2024 ,14750,600,5720,1270,22340,8000,5500,2500,NULL,8000,0,8000,7350,14340,14340,29521
50222230,SP2021 ,12625,500,4050,2110,19285,7000,6000,1000,NULL,7000,0,7000,6125,12285,12285,29521
50222230,SP2022 ,13005,515,4260,2220,20000,6000,5500,500,NULL,6000,0,6000,7520,14000,14000,29521
50222230,SP2023 ,13500,550,4560,2325,20935,8000,5500,2500,NULL,8000,0,8000,6050,12935,12935,29521
50222230,SP2024 ,14750,600,5720,1270,22340,7000,5500,1500,NULL,7000,0,7000,8350,15340,15340,29521
50222524,FA2021 ,12625,500,4050,2110,19285,5000,5000,0,NULL,6000,0,6000,7125,13285,13285,30443
50222524,FA2022 ,13005,515,4260,2220,20000,6000,4500,1500,NULL,6000,0,6000,7520,14000,14000,30443
50222524,FA2023 ,13500,550,4560,1200,19810,6000,4500,1500,NULL,6000,0,6000,8050,13810,13810,30443
50222524,FA2024 ,14750,600,5720,NULL,21070,7000,4500,2500,NULL,7000,0,7000,8350,14070,14070,30443
50222524,SP2021 ,12625,500,4050,2110,19285,6000,5000,1000,NULL,6000,0,6000,7125,13285,13285,30443
50222524,SP2022 ,13005,515,4260,2220,20000,5000,4500,500,NULL,5000,0,5000,8520,15000,15000,30443
50222524,SP2023 ,13500,550,4560,1200,19810,7000,4500,2500,NULL,7000,0,7000,7050,12810,12810,30443
50222524,SP2024 ,14750,600,5720,NULL,21070,6000,4500,1500,NULL,6000,0,6000,9350,15070,15070,30443
50222568,FA2021 ,12625,500,4050,2110,19285,5000,5000,0,NULL,6000,0,6000,7125,13285,13285,34453
50222568,FA2022 ,13005,515,3855,2220,19595,6000,4500,1500,NULL,6000,0,6000,7520,13595,13595,34453
50222568,FA2023 ,13500,550,5440,1200,20690,6000,4500,1500,NULL,6000,0,6000,8050,14690,14690,34453
50222568,FA2024 ,14750,600,5720,1270,22340,7000,4500,2500,NULL,7000,0,7000,8350,15340,15340,34453
50222568,SP2021 ,12625,500,4050,2110,19285,6000,5000,1000,NULL,6000,0,6000,7125,13285,13285,34453
50222568,SP2022 ,13005,515,3855,2220,19595,5000,4500,500,NULL,5000,0,5000,8520,14595,14595,34453
50222568,SP2023 ,13500,550,5440,1200,20690,7000,4500,2500,NULL,7000,0,7000,7050,13690,13690,34453
50222568,SP2024 ,14750,600,5720,1270,22340,6000,4500,1500,NULL,6000,0,6000,9350,16340,16340,34453
50203982,FA2021 ,12625,500,4270,5.75,17400.75,7289,7289,0,3750,8789,0,12539,4336,8611.75,4861.75,0
50203982,SP2021 ,12625,500,4270,NULL,17395,7360,7360,0,3750,7360,0,11110,5765,10035,6285,0
50209605,FA2021 ,12625,500,4050,1080,18255,7825,7825,0,3750,9325,0,13075,3800,8930,5180,0
50209605,FA2022 ,13005,515,4610,NULL,18130,7825,7825,0,7145,7825,0,14970,5695,10305,3160,0
50209605,SP2021 ,12625,500,4050,1080,18255,7825,7825,0,3750,7825,0,11575,5300,10430,6680,0
50209605,SP2022 ,13005,515,4610,NULL,18130,7825,7825,0,3750,7825,0,11575,5695,10305,6555,0
50232630,FA2024 ,14750,600,5410,2900,23660,7550,7550,0,16951,9330,0,26281,6020,14330,-2621,15
50232630,SP2024 ,14750,600,5410,2450,23210,7550,7550,0,15802,9330,0,25132,6020,13880,-1922,15
50216856,FA2021 ,12625,500,3740,2110,18975,6625,6625,0,2750,14448,0,17198,-1323,4527,1777,0
50216856,FA2022 ,13005,515,5080,1140,19740,6625,6625,0,3750,13123,0,16873,397,6617,2867,0
50216856,SP2021 ,12625,500,3740,2110,18975,6625,6625,0,2750,12447,0,15197,678,6528,3778,0
50226834,FA2024 ,14750,600,5410,2450,23210,9700,8500,1200,0,22398,0,22398,-7048,812,812,30
50226834,SP2024 ,14750,600,5410,2450,23210,9700,8500,1200,0,22397,0,22397,-7047,813,813,30
50229437,FA2023 ,13500,550,4000,2325,20375,13650,11650,2000,2750,13650,0,16400,400,6725,3975,0
50229437,FA2024 ,14750,600,4790,2450,22590,13650,11650,2000,3250,20388,0,23638,-5038,2202,-1048,0
50229437,SP2023 ,13500,550,4000,2325,20375,11650,11650,0,2750,11650,0,14400,2400,8725,5975,0
50229437,SP2024 ,14750,600,4790,2450,22590,11650,11650,0,3250,18387,0,21637,-3037,4203,953,0
50209633,FA2021 ,12625,500,4270,NULL,17395,925,925,0,3750,1925,0,5675,11200,15470,11720,0
50209633,FA2022 ,13005,515,4810,2220,20550,925,925,0,0,925,0,925,12595,19625,19625,0
50209633,SP2021 ,12625,500,4270,NULL,17395,925,925,0,3750,925,0,4675,12200,16470,12720,0
50209633,SP2022 ,13005,515,4810,2220,20550,1175,1175,0,0,1175,0,1175,12345,19375,19375,0
50216460,FA2021 ,12625,500,3740,2110,18975,9075,9075,0,3250,14723,0,17973,-1598,4252,1002,0
50216460,FA2022 ,13005,515,4610,NULL,18130,9075,9075,0,3750,12923,0,16673,597,5207,1457,0
50216460,FA2023 ,13500,550,5440,NULL,19490,9075,9075,0,3750,13173,0,16923,877,6317,2567,0
50216460,SP2021 ,12625,500,3740,2110,18975,9075,9075,0,3250,13782,0,17032,-657,5193,1943,0
50216460,SP2022 ,13005,515,4610,NULL,18130,9075,9075,0,3750,12922,0,16672,598,5208,1458,0
50216460,SP2023 ,13500,550,5440,NULL,19490,9075,9075,0,3750,13172,0,16922,878,6318,2568,0
50225867,FA2022 ,13005,515,4810,2220,20550,8300,8300,0,2750,12248,0,14998,1272,8302,5552,2947.09
50225867,FA2023 ,13500,550,5150,2325,21525,8300,7300,1000,3250,13398,0,16648,652,8127,4877,2947.09
50225867,FA2024 ,14750,600,5410,2450,23210,9300,5500,3800,3250,13398,0,16648,1952,9812,6562,2947.09
50225867,SP2022 ,13005,515,4810,2220,20550,8300,8300,0,2750,12247,0,14997,1273,8303,5553,2947.09
50225867,SP2023 ,13500,550,5150,2325,21525,8300,7300,1000,3250,13397,0,16647,653,8128,4878,2947.09
50225867,SP2024 ,14750,600,5410,2450,23210,9300,5500,3800,3250,13397,0,16647,1953,9813,6563,2947.09
50232057,FA2024 ,14750,600,5410,2680,23440,1500,0,1500,2750,19948,14750,22698,-4598,3492,742,340
50232057,SP2024 ,14750,600,5410,2680,23440,0,0,0,2750,18447,14750,21197,-3097,4993,2243,340
50216179,FA2021 ,12625,500,3740,2110,18975,5925,5925,0,3250,7425,0,10675,5700,11550,8300,0
50216179,FA2022 ,13005,515,3855,1140,18515,5925,5925,0,15439,5925,0,21364,7595,12590,-2849,0
50216179,FA2023 ,13500,550,4790,1200,20040,5925,5925,0,14750,5925,0,20675,8125,14115,-635,0
50216179,SP2021 ,12625,500,3740,2110,18975,7925,5925,2000,3250,7925,0,11175,5200,11050,7800,0
50216179,SP2022 ,13005,515,3855,1140,18515,5925,5925,0,15439,5925,0,21364,7595,12590,-2849,0
50216179,SP2023 ,13500,550,4790,NULL,18840,5925,5925,0,13750,5925,0,19675,8125,12915,-835,0
50215731,FA2021 ,12625,500,4580,2110,19815,6075,6075,0,3250,17997,0,21247,-4872,1818,-1432,0
50215731,FA2022 ,13005,515,4610,1140,19270,6975,6975,0,3750,16647,0,20397,-3127,2623,-1127,0
50215731,FA2023 ,13500,550,4790,NULL,18840,6975,6975,0,0,14448,0,14448,-398,4392,4392,0
50215731,SP2021 ,12625,500,4580,2110,19815,6075,6075,0,3250,15998,0,19248,-2873,3817,567,0
50215731,SP2022 ,13005,515,4610,1140,19270,6975,6975,0,3750,18948,0,22698,-5428,322,-3428,0
50215731,SP2023 ,13500,550,4790,NULL,18840,6975,6975,0,0,25897,0,25897,-11847,-7057,-7057,0
50203116,FA2021 ,12625,500,5160,1080,19365,0,0,0,3750,2870,0,6620,10255,16495,12745,0
50203116,SP2021 ,12625,500,5160,1080,19365,0,0,0,3750,1870,0,5620,11255,17495,13745,0
50216189,FA2021 ,12625,500,4050,2110,19285,0,0,0,NULL,0,0,0,13125,19285,19285,0
50216189,FA2022 ,13005,515,5420,NULL,18940,0,0,0,NULL,0,0,0,13520,18940,18940,0
50216189,SP2021 ,12625,500,4050,2110,19285,0,0,0,NULL,0,0,0,13125,19285,19285,0
50216189,SP2022 ,13005,515,5420,1140,20080,0,0,0,NULL,0,0,0,13520,20080,20080,0
50229101,FA2023 ,13500,550,5150,2325,21525,6000,6000,0,3750,9973,0,13723,4077,11552,7802,212
50229101,FA2024 ,14750,600,5720,1270,22340,6000,6000,0,3750,10098,0,13848,5252,12242,8492,212
50229101,SP2022 ,13005,515,4260,2220,20000,6500,6500,0,2750,6500,0,9250,7020,13500,10750,212
50229101,SP2023 ,13500,550,5150,2325,21525,6000,6000,0,3750,9972,0,13722,4078,11553,7803,212
50229101,SP2024 ,14750,600,5720,1270,22340,6000,6000,0,3750,10098,0,13848,5252,12242,8492,212
50232075,FA2024 ,14750,600,5410,2450,23210,9000,0,9000,2750,10750,0,13500,4600,12460,9710,0
50232075,SP2024 ,14750,600,5410,2450,23210,9000,0,9000,9150,9000,0,18150,6350,14210,5060,0
50209632,FA2021 ,12625,500,3740,2110,18975,0,0,0,NULL,1500,0,1500,11625,17475,17475,0
50209632,FA2022 ,13005,515,4260,1140,18920,2500,0,2500,NULL,10000,0,10000,3520,8920,8920,0
50209632,SP2021 ,12625,500,3740,2110,18975,0,0,0,NULL,0,0,0,13125,18975,18975,0
50209632,SP2022 ,13005,515,4260,1140,18920,2677,177,2500,NULL,2677,0,2677,10843,16243,16243,0
50233044,FA2024 ,14750,600,4200,2900,22450,11300,10300,1000,2750,17498,0,20248,-2148,4952,2202,100
50233044,SP2024 ,14750,600,4200,2900,22450,10300,10300,0,2750,16372,0,19122,-1022,6078,3328,100
50225881,FA2022 ,13005,515,3855,2220,19595,6500,6500,0,14757,6500,0,21257,7020,13095,-1662,-3035
50225881,FA2023 ,13500,550,5150,2325,21525,6500,4500,2000,15103,6500,0,21603,7550,15025,-78,-3035
50225881,FA2024 ,14750,600,5030,1270,21650,6500,500,6000,19007,6500,0,25507,8850,15150,-3857,-3035
50225881,SP2022 ,13005,515,3855,2220,19595,6500,6500,0,14758,6500,0,21258,7020,13095,-1663,-3035
50225881,SP2023 ,13500,550,5150,2325,21525,6500,4500,2000,15104,6500,0,21604,7550,15025,-79,-3035
50225881,SP2024 ,14750,600,5030,1270,21650,6500,500,6000,19008,6500,0,25508,8850,15150,-3858,-3035
50215181,FA2021 ,12625,500,3740,2110,18975,2175,2175,0,3250,3175,0,6425,9950,15800,12550,0
50215181,FA2022 ,13005,515,4610,1140,19270,2175,2175,0,3750,2175,0,5925,11345,17095,13345,0
50215181,FA2023 ,13500,550,5440,1200,20690,2175,0,2175,3750,2175,0,5925,11875,18515,14765,0
50215181,SP2021 ,12625,500,4240,2110,19475,2175,2175,0,3250,2175,0,5425,10950,17300,14050,0
50215181,SP2022 ,13005,515,4610,1140,19270,2175,2175,0,3750,2175,0,5925,11345,17095,13345,0
50215181,SP2023 ,13500,550,5440,1200,20690,2175,0,2175,3750,2175,0,5925,11875,18515,14765,0
50222045,FA2021 ,12625,500,3740,2110,18975,4500,4500,0,NULL,4500,0,4500,8625,14475,14475,1710
50222045,FA2022 ,13005,515,3855,2220,19595,4500,4500,0,NULL,4500,0,4500,9020,15095,15095,1710
50222045,FA2023 ,13500,550,4790,1200,20040,4500,4500,0,NULL,4500,0,4500,9550,15540,15540,1710
50222045,FA2024 ,14750,600,NULL,1270,16620,3105,3105,0,NULL,3105,0,3105,12245,13515,13515,1710
50222045,SP2021 ,12625,500,3740,2110,18975,4500,4500,0,NULL,4500,0,4500,8625,14475,14475,1710
50222045,SP2022 ,7170,515,3855,2220,13760,2481,2481,0,NULL,2481,0,2481,5204,11279,11279,1710
50222045,SP2023 ,13500,550,4790,1200,20040,4500,4500,0,NULL,4500,0,4500,9550,15540,15540,1710
50222045,SP2024 ,8140,300,NULL,0,8440,1714,1714,0,NULL,1714,0,1714,6726,6726,6726,1710
50210973,FA2021 ,19340,860,5440,2110,26890,7500,7500,0,NULL,7500,0,7500,12700,19390,19390,0
50210973,FA2022 ,19910,890,5150,2220,27280,7500,7500,0,NULL,7500,0,7500,13300,19780,19780,0
50210973,SP2021 ,19340,860,5440,2110,26890,7500,7500,0,NULL,7500,0,7500,12700,19390,19390,0
50210973,SP2022 ,19910,890,5150,2220,27280,7500,7500,0,NULL,7500,0,7500,13300,19780,19780,0
50216725,FA2021 ,12625,500,3740,2110,18975,5175,4550,625,NULL,8915,0,8915,4210,10060,10060,0
50216725,FA2022 ,13005,515,4260,2220,20000,5175,625,4550,NULL,9435,0,9435,4085,10565,10565,0
50216725,SP2021 ,12625,500,3740,2110,18975,5175,4550,625,NULL,8915,0,8915,4210,10060,10060,0
50216725,SP2022 ,13005,515,4260,2220,20000,5175,625,4550,NULL,9435,0,9435,4085,10565,10565,0
50216725,SP2023 ,13500,550,5440,NULL,19490,5975,800,5175,NULL,5975,0,5975,8075,13515,13515,0
50216958,FA2021 ,12625,500,3740,2110,18975,0,0,0,NULL,16865,12625,16865,-3740,2110,2110,0
50216958,SP2021 ,12625,500,3740,2110,18975,0,0,0,NULL,16365,12625,16365,-3240,2610,2610,0
50205477,FA2021 ,12625,500,3740,2110,18975,5175,5175,0,3750,9248,0,12998,3877,9727,5977,0
50205477,SP2021 ,12625,500,3740,2110,18975,5175,5175,0,3750,7247,0,10997,5878,11728,7978,0
50156716,FA2021 ,12625,500,3740,2110,18975,2145,2145,0,3250,13875,10730,17125,-750,5100,1850,0
50156716,FA2022 ,13005,515,NULL,1140,14660,395,395,0,0,11505,11110,11505,2015,3155,3155,0
50156716,FA2023 ,13500,550,NULL,1200,15250,1025,1025,0,3750,12500,11475,16250,1550,2750,-1000,0
50156716,SP2021 ,12625,500,3740,2110,18975,1895,1895,0,3250,12625,10730,15875,500,6350,3100,0
50156716,SP2022 ,13005,515,NULL,1140,14660,395,395,0,0,11505,11110,11505,2015,3155,3155,0
50156716,SP2023 ,13500,550,NULL,1200,15250,1025,1025,0,3750,12500,11475,16250,1550,2750,-1000,0
50229075,FA2023 ,13500,550,4000,2325,20375,7000,7000,0,16301,7000,0,23301,7050,13375,-2926,-389.56
50229075,FA2024 ,14750,600,4200,2450,22000,7000,7000,0,14250,7000,0,21250,8350,15000,750,-389.56
50229075,SP2023 ,13500,550,4000,2325,20375,7000,7000,0,15101,7000,0,22101,7050,13375,-1726,-389.56
50229075,SP2024 ,14750,600,4200,2450,22000,7000,7000,0,14250,7000,0,21250,8350,15000,750,-389.56
50227707,FA2023 ,13500,550,5150,2325,21525,7000,7000,0,NULL,7000,0,7000,7050,14525,14525,0
50231586,FA2024 ,14750,600,5410,2450,23210,10050,10050,0,8500,10350,0,18850,5000,12860,4360,0
50231586,SP2024 ,14750,600,5410,2450,23210,10050,10050,0,8500,10350,0,18850,5000,12860,4360,0
50222439,FA2021 ,12625,500,4270,1080,18475,6125,5950,175,15005,7625,0,22630,5500,10850,-4155,0
50222439,FA2022 ,13005,515,4810,2220,20550,6125,5950,175,13342,6125,0,19467,7395,14425,1083,0
50222439,SP2021 ,12625,500,4270,1080,18475,6125,5950,175,14570,6125,0,20695,7000,12350,-2220,0
50222439,SP2022 ,13850,515,4810,2220,21395,6125,5950,175,7738,6125,0,13863,8240,15270,7532,0
50118831,FA2021 ,12625,500,4580,2550,20255,4175,4175,0,NULL,4175,0,4175,8950,16080,16080,0
50118831,FA2022 ,13005,515,4810,2690,21020,4175,4175,0,NULL,4175,0,4175,9345,16845,16845,0
50118831,FA2023 ,13500,550,5440,2745,22235,4475,4175,300,NULL,4475,0,4475,9575,17760,17760,0
50118831,SP2021 ,12625,500,4580,2550,20255,4175,4175,0,NULL,4175,0,4175,8950,16080,16080,0
50118831,SP2022 ,13005,515,4810,2690,21020,4175,4175,0,NULL,4175,0,4175,9345,16845,16845,0
50118831,SP2023 ,13500,6825,6825,NULL,20325,4475,4175,300,NULL,4475,0,4475,15850,15850,15850,0
50119447,FA2022 ,13005,515,4810,2690,21020,7250,7250,0,2750,7250,0,10000,6270,13770,11020,0
50119447,FA2023 ,13500,550,5150,2745,21945,7250,7250,0,NULL,7250,0,7250,6800,14695,14695,0
50119447,FA2024 ,14750,600,6090,2680,24120,7250,7250,0,NULL,7250,0,7250,8100,16870,16870,0
50119447,SP2022 ,13005,515,4810,2690,21020,7250,7250,0,2750,7250,0,10000,6270,13770,11020,0
50119447,SP2023 ,13500,550,5150,2745,21945,7250,7250,0,NULL,7250,0,7250,6800,14695,14695,0
50119447,SP2024 ,14750,600,6090,2680,24120,7250,7250,0,NULL,7250,0,7250,8100,16870,16870,0
50209232,FA2021 ,12625,500,4580,2110,19815,5825,5825,0,2750,7325,0,10075,5800,12490,9740,0
50209232,FA2022 ,13005,515,4610,1140,19270,5825,0,5825,2750,5825,0,8575,7695,13445,10695,0
50209232,SP2021 ,12625,500,4580,2110,19815,5825,5825,0,3750,5825,0,9575,7300,13990,10240,0
50209232,SP2022 ,13005,515,4610,1140,19270,5825,0,5825,3750,5825,0,9575,7695,13445,9695,0
50234773,FA2024 ,14750,600,4200,1270,20820,6000,6000,0,NULL,6000,0,6000,9350,14820,14820,12656.17
50234773,SP2024 ,14750,600,4200,1270,20820,6000,6000,0,NULL,6000,0,6000,9350,14820,14820,12656.17
50226724,FA2024 ,14750,600,4200,1270,20820,6500,6500,0,2750,6500,0,9250,8850,14320,11570,0
50226724,SP2024 ,14750,600,4200,2900,22450,6500,6500,0,2750,6500,0,9250,8850,15950,13200,0
50154953,FA2021 ,12625,500,4580,2110,19815,5500,5500,0,NULL,5500,0,5500,7625,14315,14315,25
50154953,FA2022 ,13005,515,4260,2220,20000,5000,5000,0,NULL,5000,0,5000,8520,15000,15000,25
50154953,FA2023 ,13500,550,5440,1200,20690,5000,5000,0,NULL,5000,0,5000,9050,15690,15690,25
50154953,FA2024 ,14750,600,NULL,NULL,15350,3450,3450,0,NULL,3450,0,3450,11900,11900,11900,25
50154953,SP2021 ,12625,500,4580,2110,19815,5500,5500,0,NULL,5500,0,5500,7625,14315,14315,25
50154953,SP2022 ,13005,515,4260,2220,20000,5000,5000,0,NULL,5000,0,5000,8520,15000,15000,25
50154953,SP2023 ,13500,550,5440,1200,20690,5000,5000,0,NULL,5000,0,5000,9050,15690,15690,25
50154953,SP2024 ,14750,600,NULL,NULL,15350,3450,3450,0,NULL,3450,0,3450,11900,11900,11900,25
50228211,FA2023 ,13500,550,5150,2535,21735,6000,6000,0,2750,6000,0,8750,8050,15735,12985,0
50228211,FA2024 ,14750,600,5030,1270,21650,6000,6000,0,3250,8100,0,11350,7250,13550,10300,0
50228211,SP2023 ,13500,550,5150,2325,21525,6000,6000,0,2750,6000,0,8750,8050,15525,12775,0
50228211,SP2024 ,14750,600,5030,1270,21650,6000,6000,0,3250,8100,0,11350,7250,13550,10300,0
50154226,FA2023 ,13500,550,4000,2325,20375,0,0,0,NULL,13500,13500,13500,550,6875,6875,0
50154226,FA2024 ,14750,600,4200,2450,22000,0,0,0,NULL,18950,14750,18950,-3600,3050,3050,0
50154226,SP2023 ,13500,550,4000,2325,20375,0,0,0,NULL,13500,13500,13500,550,6875,6875,0
50154226,SP2024 ,14750,600,4200,2450,22000,0,0,0,NULL,18950,14750,18950,-3600,3050,3050,0
50215185,FA2021 ,12625,500,3740,2110,18975,2925,2425,500,3750,3925,0,7675,9200,15050,11300,0
50215185,FA2022 ,13005,515,5420,1140,20080,1263,100,1163,3750,1263,0,5013,12257,18817,15067,0
50215185,SP2021 ,12625,500,3740,2110,18975,2925,2425,500,3750,2925,0,6675,10200,16050,12300,0
50215185,SP2022 ,13005,6590,6590,NULL,19595,1662,500,1162,3750,1662,0,5412,17933,17933,14183,0
50232759,FA2024 ,14750,600,5410,2450,23210,7000,7000,0,0,7000,0,7000,8350,16210,16210,3404.65
50232759,SP2024 ,14750,600,5410,2450,23210,7000,7000,0,0,7000,0,7000,8350,16210,16210,3404.65
50234627,FA2024 ,14750,600,4790,2450,22590,6000,6000,0,2750,6000,0,8750,9350,16590,13840,4691.32
50234627,SP2024 ,14750,600,4790,2450,22590,6000,6000,0,2750,6000,0,8750,9350,16590,13840,4691.32
50216226,FA2021 ,12625,500,4050,1080,18255,3925,3925,0,14250,5425,0,19675,7700,12830,-1420,0
50216226,SP2021 ,12625,500,4050,1080,18255,3925,3925,0,14250,3925,0,18175,9200,14330,80,0
50216351,FA2021 ,12625,500,3740,2110,18975,9175,9175,0,3250,10675,0,13925,2450,8300,5050,0
50216351,FA2022 ,13005,515,4610,NULL,18130,9175,9175,0,3750,9175,0,12925,4345,8955,5205,0
50216351,FA2023 ,13500,550,NULL,NULL,14050,7675,7675,0,6250,11373,0,17623,2677,2677,-3573,0
50216351,SP2021 ,12625,500,3740,2110,18975,9175,9175,0,3250,9175,0,12425,3950,9800,6550,0
50216351,SP2022 ,13005,515,4610,NULL,18130,9175,9175,0,3750,9175,0,12925,4345,8955,5205,0
50233645,FA2024 ,14750,600,4790,2450,22590,7500,7500,0,3750,7500,0,11250,7850,15090,11340,0
50233645,SP2024 ,14750,600,4790,2450,22590,7500,7500,0,3750,7500,0,11250,7850,15090,11340,0
50217465,FA2021 ,12625,500,4580,2110,19815,8175,0,8175,10650,11448,0,22098,1677,8367,-2283,0
50217465,FA2022 ,13005,515,4810,2220,20550,8175,0,8175,8750,12023,0,20773,1497,8527,-223,0
50217465,FA2023 ,13500,550,5440,1200,20690,8175,0,8175,10250,11248,0,21498,2802,9442,-808,0
50217465,SP2022 ,13005,515,4810,2220,20550,8175,0,8175,9388,12022,0,21410,1498,8528,-860,0
50217465,SP2023 ,13500,550,5440,1200,20690,8175,0,8175,10550,11247,0,21797,2803,9443,-1107,0
50214451,FA2021 ,12625,500,3740,2110,18975,5675,5250,425,3250,10915,0,14165,2210,8060,4810,0
50214451,FA2022 ,13005,515,4610,NULL,18130,5675,0,5675,3750,5675,0,9425,7845,12455,8705,0
50214451,FA2023 ,13500,550,4790,NULL,18840,6175,500,5675,3750,6175,0,9925,7875,12665,8915,0
50214451,SP2021 ,12625,500,3740,2110,18975,5675,5250,425,3250,9415,0,12665,3710,9560,6310,0
50214451,SP2022 ,13005,6590,6590,NULL,19595,2400,1900,500,3750,2400,0,6150,17195,17195,13445,0
50214451,SP2023 ,13500,550,4790,NULL,18840,6175,500,5675,3750,6175,0,9925,7875,12665,8915,0
50233284,FA2024 ,14750,600,5720,2450,23520,5500,5500,0,13915,5500,0,19415,9850,18020,4105,115
50233284,SP2023 ,13500,550,5440,2325,21815,5500,5500,0,19131,5500,0,24631,8550,16315,-2816,115
50233284,SP2024 ,14750,600,5720,1270,22340,5500,5500,0,21616,5500,0,27116,9850,16840,-4776,115
50229430,FA2023 ,13500,550,4000,2325,20375,8950,8950,0,13125,11323,0,24448,2727,9052,-4073,0
50229430,FA2024 ,14750,600,5410,2450,23210,9950,7000,2950,14490,12448,0,26938,2902,10762,-3728,0
50229430,SP2023 ,13500,550,4000,2325,20375,8950,8950,0,4800,11322,0,16122,2728,9053,4253,0
50229430,SP2024 ,14750,600,5410,2450,23210,9950,7000,2950,9926,12447,0,22373,2903,10763,837,0
50215732,FA2021 ,12625,500,4050,2110,19285,6675,6675,0,2750,8175,0,10925,4950,11110,8360,0
50215732,SP2021 ,12625,500,4050,2110,19285,6675,6675,0,2750,6675,0,9425,6450,12610,9860,0
50229153,FA2023 ,13500,550,5150,2325,21525,9500,7500,2000,2750,9500,0,12250,4550,12025,9275,0
50229153,FA2024 ,14750,600,5410,2450,23210,10500,7500,3000,NULL,10500,0,10500,4850,12710,12710,0
50229153,SP2023 ,13500,550,5150,2325,21525,7500,7500,0,2750,7500,0,10250,6550,14025,11275,0
50229153,SP2024 ,14750,600,5410,2450,23210,8500,7500,1000,NULL,8500,0,8500,6850,14710,14710,0
50232961,FA2024 ,14750,600,5410,2450,23210,11000,9000,2000,10900,17997,0,28897,-2647,5213,-5687,-148
50232961,SP2024 ,14750,600,5410,2450,23210,9000,9000,0,5570,14442,0,20012,908,8768,3198,-148
50221439,FA2021 ,12625,500,4580,2110,19815,8000,8000,0,14244,9000,0,23244,4125,10815,-3429,0
50221439,FA2022 ,13005,515,3855,2220,19595,7500,7500,0,19017,7500,0,26517,6020,12095,-6922,0
50221439,FA2023 ,13500,550,4000,2325,20375,7500,7500,0,13692,7500,0,21192,6550,12875,-817,0
50221439,FA2024 ,14750,600,4200,2450,22000,7500,7500,0,14192,7500,0,21692,7850,14500,308,0
50221439,SP2021 ,12625,500,4580,2110,19815,8000,8000,0,12139,8000,0,20139,5125,11815,-324,0
50221439,SP2022 ,13005,515,3855,2220,19595,7500,7500,0,8575,7500,0,16075,6020,12095,3520,0
50221439,SP2023 ,13500,550,4000,2325,20375,7500,7500,0,13692,7500,0,21192,6550,12875,-817,0
50221439,SP2024 ,14750,600,NULL,NULL,15350,5175,5175,0,3750,5175,0,8925,10175,10175,6425,0
50229468,FA2023 ,13500,550,4000,2325,20375,9000,9000,0,2750,15823,0,18573,-1773,4552,1802,0
50229468,FA2024 ,14750,600,4790,2450,22590,9150,9000,150,0,22698,0,22698,-7348,-108,-108,0
50229468,SP2023 ,13500,550,4000,2325,20375,9000,9000,0,2750,15822,0,18572,-1772,4553,1803,0
50229468,SP2024 ,14750,600,4790,2450,22590,9150,9000,150,0,22697,0,22697,-7347,-107,-107,0
50227282,FA2022 ,13005,515,NULL,NULL,13520,4554,4554,0,3750,4554,0,8304,8966,8966,5216,0
50227282,FA2023 ,13500,550,NULL,NULL,14050,6554,5454,1100,3750,9826,0,13576,4224,4224,474,0
50227282,SP2022 ,13005,515,NULL,NULL,13520,4554,4554,0,3750,4554,0,8304,8966,8966,5216,0
50218598,FA2021 ,12625,500,3740,2110,18975,4825,4825,0,3250,6325,0,9575,6800,12650,9400,0
50218598,FA2022 ,13005,515,3855,2220,19595,6575,5075,1500,3750,6575,0,10325,6945,13020,9270,0
50218598,FA2023 ,13500,550,4790,NULL,18840,7325,0,7325,3750,8325,0,12075,5725,10515,6765,0
50218598,SP2021 ,12625,500,3740,2110,18975,4825,4825,0,3250,4825,0,8075,8300,14150,10900,0
50218598,SP2022 ,13005,515,3855,1140,18515,6325,4825,1500,3750,6325,0,10075,7195,12190,8440,0
50224438,FA2021 ,12625,500,4240,2110,19475,6800,6800,0,15236,7800,0,23036,5325,11675,-3561,1125
50224438,FA2022 ,13005,515,3855,2220,19595,6300,6300,0,13692,8023,0,21715,5497,11572,-2120,1125
50224438,FA2023 ,13500,550,5800,1200,21050,6300,5000,1300,17621,9822,0,27443,4228,11228,-6393,1125
50224438,SP2021 ,12625,500,3740,2110,18975,6800,6800,0,11375,6800,0,18175,6325,12175,800,1125
50224438,SP2022 ,13005,515,3855,2220,19595,6300,6300,0,10527,8022,0,18549,5498,11573,1046,1125
50224438,SP2023 ,13500,550,5800,2325,22175,6300,5000,1300,8376,9823,0,18199,4227,12352,3976,1125
50228716,FA2023 ,13500,550,4560,2325,20935,9000,7000,2000,0,9000,0,9000,5050,11935,11935,25
50228716,FA2024 ,14750,600,4790,2450,22590,9000,7000,2000,3250,9000,0,12250,6350,13590,10340,25
50228716,SP2023 ,13500,550,4560,2325,20935,7000,7000,0,0,7000,0,7000,7050,13935,13935,25
50228716,SP2024 ,14750,600,4790,2450,22590,7000,7000,0,3250,7000,0,10250,8350,15590,12340,25
50225450,FA2022 ,13005,515,4810,2220,20550,7700,7700,0,2750,14648,0,17398,-1128,5902,3152,0
50225450,FA2023 ,13500,550,5150,2325,21525,7200,7200,0,3250,15298,0,18548,-1248,6227,2977,0
50225450,FA2024 ,14750,600,5410,2450,23210,7700,6000,1700,3750,15298,0,19048,52,7912,4162,0
50225450,SP2022 ,13005,515,4810,2220,20550,7700,7700,0,2750,11147,0,13897,2373,9403,6653,0
50225450,SP2023 ,13500,550,5150,2325,21525,7200,7200,0,3250,11797,0,15047,2253,9728,6478,0
50225450,SP2024 ,14750,600,5410,2450,23210,7700,6000,1700,3750,11797,0,15547,3553,11413,7663,0
9484562,FA2023 ,3720,NULL,NULL,NULL,3720,0,0,0,NULL,3720,3720,3720,0,0,0,0
50216557,FA2021 ,12625,500,4580,2110,19815,8025,8025,0,5250,13448,0,18698,-323,6367,1117,0
50216557,FA2022 ,13005,515,5080,1140,19740,8025,8025,0,5750,11048,0,16798,2472,8692,2942,0
50216557,FA2023 ,13500,550,4560,2325,20935,8025,8025,0,5750,9275,0,15025,4775,11660,5910,0
50216557,SP2021 ,12625,500,4580,2110,19815,8025,8025,0,5250,11447,0,16697,1678,8368,3118,0
50216557,SP2022 ,13005,515,5080,1140,19740,8025,8025,0,5750,11047,0,16797,2473,8693,2943,0
50216557,SP2023 ,13500,550,4560,2325,20935,8025,8025,0,5750,9275,0,15025,4775,11660,5910,0
50216557,SP2024 ,6090,300,NULL,NULL,6390,2268,2268,0,3750,4067,0,7817,2323,2323,-1427,0
50221877,FA2021 ,12625,500,4580,2110,19815,5500,5500,0,2750,6500,0,9250,6625,13315,10565,0
50221877,SP2021 ,12625,500,4580,2110,19815,5500,5500,0,2750,5500,0,8250,7625,14315,11565,0
50155886,FA2023 ,3720,NULL,NULL,NULL,3720,0,0,0,NULL,3720,3720,3720,0,0,0,0
50210223,FA2022 ,13005,515,5420,1140,20080,3425,1700,1725,16900,3425,0,20325,10095,16655,-245,0
50210223,SP2021 ,12625,500,4580,2110,19815,3425,0,3425,16750,3425,0,20175,9700,16390,-360,0
50210223,SP2022 ,13005,515,5420,1140,20080,3425,1700,1725,16900,3425,0,20325,10095,16655,-245,0
50213045,FA2021 ,12625,500,3740,2110,18975,2825,0,2825,3750,4325,0,8075,8800,14650,10900,0
50213045,FA2022 ,13005,515,4260,2220,20000,2825,0,2825,3750,2825,0,6575,10695,17175,13425,0
50213045,SP2021 ,12625,500,3740,2110,18975,2825,0,2825,3750,2825,0,6575,10300,16150,12400,0
50213045,SP2022 ,13005,515,4260,2220,20000,2825,0,2825,3750,2825,0,6575,10695,17175,13425,0
50221687,FA2021 ,12625,500,3740,2110,18975,9500,0,9500,NULL,10500,0,10500,2625,8475,8475,2120.68
50221687,FA2022 ,13005,515,3855,2220,19595,10000,500,9500,NULL,10000,0,10000,3520,9595,9595,2120.68
50221687,FA2023 ,13500,550,4000,2325,20375,9550,0,9550,NULL,13550,0,13550,500,6825,6825,2120.68
50221687,FA2024 ,14750,600,4200,2450,22000,12000,0,12000,NULL,16700,0,16700,-1350,5300,5300,2120.68
50221687,SP2021 ,12625,500,3740,2110,18975,9500,0,9500,NULL,9500,0,9500,3625,9475,9475,2120.68
50221687,SP2022 ,13005,515,3855,2220,19595,10000,500,9500,NULL,10000,0,10000,3520,9595,9595,2120.68
50221687,SP2023 ,13500,550,4000,2325,20375,9500,0,9500,NULL,13500,0,13500,550,6875,6875,2120.68
50221687,SP2024 ,14750,600,4200,2450,22000,12000,0,12000,NULL,16200,0,16200,-850,5800,5800,2120.68
50225883,FA2022 ,13005,515,4260,2220,20000,7950,7950,0,2750,7950,0,10700,5570,12050,9300,0
50225883,FA2023 ,13500,550,4560,2325,20935,7713,7713,0,3250,7950,0,11200,6100,12985,9735,0
50225883,FA2024 ,14750,600,NULL,NULL,15350,5485,3035,2450,3750,5485,0,9235,9865,9865,6115,0
50225883,SP2022 ,13005,515,4260,2220,20000,7950,7950,0,2750,7950,0,10700,5570,12050,9300,0
50225883,SP2023 ,13500,550,4560,2325,20935,7712,7712,0,3250,7950,0,11200,6100,12985,9735,0
50225883,SP2024 ,14750,600,NULL,NULL,15350,5486,3036,2450,3750,5486,0,9236,9864,9864,6114,0
50225327,FA2022 ,13005,515,4810,2220,20550,5750,5750,0,2750,5750,0,8500,7770,14800,12050,2711
50225327,FA2023 ,13500,550,NULL,NULL,14050,3967,3967,0,3250,3967,0,7217,10083,10083,6833,2711
50225327,FA2024 ,14750,600,NULL,NULL,15350,3967,3967,0,3750,3967,0,7717,11383,11383,7633,2711
50225327,SP2022 ,13005,515,4810,2220,20550,5750,5750,0,2750,5750,0,8500,7770,14800,12050,2711
50225327,SP2023 ,13500,550,NULL,NULL,14050,3968,3968,0,3250,3968,0,7218,10082,10082,6832,2711
50225327,SP2024 ,14750,600,NULL,NULL,15350,3968,3968,0,3750,3968,0,7718,11382,11382,7632,2711
50196363,FA2021 ,12625,500,NULL,NULL,13125,2425,2425,0,3750,6298,0,10048,6827,6827,3077,0
50228159,FA2023 ,13500,550,5150,2745,21945,7700,7000,700,12017,11398,0,23415,2652,10547,-1470,0
50228159,SP2023 ,13500,550,5150,2325,21525,7700,7000,700,11403,11397,0,22800,2653,10128,-1275,0
50213578,FA2021 ,12625,500,4830,1080,19035,3925,3925,0,17657,5425,0,23082,7700,13610,-4047,0
50213578,SP2021 ,12625,500,4830,1080,19035,3925,3925,0,17657,3925,0,21582,9200,15110,-2547,0
50226306,FA2022 ,13005,515,3855,2220,19595,5000,5000,0,NULL,5000,0,5000,8520,14595,14595,0
50226306,FA2023 ,13500,550,4000,2325,20375,5000,5000,0,NULL,5000,0,5000,9050,15375,15375,0
50226306,FA2024 ,14750,600,5720,NULL,21070,5000,5000,0,NULL,5000,0,5000,10350,16070,16070,0
50226306,SP2022 ,13005,515,3855,2220,19595,5000,5000,0,NULL,5000,0,5000,8520,14595,14595,0
50226306,SP2023 ,13500,550,4000,2325,20375,5000,5000,0,NULL,5000,0,5000,9050,15375,15375,0
50226306,SP2024 ,14750,600,5720,NULL,21070,5000,5000,0,NULL,5000,0,5000,10350,16070,16070,0
50235088,FA2024 ,14750,600,5240,2450,23040,0,0,0,3253,18448,14750,21701,-3098,4592,1339,0
50235088,SP2024 ,14750,600,5240,1270,21860,0,0,0,3252,18447,14750,21699,-3097,3413,161,0
50233570,FA2024 ,14750,600,4200,2450,22000,6000,6000,0,14142,9698,0,23840,5652,12302,-1840,1030
50233570,SP2024 ,14750,600,4200,2450,22000,6000,6000,0,11813,9697,0,21510,5653,12303,490,1030
50227841,SP2022 ,13005,515,NULL,NULL,13520,0,0,0,2750,9754,9754,12504,3766,3766,1016,0
50227841,SP2023 ,13500,550,NULL,NULL,14050,0,0,0,7807,13500,13500,21307,550,550,-7257,0
50221709,FA2021 ,12625,500,4580,2110,19815,6000,6000,0,NULL,6000,0,6000,7125,13815,13815,0
50221709,FA2022 ,13005,515,4810,2220,20550,5500,5500,0,3250,5500,0,8750,8020,15050,11800,0
50221709,FA2023 ,13500,550,4000,2325,20375,5500,5500,0,NULL,5500,0,5500,8550,14875,14875,0
50221709,FA2024 ,14750,600,5030,1270,21650,5500,5500,0,NULL,5500,0,5500,9850,16150,16150,0
50221709,SP2021 ,12625,500,4580,2110,19815,6000,6000,0,NULL,6000,0,6000,7125,13815,13815,0
50221709,SP2022 ,13005,515,4810,2220,20550,5500,5500,0,3250,5500,0,8750,8020,15050,11800,0
50221709,SP2023 ,13500,550,4000,2325,20375,5500,5500,0,NULL,5500,0,5500,8550,14875,14875,0
50221709,SP2024 ,14750,600,5030,1270,21650,5500,5500,0,NULL,5500,0,5500,9850,16150,16150,0
50228385,SP2022 ,14269,7231,7231,NULL,21500,0,0,0,NULL,0,0,0,21500,21500,21500,0
50231606,FA2024 ,14750,600,4200,2450,22000,8950,8950,0,2750,8950,0,11700,6400,13050,10300,0
50231606,SP2024 ,14750,600,4200,2450,22000,8950,8950,0,2750,8950,0,11700,6400,13050,10300,0
50199296,FA2021 ,12625,500,5160,NULL,18285,0,0,0,19192,1500,0,20692,11625,16785,-2407,0
50210138,FA2021 ,12625,500,4270,2550,19945,2425,2425,0,NULL,2425,0,2425,10700,17520,17520,0
50210138,FA2022 ,13005,515,4610,1140,19270,2425,2425,0,NULL,2425,0,2425,11095,16845,16845,0
50210138,SP2021 ,12625,500,4270,1080,18475,2425,2425,0,NULL,2425,0,2425,10700,16050,16050,0
50210138,SP2022 ,13005,515,4610,1140,19270,2425,2425,0,NULL,2425,0,2425,11095,16845,16845,0
50217149,FA2021 ,12625,500,4050,2110,19285,4925,4925,0,17358,5925,0,23283,7200,13360,-3998,170
50217149,FA2022 ,13005,515,5080,1140,19740,4925,4925,0,12271,4925,0,17196,8595,14815,2544,170
50217149,FA2023 ,13500,550,5440,1200,20690,4925,4925,0,13820,4925,0,18745,9125,15765,1945,170
50217149,SP2021 ,12625,500,4050,2110,19285,4925,4925,0,10681,4925,0,15606,8200,14360,3679,170
50217149,SP2022 ,13005,515,5080,1140,19740,4925,4925,0,0,4925,0,4925,8595,14815,14815,170
50217149,SP2023 ,7450,550,5440,1200,14640,2718,2718,0,15891,2718,0,18609,5282,11922,-3969,170
50224695,FA2022 ,13005,515,3855,2690,20065,6250,6250,0,NULL,6250,0,6250,7270,13815,13815,0
50224695,FA2023 ,13500,550,5150,2745,21945,6250,6250,0,NULL,6250,0,6250,7800,15695,15695,0
50224695,FA2024 ,14750,600,5720,2450,23520,6250,6250,0,NULL,6250,0,6250,9100,17270,17270,0
50224695,SP2022 ,13005,515,3855,2690,20065,6250,6250,0,NULL,6250,0,6250,7270,13815,13815,0
50224695,SP2023 ,13500,550,5150,2745,21945,6250,6250,0,NULL,6250,0,6250,7800,15695,15695,0
50224695,SP2024 ,14750,600,5720,2450,23520,6250,6250,0,NULL,6250,0,6250,9100,17270,17270,0
50225085,FA2022 ,13005,515,3855,2690,20065,6750,6750,0,2750,6750,0,9500,6770,13315,10565,0
50225085,FA2023 ,13500,550,5150,2325,21525,6750,5500,1250,3250,6750,0,10000,7300,14775,11525,0
50225085,FA2024 ,14750,600,4200,2900,22450,6750,5500,1250,3750,6750,0,10500,8600,15700,11950,0
50225085,SP2022 ,13005,515,3855,2690,20065,6750,6750,0,2750,6750,0,9500,6770,13315,10565,0
50225085,SP2023 ,13500,550,5150,2325,21525,6750,5500,1250,3250,6750,0,10000,7300,14775,11525,0
50225085,SP2024 ,14750,600,4200,2450,22000,6750,5500,1250,3750,6750,0,10500,8600,15250,11500,0
50226837,FA2023 ,13500,550,5150,2325,21525,8000,8000,0,NULL,8000,0,8000,6050,13525,13525,-40
50226837,FA2024 ,14750,600,5410,2450,23210,7500,7500,0,NULL,7500,0,7500,7850,15710,15710,-40
50226837,SP2023 ,13500,550,5150,2325,21525,8000,8000,0,NULL,8000,0,8000,6050,13525,13525,-40
50226837,SP2024 ,14750,600,5410,2450,23210,7500,7500,0,NULL,7500,0,7500,7850,15710,15710,-40
50230211,FA2023 ,14500,7000,7000,NULL,21500,0,0,0,NULL,0,0,0,21500,21500,21500,0
50235003,FA2024 ,14750,600,4200,1270,20820,10400,6500,3900,14249,10400,0,24649,4950,10420,-3829,-3997
50235003,SP2024 ,14750,600,4200,1270,20820,10400,6500,3900,14249,10400,0,24649,4950,10420,-3829,-3997
50198991,FA2021 ,12625,500,3740,1080,17945,4925,4925,0,3000,8295,0,11295,4830,9650,6650,0
50198991,SP2021 ,12625,500,3740,NULL,16865,4925,4925,0,3000,6795,0,9795,6330,10070,7070,0
50206769,SP2022 ,13005,515,3855,2220,19595,7425,7425,0,NULL,7425,0,7425,6095,12170,12170,0
50223304,FA2021 ,12625,500,3740,2110,18975,9500,7500,2000,NULL,10500,0,10500,2625,8475,8475,0
50223304,FA2022 ,13005,515,3855,2220,19595,7000,7000,0,NULL,7000,0,7000,6520,12595,12595,0
50223304,FA2023 ,13500,550,4000,2325,20375,7000,7000,0,NULL,7000,0,7000,7050,13375,13375,0
50223304,SP2021 ,12625,500,3740,2110,18975,7500,7500,0,NULL,7500,0,7500,5625,11475,11475,0
50223304,SP2022 ,13005,515,3855,2220,19595,7000,7000,0,NULL,7000,0,7000,6520,12595,12595,0
50224668,FA2022 ,13005,515,3855,2220,19595,8500,8500,0,2750,8500,0,11250,5020,11095,8345,165
50224668,FA2023 ,13500,550,4560,2325,20935,8500,8500,0,3250,8500,0,11750,5550,12435,9185,165
50224668,FA2024 ,14750,600,5720,NULL,21070,8500,8500,0,3750,8500,0,12250,6850,12570,8820,165
50224668,SP2022 ,13005,515,3855,2220,19595,8500,8500,0,2750,8500,0,11250,5020,11095,8345,165
50224668,SP2023 ,13500,550,5440,NULL,19490,8500,8500,0,3250,8500,0,11750,5550,10990,7740,165
50224668,SP2024 ,14750,600,5720,NULL,21070,8500,8500,0,3750,8500,0,12250,6850,12570,8820,165
50210237,FA2021 ,12625,500,NULL,NULL,13125,6325,5325,1000,3750,7825,0,11575,5300,5300,1550,0
50210237,FA2022 ,13005,515,NULL,NULL,13520,6075,5325,750,3750,9825,0,13575,3695,3695,-55,0
50210237,SP2021 ,12625,500,NULL,NULL,13125,6325,5325,1000,3750,6325,0,10075,6800,6800,3050,0
50210237,SP2022 ,13005,515,NULL,NULL,13520,6075,5325,750,3750,9825,0,13575,3695,3695,-55,0
50221527,FA2021 ,12625,500,NULL,NULL,13125,4545,3795,750,2750,5545,0,8295,7580,7580,4830,7970
50221527,FA2022 ,13005,515,NULL,NULL,13520,7217,4467,2750,3250,7217,0,10467,6303,6303,3053,7970
50221527,FA2023 ,13500,550,NULL,NULL,14050,8045,3795,4250,3750,8045,0,11795,6005,6005,2255,7970
50221527,FA2024 ,14750,600,NULL,NULL,15350,7347,3097,4250,3750,8367,0,12117,6983,6983,3233,7970
50221527,SP2021 ,12625,500,NULL,NULL,13125,4545,3795,750,2750,4545,0,7295,8580,8580,5830,7970
50221527,SP2022 ,13005,515,NULL,NULL,13520,5218,4468,750,3250,5218,0,8468,8302,8302,5052,7970
50221527,SP2023 ,13500,550,NULL,NULL,14050,6045,3795,2250,3750,7945,0,11695,6105,6105,2355,7970
50221527,SP2024 ,14750,600,NULL,NULL,15350,5348,3098,2250,3750,6368,0,10118,8982,8982,5232,7970
50231896,FA2024 ,14750,600,4200,2450,22000,9500,0,9500,2750,11718,0,14468,3632,10282,7532,2665.66
50231896,SP2024 ,15720,600,4200,2450,22970,10470,0,10470,2750,12687,0,15437,3633,10283,7533,2665.66
50232407,FA2024 ,14750,600,4200,2450,22000,9500,7500,2000,2750,9500,0,12250,5850,12500,9750,0
50232407,SP2024 ,14750,600,4200,2450,22000,7500,7500,0,2750,7500,0,10250,7850,14500,11750,0
50210696,FA2021 ,19340,860,4600,2110,26050,10625,10625,0,3250,12125,0,15375,8075,13925,10675,0
50210696,FA2022 ,13005,6590,6590,NULL,19595,10625,10625,0,3750,10625,0,14375,8970,8970,5220,0
50210696,FA2023 ,13500,550,5440,NULL,19490,10625,10625,0,9283,10625,0,19908,3425,8865,-418,0
50210696,SP2021 ,19340,860,4600,2110,26050,10625,10625,0,3250,10625,0,13875,9575,15425,12175,0
50210696,SP2022 ,13005,515,3855,2220,19595,10625,10625,0,6939,10625,0,17564,2895,8970,2031,0
50210696,SP2023 ,13500,550,5440,NULL,19490,10625,10625,0,9282,10625,0,19907,3425,8865,-417,0
50228386,SP2022 ,14269,7231,7231,NULL,21500,0,0,0,NULL,0,0,0,21500,21500,21500,0
50229335,FA2023 ,13500,550,5150,2745,21945,6000,6000,0,0,6000,0,6000,8050,15945,15945,2842
50229335,FA2024 ,14750,600,5410,2450,23210,6000,6000,0,NULL,6000,0,6000,9350,17210,17210,2842
50229335,SP2023 ,13500,550,5150,2745,21945,6000,6000,0,0,6000,0,6000,8050,15945,15945,2842
50229335,SP2024 ,14750,600,5410,2450,23210,6000,6000,0,NULL,6000,0,6000,9350,17210,17210,2842
50225005,FA2022 ,13005,515,4810,2220,20550,7750,7250,500,2750,7750,0,10500,5770,12800,10050,10
50225005,FA2023 ,13500,550,5150,2325,21525,7750,500,7250,3250,7750,0,11000,6300,13775,10525,10
50225005,FA2024 ,14750,600,5410,2450,23210,7750,7250,500,NULL,7750,0,7750,7600,15460,15460,10
50225005,SP2022 ,13005,515,4810,2220,20550,7750,7250,500,2750,7750,0,10500,5770,12800,10050,10
50225005,SP2023 ,13500,550,5150,2325,21525,7750,500,7250,3250,7750,0,11000,6300,13775,10525,10
50225005,SP2024 ,14750,600,5410,2450,23210,7750,7250,500,NULL,7750,0,7750,7600,15460,15460,10
50209513,FA2021 ,12625,500,4580,2110,19815,3175,3175,0,14192,4675,0,18867,8450,15140,948,0
50209513,FA2022 ,13005,515,4610,1140,19270,3175,3175,0,16575,3175,0,19750,10345,16095,-480,0
50209513,SP2021 ,12625,500,4580,2110,19815,3175,3175,0,3750,3175,0,6925,9950,16640,12890,0
50209513,SP2022 ,13005,515,4610,1140,19270,3175,3175,0,3750,3175,0,6925,10345,16095,12345,0
50228975,FA2023 ,13500,550,4560,2325,20935,7800,7800,0,2750,9623,0,12373,4427,11312,8562,7118
50228975,FA2024 ,14750,600,4790,2450,22590,8800,6000,2800,5250,10250,0,15500,5100,12340,7090,7118
50228975,SP2023 ,13500,550,4560,2325,20935,7800,7800,0,2750,9622,0,12372,4428,11313,8563,7118
50218826,FA2021 ,12625,500,4050,2110,19285,8625,6625,2000,NULL,14175,0,14175,-1050,5110,5110,0
50218826,FA2022 ,13005,515,3855,2220,19595,8625,6625,2000,NULL,12480,0,12480,1040,7115,7115,0
50218826,FA2023 ,13500,550,4000,2325,20375,8625,6625,2000,NULL,12625,0,12625,1425,7750,7750,0
50218826,SP2021 ,12625,500,4050,2110,19285,6625,6625,0,NULL,10675,0,10675,2450,8610,8610,0
50218826,SP2022 ,13005,515,3855,2220,19595,6625,6625,0,NULL,10480,0,10480,3040,9115,9115,0
50218826,SP2023 ,13500,550,4000,2325,20375,6625,6625,0,NULL,10625,0,10625,3425,9750,9750,0
50203731,FA2021 ,12625,500,4830,1080,19035,1175,369,806,3750,2175,0,5925,10950,16860,13110,0
50203731,SP2021 ,6960,500,4830,1080,13370,648,204,444,3750,648,0,4398,6812,12722,8972,0
50231970,SP2023 ,14500,7000,7000,NULL,21500,0,0,0,NULL,0,0,0,21500,21500,21500,0
50216324,FA2021 ,12625,500,3740,2110,18975,6025,6025,0,1500,20273,0,21773,-7148,-1298,-2798,0
50216324,FA2022 ,13005,515,4380,2220,20120,6775,0,6775,0,14898,0,14898,-1378,5222,5222,0
50216324,FA2023 ,13500,550,4000,NULL,18050,7275,0,7275,3750,17275,0,21025,-3225,775,-2975,0
50216324,SP2021 ,12625,500,3740,2110,18975,6025,6025,0,1500,13082,0,14582,43,5893,4393,0
50216324,SP2022 ,13005,515,4380,2220,20120,6775,0,6775,2150,17147,0,19297,-3627,2973,823,0
50216324,SP2023 ,13500,550,4000,NULL,18050,7275,0,7275,3750,9775,0,13525,4275,8275,4525,0
50210748,FA2021 ,12625,500,3740,1080,17945,7300,7300,0,8750,8300,0,17050,4825,9645,895,0
50210748,FA2022 ,13005,515,4610,NULL,18130,7300,7300,0,9750,7300,0,17050,6220,10830,1080,0
50210748,SP2021 ,12625,500,4580,2110,19815,7300,7300,0,8750,7300,0,16050,5825,12515,3765,0
50204102,FA2021 ,12625,500,4270,2110,19505,2425,2425,0,NULL,2425,0,2425,10700,17080,17080,0
50117975,FA2021 ,12625,500,4050,2110,19285,1675,1675,0,NULL,1675,0,1675,11450,17610,17610,0
50119078,FA2022 ,13005,515,4260,2220,20000,6500,6500,0,NULL,6500,0,6500,7020,13500,13500,0
50119078,FA2023 ,13500,550,NULL,NULL,14050,4485,4485,0,NULL,4485,0,4485,9565,9565,9565,0
50119078,SP2022 ,13005,515,NULL,NULL,13520,4485,4485,0,NULL,4485,0,4485,9035,9035,9035,0
50196359,FA2021 ,19340,860,4600,1080,25020,6500,6500,0,NULL,7000,0,7000,13200,18020,18020,0
50196359,SP2021 ,10660,860,4600,1080,16340,3583,3583,0,NULL,3583,0,3583,7937,12757,12757,0
50231345,FA2024 ,14750,600,4790,2450,22590,7000,7000,0,15250,7000,0,22250,8350,15590,340,0
50231345,SP2024 ,14750,600,4790,2450,22590,7000,7000,0,15250,7000,0,22250,8350,15590,340,0
50215729,FA2021 ,12625,500,4580,2110,19815,675,0,675,NULL,2175,0,2175,10950,17640,17640,0
50215729,FA2022 ,13005,515,4610,NULL,18130,675,0,675,NULL,675,0,675,12845,17455,17455,0
50215729,FA2023 ,13500,550,4790,NULL,18840,675,0,675,NULL,675,0,675,13375,18165,18165,0
50215729,SP2021 ,12625,500,3740,2110,18975,675,0,675,NULL,675,0,675,12450,18300,18300,0
50215729,SP2022 ,13005,515,4610,NULL,18130,675,0,675,NULL,675,0,675,12845,17455,17455,0
50215729,SP2023 ,13500,550,4790,NULL,18840,675,0,675,NULL,675,0,675,13375,18165,18165,0
50231530,FA2024 ,14750,600,4200,2450,22000,9300,9300,0,17111,9300,0,26411,6050,12700,-4411,95.99
50231530,SP2024 ,14750,600,4200,2450,22000,9300,9300,0,17110,9300,0,26410,6050,12700,-4410,95.99
50217512,FA2021 ,12625,500,3740,2110,18975,7125,7125,0,8498,11748,0,20246,1377,7227,-1271,0
50217512,FA2022 ,13005,515,4610,NULL,18130,7125,7125,0,14011,9397,0,23408,4123,8733,-5278,0
50217512,FA2023 ,13500,550,4790,NULL,18840,7125,0,7125,10410,9697,0,20107,4353,9143,-1267,0
50217512,SP2021 ,12625,500,3740,2110,18975,7125,7125,0,9552,9747,0,19299,3378,9228,-324,0
50217512,SP2022 ,13005,515,4610,NULL,18130,7125,7125,0,6150,9398,0,15548,4122,8732,2582,0
50217512,SP2023 ,13500,550,4790,NULL,18840,7125,0,7125,10746,9698,0,20444,4352,9142,-1604,0
50069605,FA2024 ,14750,600,5410,2450,23210,9500,9500,0,2750,9500,0,12250,5850,13710,10960,0
50069605,SP2024 ,14750,600,5410,2450,23210,9500,9500,0,2750,9500,0,12250,5850,13710,10960,0
50224922,FA2022 ,13005,515,4810,2220,20550,7250,7250,0,2750,7250,0,10000,6270,13300,10550,15
50224922,FA2023 ,13500,550,5150,2325,21525,7250,7250,0,NULL,7250,0,7250,6800,14275,14275,15
50224922,FA2024 ,14750,600,6090,1270,22710,7250,7250,0,3750,7250,0,11000,8100,15460,11710,15
50224922,SP2022 ,13005,515,4810,2220,20550,7250,7250,0,2750,7250,0,10000,6270,13300,10550,15
50224922,SP2023 ,13500,550,5150,2325,21525,7250,7250,0,NULL,7250,0,7250,6800,14275,14275,15
50224922,SP2024 ,14750,600,6090,NULL,21440,7250,7250,0,3750,7250,0,11000,8100,14190,10440,15
50229110,FA2023 ,13500,550,5150,2325,21525,9000,9000,0,2750,9000,0,11750,5050,12525,9775,0
50229110,FA2024 ,14750,600,5410,2450,23210,9000,9000,0,NULL,9000,0,9000,6350,14210,14210,0
50229110,SP2023 ,13500,550,5150,2325,21525,9000,9000,0,2750,9000,0,11750,5050,12525,9775,0
50229110,SP2024 ,14750,600,5410,2450,23210,9000,9000,0,NULL,9000,0,9000,6350,14210,14210,0
50231691,FA2024 ,14750,600,4200,2450,22000,7700,7700,0,2750,12675,0,15425,2675,9325,6575,0
50231691,SP2024 ,14750,600,4200,2450,22000,7700,7700,0,9383,12675,0,22058,2675,9325,-58,0
50225252,FA2022 ,13005,515,4260,2220,20000,6500,6500,0,2750,6500,0,9250,7020,13500,10750,25
50225252,FA2023 ,13500,550,5150,2325,21525,6500,6500,0,3250,6500,0,9750,7550,15025,11775,25
50225252,FA2024 ,14750,600,4200,1270,20820,6500,6500,0,3250,6500,0,9750,8850,14320,11070,25
50225252,SP2022 ,13005,515,4260,2220,20000,6500,6500,0,2750,6500,0,9250,7020,13500,10750,25
50227923,SP2023 ,13500,550,5150,2325,21525,7500,7500,0,NULL,7500,0,7500,6550,14025,14025,0
50227923,SP2024 ,14750,600,NULL,NULL,15350,6175,500,5675,NULL,6175,0,6175,9175,9175,9175,0
50227730,FA2022 ,13005,515,NULL,NULL,13520,3105,3105,0,2750,3105,0,5855,10415,10415,7665,0
50227730,FA2023 ,13500,550,NULL,NULL,14050,3105,3105,0,3250,3105,0,6355,10945,10945,7695,0
50227730,FA2024 ,14750,600,NULL,NULL,15350,3105,3105,0,3750,3105,0,6855,12245,12245,8495,0
50227730,SP2022 ,13005,515,NULL,NULL,13520,3105,3105,0,2750,3105,0,5855,10415,10415,7665,0
50227730,SP2023 ,13500,550,NULL,NULL,14050,3105,3105,0,3250,3105,0,6355,10945,10945,7695,0
50227730,SP2024 ,14750,600,NULL,NULL,15350,3105,3105,0,3750,3105,0,6855,12245,12245,8495,0
50233237,FA2024 ,14750,600,4200,2450,22000,9700,9700,0,2750,13398,0,16148,1952,8602,5852,3065.44
50233237,SP2024 ,14750,600,4200,2450,22000,9700,9700,0,2750,13647,0,16397,1703,8353,5603,3065.44
50211312,FA2021 ,12625,500,4580,1080,18785,5075,3575,1500,3750,17078,0,20828,-3953,1707,-2043,0
50211312,FA2022 ,13005,515,4610,NULL,18130,4575,2250,2325,3750,13424,0,17174,96,4706,956,0
50211312,SP2021 ,12625,500,4580,1080,18785,5075,3575,1500,3750,15077,0,18827,-1952,3708,-42,0
50211312,SP2022 ,13005,515,4610,NULL,18130,4575,2250,2325,3750,13426,0,17176,94,4704,954,0
50222266,FA2021 ,12625,500,NULL,NULL,13125,2425,0,2425,NULL,2925,0,2925,10200,10200,10200,11498.32
50229917,FA2023 ,13500,550,5150,2325,21525,7000,7000,0,2750,7000,0,9750,7050,14525,11775,4330.32
50229917,FA2024 ,14750,600,5030,0,20380,7000,7000,0,NULL,7000,0,7000,8350,13380,13380,4330.32
50229917,SP2023 ,13500,550,5150,1200,20400,7000,7000,0,2750,7000,0,9750,7050,13400,10650,4330.32
50229917,SP2024 ,14750,600,5030,NULL,20380,7500,7500,0,NULL,7500,0,7500,7850,12880,12880,4330.32
50206128,FA2021 ,12625,500,4270,NULL,17395,5925,5925,0,14823,7425,0,22248,5700,9970,-4853,0
50206128,SP2021 ,12625,500,4270,NULL,17395,5925,5925,0,13463,5925,0,19388,7200,11470,-1993,0
50117888,FA2022 ,13005,515,4810,2220,20550,7000,7000,0,3250,10000,0,13250,3520,10550,7300,9049
50117888,FA2023 ,13500,550,5150,2325,21525,7000,7000,0,3750,7000,0,10750,7050,14525,10775,9049
50117888,FA2024 ,14750,600,5720,NULL,21070,7000,7000,0,NULL,7000,0,7000,8350,14070,14070,9049
50117888,SP2022 ,13005,515,4810,2220,20550,7000,7000,0,3250,7000,0,10250,6520,13550,10300,9049
50117888,SP2023 ,13500,550,5150,NULL,19200,7000,7000,0,3750,7000,0,10750,7050,12200,8450,9049
50117888,SP2024 ,14750,600,NULL,NULL,15350,4830,4830,0,NULL,4830,0,4830,10520,10520,10520,9049
50210643,FA2021 ,12625,500,4050,2110,19285,6375,6375,0,3750,7875,0,11625,5250,11410,7660,0
50210643,FA2022 ,13005,515,5080,1140,19740,5125,5125,0,3750,8797,0,12547,4723,10943,7193,0
50210643,SP2021 ,12625,500,4050,2110,19285,6375,6375,0,12750,6375,0,19125,6750,12910,160,0
50210643,SP2022 ,7170,515,5080,1140,13905,3515,3515,0,10750,4448,0,15198,3237,9457,-1293,0
50211162,FA2021 ,12625,500,4580,2110,19815,0,0,0,20676,1500,0,22176,11625,18315,-2361,0
50211162,FA2022 ,13005,515,4610,1140,19270,0,0,0,19895,0,0,19895,13520,19270,-625,0
50211162,FA2023 ,13500,550,4790,1200,20040,0,0,0,21023,0,0,21023,14050,20040,-983,0
50211162,SP2021 ,12625,500,4580,2110,19815,0,0,0,20677,0,0,20677,13125,19815,-862,0
50211162,SP2022 ,13005,515,4610,1140,19270,0,0,0,19894,0,0,19894,13520,19270,-624,0
50212233,FA2021 ,12625,500,4050,2110,19285,3675,3675,0,20940,5175,0,26115,7950,14110,-6830,0
50212233,FA2022 ,13005,515,4610,1140,19270,3675,3675,0,17324,3675,0,20999,9845,15595,-1729,0
50212233,FA2023 ,13500,550,4000,2325,20375,3674,0,3674,17274,3674,0,20948,10376,16701,-573,0
50212233,FA2024 ,8140,300,NULL,NULL,8440,2028,0,2028,4500,2028,0,6528,6412,6412,1912,0
50212233,SP2021 ,12625,500,4050,2110,19285,3675,3675,0,16764,3675,0,20439,9450,15610,-1154,0
50212233,SP2023 ,13500,550,4000,2325,20375,3676,0,3676,13670,3676,0,17346,10374,16699,3029,0
50216326,FA2021 ,12625,500,3740,2110,18975,10675,9725,950,3250,13698,0,16948,-573,5277,2027,5522
50216326,FA2022 ,13005,515,3855,2220,19595,9725,9725,0,NULL,9725,0,9725,3795,9870,9870,5522
50216326,SP2021 ,12625,500,3740,2110,18975,10675,9725,950,3250,12197,0,15447,928,6778,3528,5522
50217590,FA2021 ,12625,500,4580,2110,19815,8925,8925,0,9500,10925,0,20425,2200,8890,-610,0
50217590,FA2022 ,13005,515,4810,2220,20550,8425,8425,0,10000,8925,0,18925,4595,11625,1625,0
50217590,FA2023 ,13500,550,4000,2325,20375,8425,8425,0,10750,9500,0,20250,4550,10875,125,0
50217590,FA2024 ,6090,600,5720,2450,14860,3867,0,3867,12250,5231,0,17481,1459,9629,-2621,0
50217590,SP2021 ,12625,500,4580,2110,19815,8925,8925,0,9500,9425,0,18925,3700,10390,890,0
50217590,SP2022 ,13005,515,4810,2220,20550,8425,8425,0,10000,8925,0,18925,4595,11625,1625,0
50217590,SP2023 ,13500,6825,6825,NULL,20325,8425,8425,0,11250,9500,0,20750,10825,10825,-425,0
50231893,FA2024 ,14750,600,4200,2450,22000,0,0,0,2750,14750,14750,17500,600,7250,4500,1577.67
50231893,SP2024 ,14750,600,4200,2450,22000,0,0,0,2750,14750,14750,17500,600,7250,4500,1577.67
50225487,FA2022 ,13005,515,4260,2220,20000,8750,8750,0,2750,8750,0,11500,4770,11250,8500,0
50225487,FA2023 ,13500,550,4560,2325,20935,8750,8750,0,3250,19689,0,22939,-5639,1246,-2004,0
50225487,FA2024 ,14750,600,5720,NULL,21070,8750,5500,3250,3750,11083,0,14833,4267,9987,6237,0
50225487,SP2022 ,13005,515,3855,2220,19595,8750,8750,0,2750,8750,0,11500,4770,10845,8095,0
50225487,SP2023 ,13500,550,4560,2325,20935,8750,8750,0,3250,8750,0,12000,5300,12185,8935,0
50225487,SP2024 ,14750,600,5720,NULL,21070,8750,5500,3250,3750,11082,0,14832,4268,9988,6238,0
50216349,FA2021 ,12625,500,4470,NULL,17595,5325,0,5325,3250,6825,0,10075,6300,10770,7520,5991
50216349,FA2022 ,13005,515,4610,NULL,18130,5325,0,5325,6593,9148,0,15741,4372,8982,2389,5991
50216349,FA2023 ,16120,550,4790,NULL,21460,5325,0,5325,3750,7998,0,11748,8672,13462,9712,5991
50216349,SP2021 ,12625,500,4470,NULL,17595,5325,0,5325,3250,5325,0,8575,7800,12270,9020,5991
50216349,SP2022 ,13005,515,4610,NULL,18130,5325,0,5325,6594,9147,0,15741,4373,8983,2389,5991
50209792,FA2021 ,12625,500,3740,1080,17945,6925,5425,1500,3750,8425,0,12175,4700,9520,5770,0
50209792,FA2022 ,13005,515,3855,1140,18515,7675,5425,2250,3750,9998,0,13748,3522,8517,4767,0
50209792,SP2021 ,12625,500,3740,1080,17945,6925,5425,1500,3750,6925,0,10675,6200,11020,7270,0
50209792,SP2022 ,13005,515,3855,1140,18515,7675,5425,2250,3750,9997,0,13747,3523,8518,4768,0
50215354,FA2021 ,12625,500,3740,2110,18975,10175,0,10175,3250,11675,0,14925,1450,7300,4050,6019.65
50215354,FA2022 ,13005,515,3855,2220,19595,10175,0,10175,3750,12448,0,16198,1072,7147,3397,6019.65
50215354,FA2023 ,13500,550,5440,1200,20690,10175,0,10175,3750,10175,0,13925,3875,10515,6765,6019.65
50215354,FA2024 ,14750,600,5030,NULL,20380,10175,0,10175,3750,10175,0,13925,5175,10205,6455,6019.65
50215354,SP2021 ,12625,500,3740,2110,18975,10175,0,10175,3250,10175,0,13425,2950,8800,5550,6019.65
50215354,SP2022 ,13005,515,3855,2220,19595,10175,0,10175,3750,12447,0,16197,1073,7148,3398,6019.65
50215354,SP2023 ,13500,550,5440,1200,20690,10175,0,10175,3750,10175,0,13925,3875,10515,6765,6019.65
50232825,FA2024 ,14750,600,4200,2450,22000,7000,7000,0,2750,9500,0,12250,5850,12500,9750,0
50232825,SP2024 ,14750,600,4200,2450,22000,7000,7000,0,2750,7000,0,9750,8350,15000,12250,0
50225183,FA2022 ,13005,515,4810,2220,20550,0,0,0,2750,13005,13005,15755,515,7545,4795,2538.32
50225183,FA2023 ,13500,550,4990,2325,21365,0,0,0,NULL,13500,13500,13500,550,7865,7865,2538.32
50225183,FA2024 ,14750,600,5240,1270,21860,250,0,250,3750,14750,14500,18500,600,7110,3360,2538.32
50225183,SP2022 ,13005,515,4800,2220,20540,0,0,0,2750,13005,13005,15755,515,7535,4785,2538.32
50225183,SP2023 ,13500,550,4990,1200,20240,0,0,0,NULL,13500,13500,13500,550,6740,6740,2538.32
50225183,SP2024 ,14750,600,5240,1270,21860,250,0,250,3750,14750,14500,18500,600,7110,3360,2538.32
50228622,FA2023 ,13500,550,5150,2325,21525,9250,9250,0,2750,10250,0,13000,3800,11275,8525,0
50228622,FA2024 ,14750,600,4200,2450,22000,9000,9000,0,3250,9000,0,12250,6350,13000,9750,0
50228622,SP2023 ,13500,550,5150,2325,21525,9300,9300,0,2750,9300,0,12050,4750,12225,9475,0
50228622,SP2024 ,14750,600,4200,2450,22000,9000,9000,0,3250,9000,0,12250,6350,13000,9750,0
50223305,FA2021 ,12625,500,3740,2110,18975,6000,6000,0,NULL,6500,0,6500,6625,12475,12475,145
50223305,FA2022 ,13005,515,3855,2220,19595,5500,5500,0,NULL,5500,0,5500,8020,14095,14095,145
50223305,FA2023 ,13500,550,4790,1200,20040,5500,5500,0,NULL,5500,0,5500,8550,14540,14540,145
50223305,FA2024 ,14750,600,5030,1270,21650,5500,5500,0,NULL,9198,0,9198,6152,12452,12452,145
50223305,SP2021 ,12625,500,3740,2110,18975,6000,6000,0,NULL,6000,0,6000,7125,12975,12975,145
50223305,SP2022 ,13005,515,3855,2220,19595,5500,5500,0,NULL,5500,0,5500,8020,14095,14095,145
50223305,SP2023 ,13500,550,4790,1200,20040,5500,5500,0,NULL,5500,0,5500,8550,14540,14540,145
50223305,SP2024 ,14750,600,5030,NULL,20380,5500,5500,0,NULL,9197,0,9197,6153,11183,11183,145
50234838,FA2024 ,14750,600,4200,2900,22450,11500,9500,2000,13280,11500,0,24780,3850,10950,-2330,15
50234838,SP2024 ,14750,600,4200,2450,22000,9500,9500,0,11070,9500,0,20570,5850,12500,1430,15
50204729,FA2021 ,12625,500,4830,1080,19035,2925,2925,0,NULL,16807,0,16807,-3682,2228,2228,0
50229496,FA2023 ,13500,550,4000,2745,20795,6500,6500,0,2750,10673,0,13423,3377,10122,7372,0
50229496,FA2024 ,14750,600,5410,2450,23210,7600,6550,1050,3250,10403,0,13653,4947,12807,9557,0
50229496,SP2023 ,13500,550,4000,2745,20795,6500,6500,0,2750,10672,0,13422,3378,10123,7373,0
50229496,SP2024 ,14750,600,5410,2450,23210,7600,6550,1050,3250,10402,0,13652,4948,12808,9558,0
50225488,FA2022 ,13005,515,3855,2220,19595,13500,0,13500,2750,13500,0,16250,20,6095,3345,855
50225488,FA2023 ,13500,550,4000,2325,20375,12500,0,12500,3250,12500,0,15750,1550,7875,4625,855
50225488,FA2024 ,14750,600,5720,1270,22340,14050,0,14050,3750,16150,0,19900,-800,6190,2440,855
50225488,SP2022 ,13005,515,3855,2220,19595,10500,0,10500,2750,10500,0,13250,3020,9095,6345,855
50225488,SP2023 ,13500,550,4560,2325,20935,10550,0,10550,3250,10550,0,13800,3500,10385,7135,855
50225488,SP2024 ,14750,600,5720,0,21070,12000,0,12000,3750,14100,0,17850,1250,6970,3220,855
50210588,FA2021 ,12625,6350,6350,NULL,18975,1213,1213,0,0,2213,0,2213,16762,16762,16762,0
50210588,SP2021 ,12625,500,4830,NULL,17955,2425,2425,0,0,2425,0,2425,10700,15530,15530,0
50216786,FA2021 ,12625,500,4050,2110,19285,3925,3925,0,2750,4925,0,7675,8200,14360,11610,0
50216786,FA2022 ,13005,515,4260,2220,20000,7425,5425,2000,3750,7425,0,11175,6095,12575,8825,0
50216786,FA2023 ,13500,550,5440,1200,20690,5425,1500,3925,3750,5425,0,9175,8625,15265,11515,0
50216786,SP2021 ,12625,500,4050,2110,19285,3925,3925,0,2750,3925,0,6675,9200,15360,12610,0
50216786,SP2022 ,13005,515,4260,2220,20000,7425,5425,2000,3750,7425,0,11175,6095,12575,8825,0
50216786,SP2023 ,13500,550,5440,NULL,19490,5425,1500,3925,3750,5425,0,9175,8625,14065,10315,0
50232114,FA2024 ,14750,600,4200,2450,22000,11500,0,11500,2750,11500,0,14250,3850,10500,7750,4176.66
50232114,SP2024 ,14750,600,4200,2450,22000,9500,0,9500,2750,9500,0,12250,5850,12500,9750,4176.66
50211309,FA2021 ,12625,500,4050,1080,18255,7175,7175,0,3750,8675,0,12425,4450,9580,5830,0
50211309,FA2022 ,13005,515,3855,1140,18515,7175,7175,0,3750,7175,0,10925,6345,11340,7590,0
50211309,SP2021 ,12625,500,4050,1080,18255,7175,7175,0,3750,7175,0,10925,5950,11080,7330,0
50222311,FA2021 ,12625,500,3740,2110,18975,7500,7500,0,2750,8500,0,11250,4625,10475,7725,8190
50222311,FA2022 ,13005,515,3855,2220,19595,7000,7000,0,3250,7000,0,10250,6520,12595,9345,8190
50222311,FA2023 ,13500,550,4560,2325,20935,7000,7000,0,3750,7000,0,10750,7050,13935,10185,8190
50222311,FA2024 ,14750,600,5030,0,20380,9000,8500,500,3750,9620,0,13370,5730,10760,7010,8190
50222311,SP2021 ,12625,500,3740,2110,18975,7500,7500,0,2750,7500,0,10250,5625,11475,8725,8190
50222311,SP2022 ,13005,515,3855,2220,19595,7000,7000,0,12750,7000,0,19750,6520,12595,-155,8190
50222311,SP2023 ,13500,550,5440,1200,20690,7000,7000,0,3750,7000,0,10750,7050,13690,9940,8190
50234953,FA2024 ,4070,NULL,NULL,NULL,4070,5279,5279,0,2750,5649,0,8399,-1579,-1579,-4329,3885
50230636,FA2023 ,13500,550,5150,2325,21525,9000,9000,0,NULL,9000,0,9000,5050,12525,12525,6697.99
50230636,FA2024 ,14750,600,4200,1270,20820,9000,6500,2500,NULL,9000,0,9000,6350,11820,11820,6697.99
50230636,SP2024 ,14750,600,4200,2450,22000,9000,6500,2500,NULL,9000,0,9000,6350,13000,13000,6697.99
50205032,FA2021 ,12625,500,4830,NULL,17955,2925,2925,0,3750,4425,0,8175,8700,13530,9780,0
50205032,SP2021 ,12625,500,4830,NULL,17955,2925,2925,0,3750,2925,0,6675,10200,15030,11280,0
50216143,FA2021 ,12625,500,3740,2110,18975,10925,10925,0,3250,14848,0,18098,-1723,4127,877,0
50216143,FA2022 ,13005,515,4610,NULL,18130,10925,10925,0,5350,10925,0,16275,2595,7205,1855,0
50216143,FA2023 ,13500,550,4790,NULL,18840,11175,8275,2900,14250,13747,0,27997,303,5093,-9157,0
50216143,SP2021 ,12625,500,3740,2110,18975,10925,10925,0,3250,12847,0,16097,278,6128,2878,0
50216143,SP2022 ,13005,515,4610,NULL,18130,10925,10925,0,3750,10925,0,14675,2595,7205,3455,0
50216143,SP2023 ,13500,550,4790,NULL,18840,11175,8275,2900,2500,13748,0,16248,302,5092,2592,0
50226725,FA2022 ,13005,515,4810,2220,20550,0,0,0,NULL,13005,13005,13005,515,7545,7545,0
50226725,SP2022 ,13005,515,4810,2220,20550,0,0,0,NULL,13005,13005,13005,515,7545,7545,0
50204238,FA2021 ,12625,500,3740,1080,17945,8175,0,8175,3750,9675,0,13425,3450,8270,4520,730
50204238,SP2021 ,12625,500,4830,NULL,17955,8175,0,8175,3750,8175,0,11925,4950,9780,6030,730
50226060,FA2022 ,13005,515,4260,2220,20000,9000,9000,0,7250,13823,0,21073,-303,6177,-1073,-21
50226060,FA2023 ,13500,550,4560,2325,20935,9000,9000,0,12647,9000,0,21647,5050,11935,-712,-21
50226060,FA2024 ,14750,600,4200,2450,22000,9000,0,9000,9443,14198,0,23641,1152,7802,-1641,-21
50226060,SP2022 ,13005,515,4260,2220,20000,9000,9000,0,7250,13822,0,21072,-302,6178,-1072,-21
50226060,SP2023 ,13500,550,4560,2325,20935,9000,9000,0,12648,9000,0,21648,5050,11935,-713,-21
50226060,SP2024 ,14750,600,4200,2450,22000,9000,0,9000,9443,14197,0,23640,1153,7803,-1640,-21
50233512,FA2024 ,14750,600,4200,2450,22000,9100,9100,0,2750,9100,0,11850,6250,12900,10150,0
50233512,SP2024 ,14750,600,4200,2450,22000,9100,9100,0,2750,9100,0,11850,6250,12900,10150,0
50211764,FA2021 ,12625,500,4580,2110,19815,4175,4175,0,11109,12048,0,23157,1077,7767,-3342,0
50211764,FA2022 ,13005,515,4380,2220,20120,5075,5075,0,13201,10998,0,24199,2522,9122,-4079,0
50211764,FA2023 ,5570,275,NULL,NULL,5845,3094,0,3094,3750,4895,0,8645,950,950,-2800,0
50211764,SP2021 ,12625,500,4580,2110,19815,4175,4175,0,9514,10047,0,19561,3078,9768,254,0
50211764,SP2022 ,13005,515,4380,2220,20120,5075,5075,0,11802,10997,0,22799,2523,9123,-2679,0
50216880,FA2021 ,12625,500,4580,2110,19815,5075,5075,0,10963,12048,0,23011,1077,7767,-3196,0
50216880,FA2022 ,13005,515,NULL,NULL,13520,3625,0,3625,6250,10522,0,16772,2998,2998,-3252,0
50216880,SP2021 ,12625,500,4580,2110,19815,5075,5075,0,8950,10047,0,18997,3078,9768,818,0
50232889,FA2024 ,14750,600,4780,2450,22580,10650,10650,0,2750,14843,0,17593,507,7737,4987,-1400
50232889,SP2024 ,14750,600,4780,2450,22580,10650,10650,0,2750,16442,0,19192,-1092,6138,3388,-1400
50225009,FA2022 ,13005,515,4810,2220,20550,6500,6500,0,8750,6500,0,15250,7020,14050,5300,2426.32
50225009,FA2023 ,13500,550,5150,2325,21525,6500,6500,0,9250,8783,0,18033,5267,12742,3492,2426.32
50225009,FA2024 ,14750,600,5410,2450,23210,6500,6500,0,9750,8000,0,17750,7350,15210,5460,2426.32
50225009,SP2022 ,13005,515,4810,2220,20550,6500,6500,0,8750,6500,0,15250,7020,14050,5300,2426.32
50225009,SP2023 ,13500,550,5440,2325,21815,6500,6500,0,9250,6500,0,15750,7550,15315,6065,2426.32
50225009,SP2024 ,14750,600,5410,2450,23210,6500,6500,0,9750,6500,0,16250,8850,16710,6960,2426.32
50232077,FA2024 ,14750,600,4200,2680,22230,9500,9000,500,2750,9500,0,12250,5850,12730,9980,2580.32
50232077,SP2024 ,14750,600,4200,2450,22000,9000,9000,0,2750,9000,0,11750,6350,13000,10250,2580.32
50220851,FA2021 ,12625,500,3740,2110,18975,9750,250,9500,2750,11750,0,14500,1375,7225,4475,0
50220851,FA2022 ,13005,515,3855,2220,19595,9500,0,9500,3250,9500,0,12750,4020,10095,6845,0
50220851,FA2023 ,13500,550,4790,NULL,18840,13357,400,12957,3750,13357,0,17107,693,5483,1733,0
50220851,SP2021 ,12625,500,3740,2110,18975,9800,300,9500,2750,9800,0,12550,3325,9175,6425,0
50220851,SP2022 ,13005,515,3855,2220,19595,9850,350,9500,3250,9850,0,13100,3670,9745,6495,0
50220851,SP2023 ,13500,550,4790,NULL,18840,9500,0,9500,3750,9500,0,13250,4550,9340,5590,0
50220851,SP2024 ,14750,600,4790,1270,21410,11500,0,11500,3750,11500,0,15250,3850,9910,6160,0
50222758,FA2021 ,12625,500,4050,2110,19285,0,0,0,2750,12625,12625,15375,500,6660,3910,0
50222758,FA2022 ,13005,515,4260,2220,20000,0,0,0,NULL,13005,13005,13005,515,6995,6995,0
50222758,FA2023 ,13500,550,4560,2325,20935,0,0,0,NULL,13500,13500,13500,550,7435,7435,0
50222758,FA2024 ,14750,600,5410,2450,23210,0,0,0,NULL,14750,14750,14750,600,8460,8460,0
50222758,SP2021 ,12625,500,4050,2110,19285,0,0,0,2750,12625,12625,15375,500,6660,3910,0
50222758,SP2022 ,13005,515,4260,2220,20000,0,0,0,NULL,13005,13005,13005,515,6995,6995,0
50222758,SP2023 ,13500,6825,6825,NULL,20325,1750,1750,0,NULL,1750,0,1750,18575,18575,18575,0
50222758,SP2024 ,14750,600,5410,2450,23210,0,0,0,NULL,14750,14750,14750,600,8460,8460,0
50235192,SP2024 ,14750,600,5410,2450,23210,0,0,0,2750,19947,14750,22697,-4597,3263,513,234
50204396,FA2021 ,12625,500,3740,2110,18975,4925,4925,0,15750,6425,0,22175,6700,12550,-3200,0
50204396,SP2021 ,12625,500,3740,2110,18975,4925,4925,0,15750,4925,0,20675,8200,14050,-1700,0
50225490,FA2022 ,13005,515,4810,2220,20550,5750,5750,0,0,5750,0,5750,7770,14800,14800,0
50225490,FA2023 ,13500,550,5150,2325,21525,5750,5750,0,NULL,5750,0,5750,8300,15775,15775,0
50225490,FA2024 ,14750,600,5720,1270,22340,5750,5750,0,NULL,5750,0,5750,9600,16590,16590,0
50225490,SP2022 ,13005,515,4810,2220,20550,5750,5750,0,0,5750,0,5750,7770,14800,14800,0
50225490,SP2023 ,13500,550,4560,2325,20935,5750,5750,0,NULL,5750,0,5750,8300,15185,15185,0
50235033,FA2024 ,14750,600,4790,2450,22590,8473,8473,0,9099,13201,0,22300,2149,9389,290,-196
50235033,SP2024 ,14750,600,4790,2450,22590,8473,8473,0,11215,13200,0,24415,2150,9390,-1825,-196
50235198,FA2024 ,14750,600,4790,2450,22590,10223,10223,0,8971,13651,0,22622,1699,8939,-32,9
50235198,SP2024 ,14750,600,4790,2450,22590,10223,10223,0,10514,13650,0,24164,1700,8940,-1574,9
50226363,FA2022 ,13005,515,4260,2220,20000,8500,8500,0,NULL,8500,0,8500,5020,11500,11500,10576
50226363,FA2023 ,13500,550,4560,2325,20935,9744,9244,500,NULL,9744,0,9744,4306,11191,11191,10576
50226363,FA2024 ,14750,600,4790,2450,22590,8500,5000,3500,NULL,8500,0,8500,6850,14090,14090,10576
50226363,SP2022 ,13005,515,4260,2220,20000,8500,8500,0,NULL,8500,0,8500,5020,11500,11500,10576
50226363,SP2023 ,13500,550,4560,2325,20935,9500,9000,500,NULL,9500,0,9500,4550,11435,11435,10576
50226363,SP2024 ,14750,600,4790,2450,22590,8500,5000,3500,NULL,8500,0,8500,6850,14090,14090,10576
50226865,FA2022 ,13005,515,4260,2220,20000,8500,8500,0,NULL,8500,0,8500,5020,11500,11500,17717.35
50226865,FA2023 ,13500,550,4560,2325,20935,9732,9232,500,NULL,9732,0,9732,4318,11203,11203,17717.35
50226865,FA2024 ,14750,600,4790,2450,22590,8500,5000,3500,NULL,8500,0,8500,6850,14090,14090,17717.35
50226865,SP2022 ,13005,515,4260,2220,20000,8500,8500,0,NULL,8500,0,8500,5020,11500,11500,17717.35
50226865,SP2023 ,13500,550,4560,2325,20935,9500,9000,500,NULL,9500,0,9500,4550,11435,11435,17717.35
50226865,SP2024 ,14750,600,4790,2450,22590,8500,5000,3500,NULL,8500,0,8500,6850,14090,14090,17717.35
50221440,FA2021 ,12625,500,4580,2110,19815,7500,7500,0,2750,8500,0,11250,4625,11315,8565,2337
50221440,FA2022 ,13005,515,4810,2220,20550,7000,7000,0,3250,7000,0,10250,6520,13550,10300,2337
50221440,FA2023 ,13500,550,4790,2325,21165,7000,7000,0,3750,7000,0,10750,7050,14165,10415,2337
50221440,FA2024 ,6090,600,5030,1270,12990,2891,2684,207,3750,2891,0,6641,3799,10099,6349,2337
50221440,SP2021 ,12625,500,4580,2110,19815,7500,7500,0,2750,7500,0,10250,5625,12315,9565,2337
50221440,SP2022 ,13005,515,4810,2220,20550,7000,7000,0,3250,7000,0,10250,6520,13550,10300,2337
50221440,SP2023 ,13500,550,4790,2325,21165,7000,7000,0,3750,7000,0,10750,7050,14165,10415,2337
50221440,SP2024 ,6090,600,5030,1270,12990,2890,2684,206,3750,2890,0,6640,3800,10100,6350,2337
50231999,FA2024 ,14750,600,5410,2450,23210,9500,9500,0,2750,9500,0,12250,5850,13710,10960,3670
50231999,SP2024 ,14750,600,5410,2450,23210,9500,9500,0,2750,9500,0,12250,5850,13710,10960,3670
50199384,FA2021 ,12625,500,3740,2110,18975,625,625,0,11250,2125,0,13375,11000,16850,5600,0
50235671,SP2024 ,14750,600,4790,2450,22590,8000,8000,0,NULL,8000,0,8000,7350,14590,14590,17728
50220789,FA2021 ,12625,500,4580,2110,19815,9100,6850,2250,2750,12773,0,15523,352,7042,4292,2703.67
50220789,FA2022 ,13005,515,4810,2220,20550,10350,5500,4850,3250,15910,0,19160,-2390,4640,1390,2703.67
50220789,FA2023 ,13500,550,4000,1200,19250,8600,5000,3600,3750,8600,0,12350,5450,10650,6900,2703.67
50220789,FA2024 ,14750,600,5030,1270,21650,8600,5000,3600,3750,13047,0,16797,2303,8603,4853,2703.67
50220789,SP2021 ,12625,500,4580,2110,19815,6850,6850,0,2750,9022,0,11772,4103,10793,8043,2703.67
50220789,SP2022 ,13005,515,4810,2220,20550,8100,5500,2600,3250,12910,0,16160,610,7640,4390,2703.67
50220789,SP2023 ,13500,550,4000,1200,19250,6350,5000,1350,3750,7100,0,10850,6950,12150,8400,2703.67
50220789,SP2024 ,14750,600,5030,1270,21650,6350,5000,1350,3750,10048,0,13798,5302,11602,7852,2703.67
50234723,FA2024 ,14750,600,4200,2450,22000,6250,6250,0,2750,11448,0,14198,3902,10552,7802,136
50234723,SP2024 ,14750,600,4200,2450,22000,6250,6250,0,2750,11447,0,14197,3903,10553,7803,136
50231877,SP2023 ,13500,550,5150,2325,21525,14240,14240,0,NULL,14240,0,14240,-190,7285,7285,0
50196546,FA2021 ,12625,500,NULL,NULL,13125,3425,0,3425,3750,4925,0,8675,8200,8200,4450,0
50216664,FA2021 ,12625,500,3740,2110,18975,6125,6125,0,3250,17863,0,21113,-4738,1112,-2138,0
50216664,FA2022 ,13005,515,4810,2220,20550,7625,250,7375,3750,17683,0,21433,-4163,2867,-883,0
50216664,FA2023 ,13500,550,5150,2325,21525,7375,0,7375,3427,18048,0,21475,-3998,3477,50,0
50216664,SP2021 ,12625,500,3740,2110,18975,6125,6125,0,3250,16922,0,20172,-3797,2053,-1197,0
50216664,SP2022 ,13005,515,4810,2220,20550,7375,0,7375,3750,17913,0,21663,-4393,2637,-1113,0
50216664,SP2023 ,13500,550,5150,2325,21525,7375,0,7375,3428,18047,0,21475,-3997,3478,50,0
50233931,FA2024 ,14750,600,5410,2450,23210,7000,7000,0,2750,7000,0,9750,8350,16210,13460,2877.32
50233931,SP2024 ,14750,600,5410,2450,23210,9000,7000,2000,2750,9000,0,11750,6350,14210,11460,2877.32
50211147,FA2021 ,12625,500,3740,2110,18975,2825,2825,0,17324,4325,0,21649,8800,14650,-2674,0
50211147,FA2022 ,13005,515,3855,2220,19595,3325,2825,500,21750,3325,0,25075,10195,16270,-5480,0
50211147,SP2021 ,12625,500,3740,2110,18975,2825,2825,0,17324,2825,0,20149,10300,16150,-1174,0
50211147,SP2022 ,13005,515,3855,2220,19595,3325,2825,500,18280,3325,0,21605,10195,16270,-2010,0
50212520,FA2021 ,12625,500,4580,2110,19815,7925,0,7925,3750,9425,0,13175,3700,10390,6640,0
50212520,FA2022 ,13005,515,4810,2220,20550,7925,0,7925,3750,7925,0,11675,5595,12625,8875,0
50212520,SP2021 ,12625,500,4580,2110,19815,7925,0,7925,3750,7925,0,11675,5200,11890,8140,0
50212520,SP2022 ,13005,515,4810,2220,20550,7925,0,7925,3750,7925,0,11675,5595,12625,8875,0
50231394,FA2024 ,14750,600,2705,1225,19280,10800,8800,2000,2750,19498,0,22248,-4148,-218,-2968,0
50226398,FA2022 ,7170,515,3855,2220,13760,4687,4687,0,NULL,5687,0,5687,1998,8073,8073,11059
50226398,FA2023 ,13500,550,4000,2325,20375,8500,8500,0,NULL,8500,0,8500,5550,11875,11875,11059
50226398,SP2022 ,13005,515,3855,2220,19595,8750,8750,0,NULL,8750,0,8750,4770,10845,10845,11059
50226398,SP2023 ,13500,550,4000,2325,20375,9500,8500,1000,NULL,9500,0,9500,4550,10875,10875,11059
50231825,FA2024 ,14750,600,5410,2450,23210,0,0,0,2750,19948,14750,22698,-4598,3262,512,-181.75
50231825,SP2024 ,14750,600,5410,2450,23210,1000,0,1000,2750,20947,14750,23697,-5597,2263,-487,-181.75
50235074,FA2024 ,14750,600,4200,2450,22000,0,0,0,2680,22948,14750,25628,-7598,-948,-3628,0
50235074,SP2024 ,14750,600,4200,2450,22000,0,0,0,2680,19947,14750,22627,-4597,2053,-627,0
50235193,FA2024 ,14750,600,4200,2450,22000,0,0,0,1953,22948,14750,24901,-7598,-948,-2901,-1044
50235193,SP2024 ,14750,600,4200,2450,22000,0,0,0,1952,19947,14750,21899,-4597,2053,101,-1044
50216530,FA2021 ,12625,500,4580,2110,19815,4425,4425,0,14213,5925,0,20138,7200,13890,-323,0
50216530,FA2022 ,13005,515,4260,1140,18920,4425,4425,0,16280,4425,0,20705,9095,14495,-1785,0
50216530,FA2023 ,13500,550,4790,9.8,18849.8,4425,4425,0,17973,4425,0,22398,9625,14424.8,-3548.2,0
50216530,SP2021 ,12625,500,4580,2110,19815,4425,4425,0,14214,4425,0,18639,8700,15390,1176,0
50216530,SP2022 ,13005,6590,6590,NULL,19595,4425,4425,0,16280,4425,0,20705,15170,15170,-1110,0
50216530,SP2023 ,13500,550,4790,NULL,18840,4425,4425,0,17973,4425,0,22398,9625,14415,-3558,0
50232747,FA2024 ,14750,600,4200,2450,22000,7500,7500,0,20084,7500,0,27584,7850,14500,-5584,-5250
50232747,SP2024 ,14750,600,4200,2450,22000,7500,7500,0,14568,7500,0,22068,7850,14500,-68,-5250
50227245,FA2023 ,1940,NULL,NULL,NULL,1940,0,0,0,NULL,0,0,0,1940,1940,1940,-810
50232155,FA2024 ,14750,600,4200,2450,22000,6000,6000,0,18005,6000,0,24005,9350,16000,-2005,-1895
50232155,SP2024 ,14750,600,4200,2450,22000,6000,6000,0,16857,6000,0,22857,9350,16000,-857,-1895
50074803,FA2023 ,13500,550,5150,2325,21525,7250,7250,0,NULL,7250,0,7250,6800,14275,14275,-1000
50074803,FA2024 ,14750,600,5410,2450,23210,7000,7000,0,NULL,7000,0,7000,8350,16210,16210,-1000
50074803,SP2023 ,13500,550,5150,2325,21525,7000,7000,0,NULL,7000,0,7000,7050,14525,14525,-1000
50074803,SP2024 ,14750,7250,8873,NULL,23623,8000,8000,0,NULL,8000,0,8000,14000,15623,15623,-1000
50224349,FA2022 ,13005,515,4810,2220,20550,10250,7250,3000,2750,12250,0,15000,1270,8300,5550,-1205
50224349,FA2023 ,13500,550,5150,2325,21525,10250,7250,3000,3250,10250,0,13500,3800,11275,8025,-1205
50224349,FA2024 ,14750,600,5720,NULL,21070,6750,6750,0,3750,6750,0,10500,8600,14320,10570,-1205
50224349,SP2022 ,13005,515,4810,2220,20550,7250,7250,0,2750,7250,0,10000,6270,13300,10550,-1205
50224349,SP2023 ,13500,550,5150,2325,21525,6750,6750,0,3250,6750,0,10000,7300,14775,11525,-1205
50224349,SP2024 ,14750,600,5720,NULL,21070,6750,6750,0,3750,6750,0,10500,8600,14320,10570,-1205
50225089,FA2022 ,13005,515,4810,2220,20550,5500,5500,0,0,5500,0,5500,8020,15050,15050,0
50234378,FA2024 ,15000,7500,7500,NULL,22500,0,0,0,NULL,0,0,0,22500,22500,22500,0
50208916,FA2021 ,12625,500,NULL,NULL,13125,5425,0,5425,NULL,6925,0,6925,6200,6200,6200,0
50208916,SP2021 ,12625,500,NULL,NULL,13125,7425,0,7425,NULL,7425,0,7425,5700,5700,5700,0
50215052,FA2021 ,12625,500,4580,2550,20255,6925,6925,0,14002,10548,0,24550,2577,9707,-4295,0
50215052,FA2022 ,13005,515,4610,1140,19270,7825,7825,0,14566,7825,0,22391,5695,11445,-3121,0
50215052,FA2023 ,13500,550,5440,1200,20690,7825,7825,0,13148,10548,0,23696,3502,10142,-3006,0
50215052,SP2021 ,12625,500,4580,2550,20255,6925,6925,0,11129,8547,0,19676,4578,11708,579,0
50215052,SP2022 ,13005,515,4610,1140,19270,7825,7825,0,11405,7825,0,19230,5695,11445,40,0
50215052,SP2023 ,13500,550,5440,1200,20690,7825,7825,0,13148,10547,0,23695,3503,10143,-3005,0
50228162,FA2023 ,13500,550,5150,2325,21525,5150,5150,0,18642,8848,0,27490,5202,12677,-5965,0
50228162,FA2024 ,14750,600,5410,2680,23440,5150,5000,150,17842,8848,0,26690,6502,14592,-3250,0
50228162,SP2023 ,13500,550,5150,2325,21525,5150,5150,0,15400,8847,0,24247,5203,12678,-2722,0
50228162,SP2024 ,14750,600,5410,2450,23210,5150,5000,150,15650,8847,0,24497,6503,14363,-1287,0
50225491,FA2022 ,13005,515,4810,2220,20550,7750,7750,0,14449,7750,0,22199,5770,12800,-1649,-5217
50225491,FA2023 ,13500,550,4000,2325,20375,7750,7750,0,10538,11750,0,22288,2300,8625,-1913,-5217
50225491,FA2024 ,14750,600,5030,1270,21650,9250,7750,1500,12592,11850,0,24442,3500,9800,-2792,-5217
50225491,SP2022 ,13005,515,4810,2220,20550,7750,7750,0,12412,7750,0,20162,5770,12800,388,-5217
50225491,SP2023 ,13500,550,4000,2325,20375,7750,7750,0,10538,11750,0,22288,2300,8625,-1913,-5217
50225491,SP2024 ,14750,600,5030,1270,21650,9250,7750,1500,12592,11350,0,23942,4000,10300,-2292,-5217
50232246,SP2023 ,14500,7000,7000,NULL,21500,0,0,0,NULL,0,0,0,21500,21500,21500,0
50216198,FA2021 ,12625,500,4580,2110,19815,9425,9425,0,3250,15073,0,18323,-1948,4742,1492,0
50216198,FA2022 ,13005,515,3855,1140,18515,10425,1000,9425,3750,14273,0,18023,-753,4242,492,0
50216198,FA2023 ,13500,550,4790,NULL,18840,11925,2500,9425,3750,15198,0,18948,-1148,3642,-108,0
50216198,SP2021 ,12625,500,4580,2110,19815,9425,9425,0,3250,14132,0,17382,-1007,5683,2433,0
50216198,SP2022 ,13005,515,3855,1140,18515,10425,1000,9425,3750,14272,0,18022,-752,4243,493,0
50203324,FA2021 ,12625,500,4270,NULL,17395,6875,6875,0,14250,8375,0,22625,4750,9020,-5230,0
50203324,FA2022 ,13005,515,NULL,NULL,13520,5375,5375,0,7750,5375,0,13125,8145,8145,395,0
50203324,SP2021 ,12625,500,4270,NULL,17395,6875,6875,0,14250,6875,0,21125,6250,10520,-3730,0
50198519,SP2021 ,3470,NULL,NULL,NULL,3470,0,0,0,NULL,0,0,0,3470,3470,3470,0
50218313,FA2021 ,12625,500,3740,2110,18975,8975,8975,0,3250,14447,0,17697,-1322,4528,1278,0
50218313,FA2022 ,13005,515,4610,1140,19270,8975,8975,0,3750,11848,0,15598,1672,7422,3672,0
50218313,FA2023 ,13500,550,5440,1200,20690,8975,8975,0,0,10997,0,10997,3053,9693,9693,0
50218313,SP2021 ,12625,500,3740,2110,18975,8975,8975,0,3250,12448,0,15698,677,6527,3277,0
50218313,SP2022 ,13005,515,4610,1140,19270,8975,8975,0,3750,11847,0,15597,1673,7423,3673,0
50218313,SP2023 ,13500,550,5440,1200,20690,8975,8975,0,0,10998,0,10998,3052,9692,9692,0
50160517,FA2021 ,12625,500,3740,2110,18975,6425,3375,3050,3750,12073,0,15823,1052,6902,3152,0
50160517,FA2022 ,13005,515,5080,1140,19740,6425,700,5725,3750,10273,0,14023,3247,9467,5717,0
50160517,SP2021 ,12625,500,3740,2110,18975,6425,3375,3050,3750,11132,0,14882,1993,7843,4093,0
50206386,FA2021 ,12625,500,3740,1080,17945,5425,3425,2000,3750,10165,0,13915,2960,7780,4030,0
50206386,FA2022 ,13005,515,NULL,NULL,13520,6471,4471,2000,3750,6471,0,10221,7049,7049,3299,0
50206386,SP2021 ,12625,500,3740,1080,17945,3425,3425,0,3750,7165,0,10915,5960,10780,7030,0
50206386,SP2022 ,13005,515,NULL,NULL,13520,3425,3425,0,3750,3425,0,7175,10095,10095,6345,0
50213773,FA2021 ,12625,500,3740,1080,17945,18525,6425,12100,NULL,20025,0,20025,-6900,-2080,-2080,0
50213773,FA2022 ,13005,515,3855,NULL,17375,16925,6425,10500,NULL,16925,0,16925,-3405,450,450,0
50213773,SP2021 ,12625,500,3740,1080,17945,18925,6425,12500,NULL,18925,0,18925,-5800,-980,-980,0
50213773,SP2022 ,13005,515,3855,NULL,17375,16925,6425,10500,NULL,16925,0,16925,-3405,450,450,0
50226849,FA2022 ,13005,515,4810,2220,20550,7500,7500,0,13750,7500,0,21250,6020,13050,-700,0
50226849,FA2023 ,13500,550,4790,1200,20040,7500,7500,0,15391,7500,0,22891,6550,12540,-2851,0
50226849,FA2024 ,14750,600,5720,NULL,21070,7500,7500,0,15250,7500,0,22750,7850,13570,-1680,0
50226849,SP2022 ,13005,515,4610,1140,19270,7500,7500,0,13750,7500,0,21250,6020,11770,-1980,0
50226849,SP2023 ,13500,550,4790,1200,20040,7500,7500,0,15391,7500,0,22891,6550,12540,-2851,0
50226849,SP2024 ,8140,600,5720,NULL,14460,4139,4139,0,15250,4139,0,19389,4601,10321,-4929,0
50221969,FA2021 ,12625,500,3740,2110,18975,9800,7800,2000,2750,14548,0,17298,-1423,4427,1677,270
50221969,FA2022 ,13005,515,3855,2220,19595,7800,7800,0,3250,11648,0,14898,1872,7947,4697,270
50221969,FA2023 ,13500,550,4000,1200,19250,7300,7300,0,2750,11898,0,14648,2152,7352,4602,270
50221969,FA2024 ,14750,600,4200,NULL,19550,7800,7000,800,3750,11898,0,15648,3452,7652,3902,270
50221969,SP2021 ,12625,500,3740,2110,18975,7800,7800,0,2750,12107,0,14857,1018,6868,4118,270
50221969,SP2022 ,13005,515,3855,2220,19595,7800,7800,0,3250,11647,0,14897,1873,7948,4698,270
50221969,SP2023 ,13500,550,4000,1200,19250,7300,7300,0,2750,11897,0,14647,2153,7353,4603,270
50221969,SP2024 ,14750,600,4200,NULL,19550,7800,7000,800,3750,11897,0,15647,3453,7653,3903,270
50219034,FA2021 ,12625,500,NULL,NULL,13125,4675,4675,0,3750,10047,0,13797,3078,3078,-672,0
50219034,FA2022 ,13005,515,NULL,NULL,13520,5925,0,5925,0,10773,0,10773,2747,2747,2747,0
50219034,FA2023 ,13500,550,NULL,NULL,14050,5925,0,5925,NULL,11123,0,11123,2927,2927,2927,0
50219034,SP2021 ,12625,500,NULL,NULL,13125,4675,4675,0,3750,8048,0,11798,5077,5077,1327,0
50219034,SP2022 ,13005,515,NULL,NULL,13520,5925,0,5925,0,10772,0,10772,2748,2748,2748,0
50221059,FA2021 ,12625,500,3740,2110,18975,9750,9750,0,2750,16998,0,19748,-3873,1977,-773,2700
50221059,FA2022 ,13005,515,4810,2220,20550,9250,9250,0,3250,14848,0,18098,-1328,5702,2452,2700
50221059,FA2023 ,13500,550,5440,1200,20690,8750,8750,0,3750,14173,0,17923,-123,6517,2767,2700
50221059,FA2024 ,14750,600,5030,1270,21650,9250,7500,1750,3750,13348,0,17098,2002,8302,4552,2700
50221059,SP2021 ,12625,500,3740,2110,18975,10750,9750,1000,2750,16557,0,19307,-3432,2418,-332,2700
50221059,SP2022 ,13005,515,4810,2220,20550,10250,9250,1000,3250,16597,0,19847,-3077,3953,703,2700
50221059,SP2023 ,13500,550,5440,1200,20690,8750,8750,0,3750,14672,0,18422,-622,6018,2268,2700
50221059,SP2024 ,14750,600,5030,1270,21650,9250,7500,1750,3750,13348,0,17098,2002,8302,4552,2700
50209608,FA2021 ,12625,500,4830,2110,20065,0,0,0,3750,16125,12625,19875,-3000,3940,190,0
50209608,FA2022 ,13005,515,5080,1140,19740,500,0,500,NULL,13005,12505,13005,515,6735,6735,0
50209608,SP2021 ,12625,500,4830,2110,20065,0,0,0,3750,12625,12625,16375,500,7440,3690,0
50209608,SP2022 ,13005,515,5080,1140,19740,500,0,500,NULL,13005,12505,13005,515,6735,6735,0
50228087,FA2023 ,13500,550,5150,2325,21525,6500,6500,0,NULL,6500,0,6500,7550,15025,15025,0
50228087,SP2023 ,13500,550,5150,2325,21525,6500,6500,0,NULL,6500,0,6500,7550,15025,15025,0
50226802,FA2022 ,13005,515,NULL,NULL,13520,0,0,0,NULL,0,0,0,13520,13520,13520,0
50226802,SP2022 ,7170,257,NULL,NULL,7427,0,0,0,NULL,0,0,0,7427,7427,7427,0
50231428,FA2024 ,14750,600,4790,2450,22590,7000,7000,0,16750,7000,0,23750,8350,15590,-1160,0
50231428,SP2024 ,14750,600,4790,2450,22590,7000,7000,0,16750,7000,0,23750,8350,15590,-1160,0
50206872,FA2021 ,12625,500,4580,2550,20255,2275,0,2275,18562,3775,0,22337,9350,16480,-2082,0
50206872,SP2021 ,12625,500,4580,2550,20255,2275,0,2275,19552,2275,0,21827,10850,17980,-1572,0
50222066,FA2021 ,12625,500,3740,2550,19415,5800,5000,800,0,6800,0,6800,6325,12615,12615,0
50222066,FA2022 ,13005,515,3855,2220,19595,4500,4500,0,3250,4500,0,7750,9020,15095,11845,0
50222066,FA2023 ,13500,550,4000,2325,20375,4750,4750,0,3750,4750,0,8500,9300,15625,11875,0
50222066,FA2024 ,14750,600,5030,1270,21650,4800,4800,0,3750,4800,0,8550,10550,16850,13100,0
50222066,SP2021 ,12625,500,3740,2550,19415,5000,5000,0,0,5000,0,5000,8125,14415,14415,0
50222066,SP2022 ,13005,515,3855,2220,19595,4500,4500,0,3250,4500,0,7750,9020,15095,11845,0
50222066,SP2023 ,13500,550,4000,2325,20375,4500,4500,0,3750,4500,0,8250,9550,15875,12125,0
50222066,SP2024 ,14750,600,5030,1270,21650,4500,4500,0,3750,4500,0,8250,10850,17150,13400,0
50120427,FA2024 ,14750,600,4200,2450,22000,8050,8050,0,2750,8050,0,10800,7300,13950,11200,2497.66
50120427,SP2024 ,14750,600,4200,2450,22000,8050,8050,0,2750,8050,0,10800,7300,13950,11200,2497.66
50225988,FA2022 ,13005,515,3855,1140,18515,6000,6000,0,2750,8773,0,11523,4747,9742,6992,0
50225988,FA2023 ,13500,550,4560,2325,20935,6000,6000,0,0,9926,0,9926,4124,11009,11009,0
50225988,SP2022 ,13005,515,3855,1140,18515,6000,6000,0,2750,17359,0,20109,-3839,1156,-1594,0
50231165,FA2023 ,13500,550,4560,2325,20935,8500,6500,2000,3750,16354,0,20104,-2304,4581,831,6221.5
50231165,FA2024 ,14750,600,5410,2450,23210,7300,7300,0,3750,21981,0,25731,-6631,1229,-2521,6221.5
50231165,SP2023 ,13500,550,4560,2325,20935,6500,6500,0,3750,13372,0,17122,678,7563,3813,6221.5
50231165,SP2024 ,14750,600,5410,2450,23210,7300,7300,0,3750,8625,0,12375,6725,14585,10835,6221.5
50157108,FA2021 ,12625,500,4270,1080,18475,3175,3175,0,NULL,3675,0,3675,9450,14800,14800,0
50157108,SP2021 ,12625,500,4270,1080,18475,3175,3175,0,NULL,3175,0,3175,9950,15300,15300,0
50230498,FA2024 ,14750,600,4790,2450,22590,12000,0,12000,NULL,12000,0,12000,3350,10590,10590,-10
50230498,SP2024 ,14750,600,4780,2450,22580,10000,0,10000,NULL,10000,0,10000,5350,12580,12580,-10
50228643,FA2023 ,13500,550,4000,2325,20375,8500,8500,0,9250,8500,0,17750,5550,11875,2625,0
50228643,FA2024 ,14750,600,4200,2450,22000,8500,8500,0,13631,8500,0,22131,6850,13500,-131,0
50228643,SP2023 ,13500,550,4000,2325,20375,8500,8500,0,9250,8500,0,17750,5550,11875,2625,0
50228643,SP2024 ,14750,600,4200,2450,22000,8500,8500,0,13630,8500,0,22130,6850,13500,-130,0
50203354,FA2021 ,12625,500,5160,1080,19365,8425,8425,0,3750,8425,0,12175,4700,10940,7190,0
50203354,SP2021 ,12625,500,5160,NULL,18285,8425,8425,0,3750,8425,0,12175,4700,9860,6110,0
50226257,FA2022 ,13005,515,NULL,27.45,13547.45,5313,5313,0,1750,8686,0,10436,4834,4861.45,3111.45,0
50226257,FA2023 ,13500,550,NULL,NULL,14050,4968,3768,1200,0,6218,0,6218,7832,7832,7832,0
50226257,FA2024 ,14750,600,NULL,NULL,15350,4968,4768,200,0,6838,0,6838,8512,8512,8512,0
50226257,SP2022 ,13005,515,NULL,NULL,13520,5313,5313,0,1750,8685,0,10435,4835,4835,3085,0
50226257,SP2023 ,13500,550,NULL,NULL,14050,4968,3768,1200,0,6218,0,6218,7832,7832,7832,0
50226257,SP2024 ,14750,600,NULL,NULL,15350,4968,4768,200,0,6838,0,6838,8512,8512,8512,0
50226797,FA2022 ,13005,515,4810,2220,20550,6500,6500,0,11250,6500,0,17750,7020,14050,2800,0
50226797,FA2023 ,13500,550,5440,NULL,19490,6500,6500,0,10450,6500,0,16950,7550,12990,2540,0
50226797,SP2022 ,13005,515,4810,2220,20550,6500,6500,0,10350,6500,0,16850,7020,14050,3700,0
50226797,SP2023 ,13500,550,5440,NULL,19490,6500,6500,0,8500,6500,0,15000,7550,12990,4490,0
50226458,FA2022 ,13005,515,4810,2220,20550,5500,5500,0,2750,11448,0,14198,2072,9102,6352,4577
50226458,FA2023 ,13500,550,5150,2325,21525,6600,6600,0,NULL,10298,0,10298,3752,11227,11227,4577
50226458,FA2024 ,14750,600,5030,1270,21650,6600,6600,0,NULL,6600,0,6600,8750,15050,15050,4577
50226458,SP2022 ,13005,515,4810,2220,20550,5500,5500,0,2750,11447,0,14197,2073,9103,6353,4577
50226458,SP2023 ,13500,550,5150,2325,21525,6600,6600,0,NULL,10297,0,10297,3753,11228,11228,4577
50226458,SP2024 ,14750,600,5030,NULL,20380,6600,6600,0,NULL,6600,0,6600,8750,13780,13780,4577
50224350,FA2022 ,13005,515,3855,2220,19595,5500,5500,0,2750,5500,0,8250,8020,14095,11345,0
50224350,SP2022 ,13005,515,3855,2220,19595,5500,5500,0,2750,5500,0,8250,8020,14095,11345,0
50231460,FA2024 ,14750,600,4200,2450,22000,8000,8000,0,2750,8000,0,10750,7350,14000,11250,3383.66
50231460,SP2024 ,14750,600,4200,2450,22000,9000,9000,0,2750,9000,0,11750,6350,13000,10250,3383.66
50216079,FA2021 ,12625,500,4580,2110,19815,4425,4425,0,NULL,4925,0,4925,8200,14890,14890,0
50216079,FA2022 ,13005,515,NULL,NULL,13520,2925,2925,0,NULL,2925,0,2925,10595,10595,10595,0
50216079,SP2021 ,12625,500,4580,2110,19815,4425,4425,0,NULL,4425,0,4425,8700,15390,15390,0
50216079,SP2022 ,13005,515,NULL,NULL,13520,2925,2925,0,NULL,2925,0,2925,10595,10595,10595,0
50228206,FA2023 ,13500,550,4560,2325,20935,6500,6500,0,NULL,6500,0,6500,7550,14435,14435,0
50228206,FA2024 ,14750,600,4790,2450,22590,6500,6500,0,NULL,6500,0,6500,8850,16090,16090,0
50228206,SP2023 ,13500,550,4560,2325,20935,6500,6500,0,NULL,6500,0,6500,7550,14435,14435,0
50228206,SP2024 ,14750,600,4790,2450,22590,6500,6500,0,NULL,6500,0,6500,8850,16090,16090,0
50205000,FA2021 ,12625,6350,6350,NULL,18975,9175,1550,7625,NULL,9175,0,9175,9800,9800,9800,0
50205000,SP2021 ,12625,500,4270,1080,18475,9175,1550,7625,NULL,9175,0,9175,3950,9300,9300,0
50228697,FA2023 ,13500,550,4560,2325,20935,9500,0,9500,2750,13000,0,15750,1050,7935,5185,3438
50228697,FA2024 ,14750,600,4790,2450,22590,9500,0,9500,3250,12000,0,15250,3350,10590,7340,3438
50228697,SP2023 ,13500,550,4560,2325,20935,9500,0,9500,2750,9500,0,12250,4550,11435,8685,3438
50228697,SP2024 ,14750,600,4790,2450,22590,9500,0,9500,3250,9500,0,12750,5850,13090,9840,3438
9447410,FA2021 ,3470,NULL,NULL,NULL,3470,0,0,0,NULL,0,0,0,3470,3470,3470,0
9447410,SP2021 ,6960,250,NULL,NULL,7210,0,0,0,NULL,0,0,0,7210,7210,7210,0
50220870,FA2021 ,12625,500,4580,2110,19815,5750,5750,0,2750,21683,0,24433,-8558,-1868,-4618,0
50220870,FA2022 ,13005,515,4810,2220,20550,5750,5750,0,9971,9598,0,19569,3922,10952,981,0
50220870,SP2021 ,12625,500,4580,2110,19815,7250,7250,0,10357,11557,0,21914,1568,8258,-2099,0
50220870,SP2022 ,13005,515,4810,2220,20550,5750,5750,0,11771,9597,0,21368,3923,10953,-818,0
50231587,FA2024 ,14750,600,4200,2450,22000,8700,8700,0,2750,12698,0,15448,2652,9302,6552,2474.9
50231587,SP2024 ,14750,600,4200,2450,22000,8700,8700,0,2750,12697,0,15447,2653,9303,6553,2474.9
50224257,FA2022 ,13005,515,3855,2220,19595,8000,8000,0,NULL,8000,0,8000,5520,11595,11595,12446
50224257,FA2023 ,13500,550,4000,2325,20375,7750,7750,0,NULL,11750,0,11750,2300,8625,8625,12446
50224257,FA2024 ,14750,600,4200,2450,22000,8750,7750,1000,NULL,12950,0,12950,2400,9050,9050,12446
50224257,SP2021 ,12625,500,NULL,NULL,13125,7000,7000,0,NULL,7000,0,7000,6125,6125,6125,12446
50224257,SP2022 ,13005,515,3855,2220,19595,7500,7500,0,NULL,7500,0,7500,6020,12095,12095,12446
50224257,SP2023 ,13500,550,4000,2325,20375,7750,7750,0,NULL,11750,0,11750,2300,8625,8625,12446
50224257,SP2024 ,14750,600,4200,2450,22000,8750,7750,1000,NULL,12950,0,12950,2400,9050,9050,12446
50228909,FA2023 ,13500,550,4000,2325,20375,9000,7000,2000,3750,20973,0,24723,-6923,-598,-4348,-2166
50228909,FA2024 ,14750,600,4200,2450,22000,9900,7000,2900,2250,19598,0,21848,-4248,2402,152,-2166
50228909,SP2023 ,13500,550,4000,2325,20375,7000,7000,0,3750,11472,0,15222,2578,8903,5153,-2166
50228909,SP2024 ,14750,7250,7250,NULL,22000,8900,8900,0,2250,14097,0,16347,7903,7903,5653,-2166
50222406,FA2021 ,12625,500,4580,2110,19815,7850,7850,0,7000,11058,0,18058,2067,8757,1757,0
50222406,SP2021 ,12625,500,4580,2110,19815,7850,7850,0,9750,9772,0,19522,3353,10043,293,0
50218865,FA2021 ,12625,500,4050,2110,19285,11375,9375,2000,2750,16148,0,18898,-3023,3137,387,0
50218865,FA2022 ,13005,515,4260,2220,20000,9375,9375,0,3750,10998,0,14748,2522,9002,5252,0
50218865,FA2023 ,13500,550,4560,2325,20935,9375,5675,3700,3750,13472,0,17222,578,7463,3713,0
50218865,SP2021 ,12625,500,4050,2110,19285,9375,9375,0,2750,12147,0,14897,978,7138,4388,0
50218865,SP2022 ,13005,515,4260,2220,20000,9375,9375,0,3750,10997,0,14747,2523,9003,5253,0
50218865,SP2023 ,13500,550,4560,2325,20935,9375,5675,3700,3750,13473,0,17223,577,7462,3712,0
50225014,FA2023 ,13500,550,4000,2535,20585,9500,0,9500,4450,10593,0,15043,3457,9992,5542,0
50225014,FA2024 ,14750,600,4200,2450,22000,9500,0,9500,3750,14880,0,18630,470,7120,3370,0
50225014,SP2023 ,13500,550,4000,2325,20375,9500,0,9500,4450,9500,0,13950,4550,10875,6425,0
50225014,SP2024 ,14750,600,4200,2450,22000,9500,0,9500,3750,13700,0,17450,1650,8300,4550,0
50227905,FA2023 ,13500,550,4560,2325,20935,9000,5000,4000,19000,9000,0,28000,5050,11935,-7065,10475
50227905,FA2024 ,14750,600,5240,1270,21860,10000,5000,5000,NULL,10000,0,10000,5350,11860,11860,10475
50227905,SP2022 ,13005,515,4810,2220,20550,9000,9000,0,NULL,9000,0,9000,4520,11550,11550,10475
50227905,SP2023 ,16120,550,4560,1200,22430,9000,5000,4000,14000,9000,0,23000,7670,13430,-570,10475
50227905,SP2024 ,14750,600,5240,1270,21860,9000,5000,4000,NULL,9000,0,9000,6350,12860,12860,10475
50217189,FA2021 ,12625,500,4050,2110,19285,5750,5750,0,15264,5750,0,21014,7375,13535,-1729,0
50217189,FA2022 ,13005,515,5080,1140,19740,5250,5250,0,16759,5250,0,22009,8270,14490,-2269,0
50217189,FA2023 ,13500,550,5800,1200,21050,5250,5250,0,19000,5250,0,24250,8800,15800,-3200,0
50217189,SP2021 ,12625,500,4050,2110,19285,5750,5750,0,15264,5750,0,21014,7375,13535,-1729,0
50217189,SP2022 ,13005,515,5080,1140,19740,5250,5250,0,16758,5250,0,22008,8270,14490,-2268,0
50217189,SP2023 ,13500,550,5800,1200,21050,5250,5250,0,19000,5250,0,24250,8800,15800,-3200,0
50228644,FA2023 ,13500,550,5150,2325,21525,6300,5500,800,0,6300,0,6300,7750,15225,15225,2577
50228644,FA2024 ,14750,600,5410,2450,23210,7300,5500,1800,3250,7300,0,10550,8050,15910,12660,2577
50228644,SP2023 ,13500,550,5150,2325,21525,6300,5500,800,0,6300,0,6300,7750,15225,15225,2577
50228644,SP2024 ,14750,600,5410,2450,23210,7300,5500,1800,3250,7300,0,10550,8050,15910,12660,2577
50222619,FA2021 ,12625,500,4580,2110,19815,8500,6500,2000,2750,10000,0,12750,3125,9815,7065,2636.92
50222619,FA2022 ,13005,515,4810,2220,20550,6500,6000,500,5250,7000,0,12250,6520,13550,8300,2636.92
50222619,FA2023 ,13500,550,4000,2325,20375,7400,4000,3400,5750,9123,0,14873,4927,11252,5502,2636.92
50222619,FA2024 ,14750,600,4790,2450,22590,7000,4000,3000,3750,12598,0,16348,2752,9992,6242,2636.92
50222619,SP2021 ,12625,500,4580,2110,19815,6500,6500,0,2750,6500,0,9250,6625,13315,10565,2636.92
50222619,SP2022 ,13005,515,4810,2220,20550,7000,6000,1000,5250,7000,0,12250,6520,13550,8300,2636.92
50222619,SP2023 ,13500,550,4000,2325,20375,6000,4000,2000,5750,7722,0,13472,6328,12653,6903,2636.92
50222619,SP2024 ,14750,600,4790,2450,22590,6000,4000,2000,3750,11598,0,15348,3752,10992,7242,2636.92
50181743,FA2024 ,14750,600,4780,2450,22580,6000,6000,0,NULL,6000,0,6000,9350,16580,16580,11272
50181743,SP2024 ,14750,600,4780,2450,22580,7000,6000,1000,NULL,7000,0,7000,8350,15580,15580,11272
50209857,FA2021 ,12625,500,3740,NULL,16865,0,0,0,NULL,1500,0,1500,11625,15365,15365,0
50209857,FA2022 ,13005,515,3855,2220,19595,0,0,0,NULL,0,0,0,13520,19595,19595,0
50209857,SP2021 ,12625,500,3740,1080,17945,0,0,0,NULL,0,0,0,13125,17945,17945,0
50216190,FA2021 ,12625,500,3740,2110,18975,3925,700,3225,NULL,5425,0,5425,7700,13550,13550,0
50216190,FA2022 ,13005,515,3855,2220,19595,3925,3925,0,NULL,3925,0,3925,9595,15670,15670,0
50216190,FA2023 ,13500,550,4000,2325,20375,3925,3925,0,NULL,3925,0,3925,10125,16450,16450,0
50216190,SP2021 ,12625,6350,6350,NULL,18975,3925,700,3225,NULL,3925,0,3925,15050,15050,15050,0
50216190,SP2022 ,13005,515,3855,2220,19595,3925,3925,0,NULL,3925,0,3925,9595,15670,15670,0
50232826,FA2024 ,14750,600,4200,2450,22000,11800,11800,0,2750,11800,0,14550,3550,10200,7450,2664.66
50232826,SP2024 ,14750,600,4200,2450,22000,11800,11800,0,2750,11800,0,14550,3550,10200,7450,2664.66
50204171,FA2021 ,12625,500,4580,2110,19815,1925,1925,0,20750,4661,0,25411,8464,15154,-5596,0
50204171,SP2021 ,12625,500,4580,2110,19815,1925,1925,0,19250,2661,0,21911,10464,17154,-2096,0
50203632,FA2021 ,12625,500,4830,NULL,17955,8675,0,8675,3750,11675,0,15425,1450,6280,2530,220
50203632,SP2021 ,12625,500,4830,NULL,17955,8675,0,8675,3750,9675,0,13425,3450,8280,4530,220
50204921,FA2021 ,12625,500,5160,1080,19365,4425,4425,0,13750,5925,0,19675,7200,13440,-310,0
50204921,SP2021 ,12625,500,5160,1080,19365,4425,4425,0,13750,4425,0,18175,8700,14940,1190,0
50220891,FA2021 ,12625,500,NULL,NULL,13125,3547,3547,0,0,10195,0,10195,2930,2930,2930,100
50220891,FA2022 ,13005,515,NULL,NULL,13520,3202,3202,0,0,6475,0,6475,7045,7045,7045,100
50220891,FA2023 ,13500,550,NULL,NULL,14050,3202,3202,0,0,9599,0,9599,4451,4451,4451,100
50220891,FA2024 ,14750,600,NULL,NULL,15350,4002,3202,800,3750,8100,0,11850,7250,7250,3500,100
50220891,SP2021 ,12625,500,NULL,NULL,13125,3547,3547,0,0,9754,0,9754,3371,3371,3371,100
50220891,SP2022 ,13005,515,NULL,NULL,13520,3202,3202,0,0,6474,0,6474,7046,7046,7046,100
50220891,SP2023 ,13500,550,NULL,NULL,14050,3202,3202,0,0,9600,0,9600,4450,4450,4450,100
50220891,SP2024 ,14750,600,NULL,NULL,15350,4002,3202,800,3750,8100,0,11850,7250,7250,3500,100
50228002,FA2023 ,13500,550,5150,2325,21525,9000,9000,0,2750,14198,0,16948,-148,7327,4577,0
50228002,FA2024 ,14750,600,4790,2450,22590,9000,9000,0,3250,14198,0,17448,1152,8392,5142,0
50228002,SP2023 ,13500,550,5150,2325,21525,9000,9000,0,2750,14197,0,16947,-147,7328,4578,0
50228002,SP2024 ,14750,600,4790,2450,22590,9000,9000,0,3250,14198,0,17448,1152,8392,5142,0
50229420,FA2023 ,13500,550,5150,2325,21525,7000,7000,0,NULL,9250,0,9250,4800,12275,12275,3541.68
50229420,FA2024 ,14750,600,NULL,NULL,15350,4830,4830,0,NULL,4830,0,4830,10520,10520,10520,3541.68
50229420,SP2023 ,13500,550,NULL,NULL,14050,4830,4830,0,NULL,4830,0,4830,9220,9220,9220,3541.68
50229420,SP2024 ,14750,600,NULL,NULL,15350,4830,4830,0,NULL,4830,0,4830,10520,10520,10520,3541.68
50205272,FA2021 ,12625,500,4050,2110,19285,925,925,0,NULL,925,0,925,12200,18360,18360,0
50205272,SP2021 ,12625,500,4050,2110,19285,925,925,0,NULL,925,0,925,12200,18360,18360,0
50224937,SP2021 ,15944,5556,5556,NULL,21500,0,0,0,NULL,0,0,0,21500,21500,21500,0
50130016,FA2022 ,13005,515,3274,2220,19014,4500,4500,0,2750,4500,0,7250,9020,14514,11764,4561.5
50130016,FA2023 ,13500,550,5150,2325,21525,4500,4500,0,3250,4500,0,7750,9550,17025,13775,4561.5
50130016,FA2024 ,14750,600,5720,1270,22340,4500,4500,0,15750,4500,0,20250,10850,17840,2090,4561.5
50130016,SP2022 ,13005,515,4810,2220,20550,4500,4500,0,13192,4500,0,17692,9020,16050,2858,4561.5
50130016,SP2023 ,13500,550,5150,2325,21525,4500,4500,0,15250,4500,0,19750,9550,17025,1775,4561.5
50130016,SP2024 ,14750,600,NULL,NULL,15350,3105,3105,0,3750,3105,0,6855,12245,12245,8495,4561.5
50130018,FA2024 ,14750,600,5410,2450,23210,5500,5500,0,15750,5500,0,21250,9850,17710,1960,4279
50130018,SP2024 ,14750,600,NULL,NULL,15350,3795,3795,0,2750,4295,0,7045,11055,11055,8305,4279
50232584,FA2024 ,14750,600,5410,2900,23660,8500,8500,0,2750,8500,0,11250,6850,15160,12410,0
50232584,SP2024 ,14750,600,5410,2450,23210,8500,8500,0,2750,8500,0,11250,6850,14710,11960,0
50233207,FA2024 ,14750,600,4200,2450,22000,8700,8700,0,14750,12698,0,27448,2652,9302,-5448,-6334.81
50233207,SP2024 ,14750,600,4200,2450,22000,8700,8700,0,10750,12697,0,23447,2653,9303,-1447,-6334.81
50205854,FA2021 ,12625,500,4270,1080,18475,0,0,0,NULL,0,0,0,13125,18475,18475,0
50205854,SP2021 ,12625,500,4270,1080,18475,0,0,0,NULL,0,0,0,13125,18475,18475,0
50217287,FA2021 ,12625,500,4470,NULL,17595,3425,0,3425,NULL,3425,0,3425,9700,14170,14170,0
50217287,FA2022 ,13005,515,4610,NULL,18130,3425,0,3425,NULL,3425,0,3425,10095,14705,14705,0
50217287,SP2021 ,12625,500,4470,NULL,17595,3425,0,3425,NULL,3425,0,3425,9700,14170,14170,0
50217287,SP2022 ,13005,515,4610,NULL,18130,3425,0,3425,NULL,3425,0,3425,10095,14705,14705,0
50225090,FA2022 ,13005,515,3855,2220,19595,8750,6750,2000,2750,8750,0,11500,4770,10845,8095,0
50225090,FA2023 ,13500,550,4000,2325,20375,8750,6750,2000,3250,8750,0,12000,5300,11625,8375,0
50225090,FA2024 ,14750,600,5410,2450,23210,7950,6750,1200,3750,7950,0,11700,7400,15260,11510,0
50225090,SP2022 ,13005,515,3855,2220,19595,6750,6750,0,2750,6750,0,9500,6770,12845,10095,0
50225090,SP2023 ,13500,550,4000,2325,20375,6750,6750,0,3250,6750,0,10000,7300,13625,10375,0
50225090,SP2024 ,14750,7250,7250,NULL,22000,6750,6750,0,3750,6750,0,10500,15250,15250,11500,0
50226766,FA2022 ,13005,515,4810,2690,21020,6000,6000,0,3250,6000,0,9250,7520,15020,11770,0
50226766,FA2023 ,13500,550,4000,2325,20375,5000,5000,0,3250,8472,0,11722,5578,11903,8653,0
50226766,FA2024 ,14750,600,5030,NULL,20380,6500,5500,1000,3750,8765,0,12515,6585,11615,7865,0
50226766,SP2022 ,13005,515,4810,2690,21020,6000,6000,0,3250,6000,0,9250,7520,15020,11770,0
50226766,SP2023 ,13500,550,4000,2325,20375,5000,5000,0,3250,8473,0,11723,5577,11902,8652,0
50226766,SP2024 ,14750,600,5030,NULL,20380,6500,5500,1000,3750,8765,0,12515,6585,11615,7865,0
50213310,FA2021 ,12625,500,4580,2110,19815,925,0,925,NULL,2425,0,2425,10700,17390,17390,0
50213310,FA2022 ,13005,515,3855,2220,19595,925,0,925,NULL,925,0,925,12595,18670,18670,0
50213310,FA2023 ,13500,550,4000,2325,20375,925,0,925,NULL,925,0,925,13125,19450,19450,0
50213310,FA2024 ,8140,600,4780,2450,15970,510,0,510,NULL,510,0,510,8230,15460,15460,0
50213310,SP2021 ,12625,500,4580,2110,19815,1425,0,1425,NULL,1425,0,1425,11700,18390,18390,0
50213310,SP2022 ,13005,515,3855,2220,19595,925,0,925,NULL,925,0,925,12595,18670,18670,0
50213310,SP2023 ,13500,550,4000,2325,20375,925,0,925,NULL,925,0,925,13125,19450,19450,0
50222824,FA2021 ,12625,500,3740,2110,18975,6500,6500,0,4750,12148,0,16898,977,6827,2077,-9401
50222824,FA2022 ,13005,515,4260,2220,20000,9150,7650,1500,1281,19747,0,21028,-6227,253,-1028,-9401
50222824,FA2023 ,14380,550,4560,2325,21815,9900,7000,2900,3250,18247,0,21497,-3317,3568,318,-9401
50222824,FA2024 ,14750,600,4790,1270,21410,8400,5500,2900,0,25748,0,25748,-10398,-4338,-4338,-9401
50222824,SP2021 ,12625,500,3740,2110,18975,6500,6500,0,4750,11707,0,16457,1418,7268,2518,-9401
50222824,SP2022 ,13005,515,4260,2220,20000,9150,7650,1500,3250,19748,0,22998,-6228,252,-2998,-9401
50222824,SP2023 ,13500,550,4560,2325,20935,10900,7000,3900,4250,19248,0,23498,-5198,1687,-2563,-9401
50222824,SP2024 ,14750,600,4790,1270,21410,8400,5500,2900,0,30248,0,30248,-14898,-8838,-8838,-9401
50226495,FA2022 ,13005,515,4260,2220,20000,5500,5500,0,4750,9848,0,14598,3672,10152,5402,5846
50226495,FA2023 ,13500,550,4560,2325,20935,5000,5000,0,4750,9598,0,14348,4452,11337,6587,5846
50226495,FA2024 ,14750,600,4790,2450,22590,9250,5000,4250,6350,18598,0,24948,-3248,3992,-2358,5846
50226495,SP2022 ,13005,515,4260,2220,20000,5500,5500,0,4750,9847,0,14597,3673,10153,5403,5846
50226495,SP2023 ,13500,550,4560,2325,20935,6000,5000,1000,4750,11597,0,16347,2453,9338,4588,5846
50226495,SP2024 ,14750,600,4790,2450,22590,8250,5000,3250,6350,17597,0,23947,-2247,4993,-1357,5846
50227626,FA2022 ,13005,515,4260,2220,20000,6500,6500,0,5250,10448,0,15698,3072,9552,4302,10377
50227626,FA2023 ,13500,550,4560,2325,20935,8000,8000,0,6250,12097,0,18347,1953,8838,2588,10377
50227626,SP2022 ,13005,515,4260,2220,20000,6500,6500,0,5250,10447,0,15697,3073,9553,4303,10377
50227626,SP2023 ,13500,550,4560,2325,20935,9000,8000,1000,6250,14598,0,20848,-548,6337,87,10377
50234379,FA2024 ,15000,7500,7500,NULL,22500,0,0,0,NULL,0,0,0,22500,22500,22500,0
50211163,FA2021 ,12625,500,3740,NULL,16865,9912,0,9912,NULL,11412,0,11412,1713,5453,5453,12400
50211163,FA2022 ,13005,515,4260,2220,20000,9912,3662,6250,NULL,14172,0,14172,-652,5828,5828,12400
50211163,FA2023 ,13500,550,1500,NULL,15550,9912,3662,6250,NULL,9912,0,9912,4138,5638,5638,12400
50211163,SP2021 ,12625,500,3740,NULL,16865,9912,0,9912,NULL,9912,0,9912,3213,6953,6953,12400
50211163,SP2022 ,13005,515,4260,2220,20000,9912,3662,6250,NULL,14172,0,14172,-652,5828,5828,12400
50209248,FA2021 ,12625,500,4050,2110,19285,1925,1925,0,0,2925,0,2925,10200,16360,16360,0
50209248,SP2021 ,12625,500,4050,2110,19285,1925,1925,0,0,1925,0,1925,11200,17360,17360,0
50210669,FA2021 ,12625,500,4050,2110,19285,8625,6625,2000,3750,14175,0,17925,-1050,5110,1360,0
50210669,FA2022 ,13005,515,3855,2220,19595,8625,6625,2000,3750,13553,0,17303,-33,6042,2292,0
50210669,SP2021 ,12625,500,4050,2110,19285,6625,6625,0,3750,10675,0,14425,2450,8610,4860,0
50210669,SP2022 ,13005,515,3855,2220,19595,6625,6625,0,3750,11552,0,15302,1968,8043,4293,0
50204983,FA2021 ,12625,500,NULL,NULL,13125,500,500,0,11250,1000,0,12250,12125,12125,875,0
50204983,SP2021 ,12625,500,NULL,NULL,13125,500,500,0,15750,500,0,16250,12625,12625,-3125,0
50231675,FA2024 ,14750,600,5410,2450,23210,11000,9000,2000,2750,14213,0,16963,1137,8997,6247,2802
50231675,SP2024 ,14750,600,5410,2450,23210,9000,9000,0,2750,12212,0,14962,3138,10998,8248,2802
50204625,FA2021 ,12625,500,4830,1080,19035,3525,0,3525,9754,11523,0,21277,1602,7512,-2242,0
50204625,SP2021 ,12625,500,4830,1080,19035,3525,0,3525,12949,10582,0,23531,2543,8453,-4496,0
50232116,FA2024 ,14750,600,NULL,NULL,15350,6900,6900,0,2750,13598,0,16348,1752,1752,-998,-949
50232116,SP2024 ,14750,600,NULL,NULL,15350,6900,6900,0,2750,13597,0,16347,1753,1753,-997,-949
50228343,FA2023 ,13500,550,4560,2325,20935,7500,7500,0,2750,8400,0,11150,5650,12535,9785,0
50228343,FA2024 ,14750,600,5410,2450,23210,7500,7500,0,NULL,7500,0,7500,7850,15710,15710,0
50228343,SP2023 ,13500,550,4560,2325,20935,7500,7500,0,2750,7500,0,10250,6550,13435,10685,0
50228343,SP2024 ,14750,600,5410,2450,23210,7500,7500,0,NULL,7500,0,7500,7850,15710,15710,0
50215319,FA2021 ,19340,860,5440,2110,26890,11500,9500,2000,3250,13000,0,16250,7200,13890,10640,0
50215319,FA2022 ,19910,890,5150,2220,27280,11500,9500,2000,3750,11500,0,15250,9300,15780,12030,0
50215319,SP2021 ,19340,860,5440,2110,26890,9500,9500,0,3250,9500,0,12750,10700,17390,14140,0
50215319,SP2022 ,19910,890,5150,2220,27280,9500,9500,0,3750,9500,0,13250,11300,17780,14030,0
50206206,FA2021 ,12625,500,4830,NULL,17955,8850,6850,2000,6250,10350,0,16600,2775,7605,1355,2443.36
50206206,SP2021 ,12625,500,4830,NULL,17955,6850,6850,0,6250,6850,0,13100,6275,11105,4855,2443.36
50231744,FA2024 ,14750,600,4200,2450,22000,8500,8500,0,2750,8500,0,11250,6850,13500,10750,3646.32
50231744,SP2024 ,14750,600,4200,2450,22000,8500,8500,0,2750,8500,0,11250,6850,13500,10750,3646.32
50228387,SP2022 ,14269,7231,7231,NULL,21500,0,0,0,NULL,0,0,0,21500,21500,21500,0
50220892,FA2021 ,12625,500,3740,2110,18975,6750,6750,0,2750,6750,0,9500,6375,12225,9475,0
50220892,FA2022 ,13005,515,3855,2220,19595,6000,6000,0,3250,6000,0,9250,7520,13595,10345,0
50220892,FA2023 ,13500,550,5440,1200,20690,6000,6000,0,3750,6000,0,9750,8050,14690,10940,0
50220892,FA2024 ,14750,600,5720,1270,22340,6000,6000,0,3750,6000,0,9750,9350,16340,12590,0
50220892,SP2021 ,12625,500,3740,2110,18975,6750,6750,0,2750,6750,0,9500,6375,12225,9475,0
50220892,SP2022 ,13005,515,3855,2220,19595,6000,6000,0,3250,6000,0,9250,7520,13595,10345,0
50220892,SP2023 ,13500,550,5440,1200,20690,6000,6000,0,3750,6000,0,9750,8050,14690,10940,0
50220892,SP2024 ,14750,7250,7250,0,22000,6000,6000,0,3750,6000,0,9750,16000,16000,12250,0
50221643,FA2021 ,12625,500,3740,2110,18975,5500,5500,0,2750,6500,0,9250,6625,12475,9725,0
50221643,FA2022 ,13005,515,4810,2220,20550,5000,5000,0,2750,5000,0,7750,8520,15550,12800,0
50221643,FA2023 ,13500,550,4000,2325,20375,5000,5000,0,3750,5000,0,8750,9050,15375,11625,0
50221643,FA2024 ,14750,600,5410,2450,23210,5000,5000,0,NULL,5000,0,5000,10350,18210,18210,0
50221643,SP2021 ,12625,500,3740,2110,18975,5500,5500,0,2750,5500,0,8250,7625,13475,10725,0
50221643,SP2022 ,13005,515,4810,2220,20550,5000,5000,0,2750,5000,0,7750,8520,15550,12800,0
50221643,SP2023 ,13500,550,4000,2325,20375,5000,5000,0,3750,5000,0,8750,9050,15375,11625,0
50221643,SP2024 ,14750,600,5410,2450,23210,5000,5000,0,NULL,5000,0,5000,10350,18210,18210,0
50229202,FA2023 ,13500,550,5150,2325,21525,7000,7000,0,7971,7000,0,14971,7050,14525,6554,0
50229202,FA2024 ,14750,600,5410,2450,23210,7000,7000,0,9515,7000,0,16515,8350,16210,6695,0
50229202,SP2023 ,13500,550,5150,2325,21525,7000,7000,0,7971,7000,0,14971,7050,14525,6554,0
50229202,SP2024 ,14750,600,5410,2450,23210,7000,7000,0,9515,7000,0,16515,8350,16210,6695,0
50198415,FA2021 ,12625,500,4270,1080,18475,3125,3125,0,3750,4625,0,8375,8500,13850,10100,0
50203418,FA2021 ,12625,500,4830,NULL,17955,3675,3675,0,3750,5175,0,8925,7950,12780,9030,0
50203418,SP2021 ,6960,500,4830,NULL,12290,2026,2026,0,3750,2026,0,5776,5434,10264,6514,0
50223414,FA2021 ,12625,500,3740,2110,18975,5000,5000,0,NULL,5000,0,5000,8125,13975,13975,0
50149338,FA2021 ,12625,500,3740,2110,18975,925,925,0,3750,1425,0,5175,11700,17550,13800,7850
50149338,FA2022 ,13005,515,3855,1140,18515,925,925,0,18382,925,0,19307,12595,17590,-792,7850
50149338,SP2021 ,12625,500,3740,2110,18975,925,925,0,18450,925,0,19375,12200,18050,-400,7850
50149338,SP2022 ,13005,515,3855,1140,18515,925,925,0,3750,925,0,4675,12595,17590,13840,7850
50216126,FA2021 ,12625,500,4050,2110,19285,5425,4825,600,3250,6925,0,10175,6200,12360,9110,0
50216126,SP2021 ,12625,500,4050,2110,19285,5425,4825,600,14347,5425,0,19772,7700,13860,-487,0
50204943,FA2021 ,12625,500,4830,1080,19035,4875,4875,0,3750,6375,0,10125,6750,12660,8910,0
50204943,SP2021 ,12625,500,4830,1080,19035,4875,4875,0,3750,4875,0,8625,8250,14160,10410,0
50226922,FA2023 ,13500,550,4000,2325,20375,7000,7000,0,2750,7000,0,9750,7050,13375,10625,4821.32
50226922,FA2024 ,14750,600,4200,2450,22000,6500,6500,0,3250,6500,0,9750,8850,15500,12250,4821.32
50226922,SP2023 ,13500,550,4000,2325,20375,7000,7000,0,2750,7000,0,9750,7050,13375,10625,4821.32
50226922,SP2024 ,14750,600,4200,2450,22000,6500,6500,0,3250,6500,0,9750,8850,15500,12250,4821.32
50203403,FA2021 ,12625,500,4270,1080,18475,2925,0,2925,3750,4425,0,8175,8700,14050,10300,0
50203403,SP2021 ,12625,500,4270,NULL,17395,2925,0,2925,3750,2925,0,6675,10200,14470,10720,0
50220790,FA2021 ,12625,500,4050,2110,19285,7000,7000,0,2750,9500,0,12250,3625,9785,7035,8867.5
50220790,FA2022 ,13005,515,3855,2690,20065,6500,6500,0,2750,9773,0,12523,3747,10292,7542,8867.5
50220790,FA2023 ,13500,550,5440,1200,20690,7000,0,7000,3750,10273,0,14023,3777,10417,6667,8867.5
50220790,FA2024 ,14750,600,5720,2450,23520,6500,0,6500,3750,10198,0,13948,5152,13322,9572,8867.5
50220790,SP2021 ,12625,500,4050,2550,19725,7000,7000,0,2750,7000,0,9750,6125,12725,9975,8867.5
50220790,SP2022 ,13005,515,3855,2690,20065,6500,6500,0,2750,9772,0,12522,3748,10293,7543,8867.5
50220790,SP2023 ,13500,550,5440,1200,20690,7000,0,7000,3750,10272,0,14022,3778,10418,6668,8867.5
50220790,SP2024 ,14750,600,6090,2450,23890,6500,0,6500,3750,10197,0,13947,5153,13693,9943,8867.5
50225562,FA2022 ,13005,515,4260,2220,20000,5500,5500,0,17093,5500,0,22593,8020,14500,-2593,0
50217446,FA2021 ,12625,500,3740,1080,17945,6925,6925,0,11759,12548,0,24307,577,5397,-6362,-2
50217446,FA2022 ,13005,515,3855,1140,18515,6925,6925,0,18294,6925,0,25219,6595,11590,-6704,-2
50217446,SP2021 ,12625,500,3740,1080,17945,6925,6925,0,11758,10547,0,22305,2578,7398,-4360,-2
50217446,SP2022 ,13005,515,3855,2220,19595,6925,6925,0,3750,6925,0,10675,6595,12670,8920,-2
50211541,FA2021 ,12625,500,4580,2110,19815,0,0,0,5250,1000,0,6250,12125,18815,13565,0
50211541,FA2022 ,13005,515,4610,15,18145,0,0,0,3750,0,0,3750,13520,18145,14395,0
50211541,SP2021 ,12625,500,4580,2110,19815,0,0,0,3750,0,0,3750,13125,19815,16065,0
50211541,SP2022 ,13005,515,4610,NULL,18130,0,0,0,3750,0,0,3750,13520,18130,14380,0
50212783,FA2021 ,12625,500,4580,2110,19815,5425,4950,475,3750,11505,0,15255,1620,8310,4560,0
50212783,FA2022 ,13005,515,4610,NULL,18130,5425,5425,0,3750,7352,0,11102,6168,10778,7028,0
50212783,FA2023 ,13500,550,4790,NULL,18840,5425,5425,0,2000,7425,0,9425,6625,11415,9415,0
50212783,SP2021 ,12625,500,4580,2110,19815,5425,4950,475,3750,10005,0,13755,3120,9810,6060,0
50212783,SP2022 ,13005,515,4610,NULL,18130,5425,5425,0,3750,7353,0,11103,6167,10777,7027,0
50212783,SP2023 ,13500,550,4790,NULL,18840,5425,5425,0,2000,7425,0,9425,6625,11415,9415,0
50210715,FA2021 ,12625,500,3740,2110,18975,3425,3425,0,NULL,3425,0,3425,9700,15550,15550,0
50210715,FA2022 ,13005,515,5080,NULL,18600,3425,3425,0,NULL,3425,0,3425,10095,15175,15175,0
50210715,SP2021 ,12625,500,3740,2110,18975,3425,3425,0,NULL,3425,0,3425,9700,15550,15550,0
50210715,SP2022 ,13005,515,5080,NULL,18600,3425,3425,0,NULL,3425,0,3425,10095,15175,15175,0
50228051,FA2023 ,13500,550,5150,2325,21525,7000,7000,0,NULL,7000,0,7000,7050,14525,14525,0
50228051,FA2024 ,14750,600,5410,2680,23440,8500,8500,0,NULL,8500,0,8500,6850,14940,14940,0
50228051,SP2023 ,13500,550,5150,2325,21525,7000,7000,0,NULL,7000,0,7000,7050,14525,14525,0
50228051,SP2024 ,14750,600,5410,2680,23440,8500,8500,0,NULL,8500,0,8500,6850,14940,14940,0
50235346,FA2024 ,14750,600,4200,2450,22000,10028,10028,0,2750,13726,0,16476,1624,8274,5524,1970.67
50235346,SP2024 ,14750,600,4200,2450,22000,10028,10028,0,2750,13725,0,16475,1625,8275,5525,1970.67
50232484,FA2024 ,14750,600,NULL,NULL,15350,4830,4830,0,12750,7830,0,20580,7520,7520,-5230,-8610
50232484,SP2024 ,14750,600,NULL,NULL,15350,4830,4830,0,12750,7830,0,20580,7520,7520,-5230,-8610
50209016,FA2021 ,6960,250,NULL,NULL,7210,1888,1888,0,NULL,1888,0,1888,5322,5322,5322,0
50209016,FA2022 ,13005,515,NULL,1140,14660,3425,2950,475,NULL,3425,0,3425,10095,11235,11235,0
50209016,SP2021 ,12625,500,NULL,1080,14205,3425,3425,0,NULL,3425,0,3425,9700,10780,10780,0
50216220,FA2021 ,12625,500,4050,2110,19285,4894,1894,3000,3250,17125,10731,20375,-4000,2160,-1090,0
50216220,FA2022 ,13005,515,5080,1140,19740,3894,1894,2000,0,18005,11111,18005,-4485,1735,1735,0
50216220,FA2023 ,13500,550,5440,NULL,19490,4825,2825,2000,0,19800,11475,19800,-5750,-310,-310,0
50216220,SP2021 ,12625,500,4050,2110,19285,1894,1894,0,0,18625,10731,18625,-5500,660,660,0
50216220,SP2022 ,13005,515,5080,1140,19740,1894,1894,0,0,21005,11111,21005,-7485,-1265,-1265,0
50216220,SP2023 ,13500,550,5440,NULL,19490,2025,2025,0,0,22000,11475,22000,-7950,-2510,-2510,0
50204503,FA2021 ,12625,500,4830,NULL,17955,4925,1650,3275,NULL,4925,0,4925,8200,13030,13030,0
50204503,SP2021 ,12625,500,4830,NULL,17955,4925,1650,3275,NULL,4925,0,4925,8200,13030,13030,0
50216415,FA2021 ,12625,500,3740,2110,18975,5350,4850,500,3250,10373,0,13623,2752,8602,5352,0
50216415,FA2022 ,13005,515,3855,2220,19595,4100,3600,500,5250,10198,0,15448,3322,9397,4147,0
50216415,FA2023 ,13500,550,4000,2325,20375,4850,0,4850,3750,11673,0,15423,2377,8702,4952,0
50216415,SP2021 ,12625,500,3740,2110,18975,5350,4850,500,3250,8372,0,11622,4753,10603,7353,0
50216415,SP2022 ,13005,515,3855,2220,19595,3600,3600,0,5250,9697,0,14947,3823,9898,4648,0
50216415,SP2023 ,13500,550,4000,2325,20375,4850,0,4850,3750,11672,0,15422,2378,8703,4953,0
50225328,FA2022 ,13005,515,3855,2220,19595,9500,0,9500,NULL,9500,0,9500,4020,10095,10095,0
50225328,FA2023 ,13500,550,4000,2325,20375,9500,0,9500,NULL,9500,0,9500,4550,10875,10875,0
50225328,FA2024 ,14750,600,5030,NULL,20380,9550,0,9550,NULL,9550,0,9550,5800,10830,10830,0
50225328,SP2022 ,13005,515,3855,2220,19595,9500,0,9500,NULL,9500,0,9500,4020,10095,10095,0
50225328,SP2023 ,13500,550,4000,2325,20375,9550,0,9550,NULL,9550,0,9550,4500,10825,10825,0
50225328,SP2024 ,14750,600,5030,NULL,20380,9500,0,9500,NULL,9500,0,9500,5850,10880,10880,0
50226803,FA2022 ,13005,515,4810,2220,20550,6500,6500,0,NULL,6500,0,6500,7020,14050,14050,0
50226803,FA2023 ,13500,550,4000,2325,20375,6500,6500,0,NULL,6500,0,6500,7550,13875,13875,0
50226803,FA2024 ,14750,600,5030,NULL,20380,7500,6500,1000,NULL,7500,0,7500,7850,12880,12880,0
50226803,SP2022 ,13005,515,4810,2220,20550,6500,6500,0,NULL,6500,0,6500,7020,14050,14050,0
50226803,SP2023 ,13500,550,4000,2325,20375,6500,6500,0,NULL,6500,0,6500,7550,13875,13875,0
50226803,SP2024 ,14750,600,5030,NULL,20380,7500,6500,1000,NULL,7500,0,7500,7850,12880,12880,0
50226980,FA2022 ,13005,515,3855,2220,19595,9000,9000,0,NULL,9000,0,9000,4520,10595,10595,0
50226980,FA2023 ,13500,550,4000,NULL,18050,9000,9000,0,NULL,9000,0,9000,5050,9050,9050,0
50226980,FA2024 ,14750,7250,7250,NULL,22000,9000,9000,0,NULL,9000,0,9000,13000,13000,13000,0
50226980,SP2022 ,13005,515,3855,2220,19595,9000,9000,0,NULL,9000,0,9000,4520,10595,10595,0
50226980,SP2023 ,13500,550,4000,NULL,18050,9000,9000,0,NULL,9000,0,9000,5050,9050,9050,0
50226980,SP2024 ,14750,600,4200,NULL,19550,9000,9000,0,NULL,9000,0,9000,6350,10550,10550,0
50227860,FA2023 ,13500,550,5150,2325,21525,5500,5500,0,2750,5500,0,8250,8550,16025,13275,0
50227860,SP2023 ,13500,550,5150,2325,21525,5500,5500,0,2750,5500,0,8250,8550,16025,13275,0
50230610,FA2023 ,13500,550,5150,2325,21525,7450,7450,0,14569,11148,0,25717,2902,10377,-4192,1023
50230610,SP2023 ,13500,550,5150,2325,21525,7450,7450,0,10129,11147,0,21276,2903,10378,249,1023
50226064,FA2022 ,13005,515,3855,2690,20065,9500,9500,0,NULL,9500,0,9500,4020,10565,10565,0
50226064,FA2023 ,13500,550,4550,2325,20925,9500,9500,0,NULL,9500,0,9500,4550,11425,11425,0
50226064,FA2024 ,14750,7250,7250,NULL,22000,9500,9500,0,NULL,9500,0,9500,12500,12500,12500,0
50226064,SP2022 ,13005,515,3855,2690,20065,9500,9500,0,NULL,9500,0,9500,4020,10565,10565,0
50226064,SP2023 ,13500,550,4550,2325,20925,9500,9500,0,NULL,9500,0,9500,4550,11425,11425,0
50226064,SP2024 ,14750,600,4780,2450,22580,9500,7500,2000,NULL,9500,0,9500,5850,13080,13080,0
50234132,FA2024 ,14750,600,4200,2450,22000,10250,10250,0,11208,12750,0,23958,2600,9250,-1958,0
50209236,FA2021 ,12625,500,4830,NULL,17955,4425,4425,0,NULL,4425,0,4425,8700,13530,13530,0
50209236,SP2021 ,12625,500,4830,NULL,17955,4425,4425,0,NULL,4425,0,4425,8700,13530,13530,0
50204448,FA2021 ,12625,500,NULL,1080,14205,2425,1825,600,3750,3925,0,7675,9200,10280,6530,0
50204448,SP2021 ,3470,NULL,NULL,1080,4550,0,0,0,0,0,0,0,3470,4550,4550,0
50228576,FA2023 ,13500,550,4560,2325,20935,7000,7000,0,NULL,7000,0,7000,7050,13935,13935,0
50228576,FA2024 ,15720,600,4790,2450,23560,7500,7500,0,NULL,7500,0,7500,8820,16060,16060,0
50228576,SP2023 ,13500,550,4560,2325,20935,7000,7000,0,NULL,7000,0,7000,7050,13935,13935,0
50228576,SP2024 ,14750,600,4790,2450,22590,7500,7500,0,NULL,7500,0,7500,7850,15090,15090,0
50204367,FA2021 ,12625,500,4270,NULL,17395,2425,0,2425,NULL,2425,0,2425,10700,14970,14970,0
50231788,FA2024 ,14750,600,4200,2450,22000,8000,8000,0,2750,8250,0,11000,7100,13750,11000,0
50231788,SP2024 ,14750,600,4200,2450,22000,8000,8000,0,2750,8250,0,11000,7100,13750,11000,0
50221418,FA2021 ,12625,500,3740,2110,18975,6750,6750,0,2750,6750,0,9500,6375,12225,9475,0
50221418,FA2022 ,13005,515,4810,2220,20550,6250,6250,0,NULL,6250,0,6250,7270,14300,14300,0
50221418,FA2023 ,13500,6825,6825,NULL,20325,6250,6250,0,NULL,6250,0,6250,14075,14075,14075,0
50221418,FA2024 ,14750,600,5410,2450,23210,6250,6250,0,NULL,6250,0,6250,9100,16960,16960,0
50221418,SP2021 ,12625,500,3740,2110,18975,6750,6750,0,2750,6750,0,9500,6375,12225,9475,0
50221418,SP2022 ,13005,515,4810,2220,20550,6250,6250,0,NULL,6250,0,6250,7270,14300,14300,0
50221418,SP2023 ,13500,550,5150,2325,21525,6250,6250,0,NULL,6250,0,6250,7800,15275,15275,0
50221418,SP2024 ,8140,600,5410,2450,16600,3449,3449,0,NULL,3449,0,3449,5291,13151,13151,0
50229555,FA2023 ,13500,550,4560,2325,20935,7900,7900,0,13441,9150,0,22591,4900,11785,-1656,-2976.03
50229555,FA2024 ,14750,600,4200,2450,22000,9150,6500,2650,11345,12668,0,24013,2682,9332,-2013,-2976.03
50229555,SP2023 ,13500,550,4560,2325,20935,7900,7900,0,13441,9150,0,22591,4900,11785,-1656,-2976.03
50229555,SP2024 ,14750,600,4200,2450,22000,9150,6500,2650,11345,12667,0,24012,2683,9333,-2012,-2976.03
50190282,FA2021 ,12625,500,3740,1080,17945,1425,1425,0,NULL,2925,0,2925,10200,15020,15020,0
50190282,SP2021 ,12625,500,3740,1080,17945,1425,1425,0,NULL,1425,0,1425,11700,16520,16520,0
50204399,FA2022 ,13005,515,5080,1140,19740,9425,7425,2000,NULL,9425,0,9425,4095,10315,10315,0
50204399,FA2023 ,13500,550,5440,1200,20690,9425,7425,2000,NULL,9425,0,9425,4625,11265,11265,0
50204399,SP2022 ,13005,515,5080,1140,19740,7425,7425,0,NULL,7425,0,7425,6095,12315,12315,0
50207397,FA2022 ,13005,515,5080,2220,20820,6500,6500,0,NULL,6500,0,6500,7020,14320,14320,0
50207397,FA2023 ,13500,550,5440,2745,22235,8500,0,8500,NULL,8500,0,8500,5550,13735,13735,0
50207397,SP2022 ,13005,515,5080,2220,20820,6500,6500,0,NULL,6500,0,6500,7020,14320,14320,0
50207397,SP2023 ,13500,550,5440,2325,21815,6500,0,6500,NULL,6500,0,6500,7550,15315,15315,0
50221442,FA2021 ,12625,500,3740,2110,18975,7300,7300,0,2750,8300,0,11050,4825,10675,7925,0
50221442,FA2022 ,13005,515,3855,2220,19595,6050,6050,0,3250,6050,0,9300,7470,13545,10295,0
50221442,FA2023 ,13500,550,4000,2325,20375,6050,6050,0,3750,6050,0,9800,8000,14325,10575,0
50221442,FA2024 ,14750,600,4200,2450,22000,6050,5000,1050,3750,6050,0,9800,9300,15950,12200,0
50221442,SP2021 ,12625,500,3740,2110,18975,7300,7300,0,2750,7300,0,10050,5825,11675,8925,0
50221442,SP2022 ,13005,515,3855,2220,19595,6050,6050,0,3250,6050,0,9300,7470,13545,10295,0
50221442,SP2023 ,13500,550,4000,2325,20375,6050,6050,0,3750,6050,0,9800,8000,14325,10575,0
50221442,SP2024 ,14750,600,4200,2450,22000,6050,5000,1050,3750,6050,0,9800,9300,15950,12200,0
50221505,FA2021 ,12625,500,4580,2110,19815,7750,7750,0,NULL,8750,0,8750,4375,11065,11065,0
50221505,FA2022 ,13005,515,3855,1140,18515,8750,7250,1500,NULL,8750,0,8750,4770,9765,9765,0
50221505,SP2021 ,12625,500,4580,2110,19815,7750,7750,0,NULL,7750,0,7750,5375,12065,12065,0
50221915,FA2021 ,12625,500,4580,2110,19815,5500,5500,0,NULL,5500,0,5500,7625,14315,14315,0
50221915,SP2021 ,12625,500,4580,2110,19815,5500,5500,0,NULL,5500,0,5500,7625,14315,14315,0
50225601,FA2022 ,13005,515,3855,2220,19595,8300,8300,0,2750,10123,0,12873,3397,9472,6722,0
50225601,FA2023 ,13500,550,4000,2325,20375,8300,8300,0,3250,11173,0,14423,2877,9202,5952,0
50225601,SP2022 ,13005,515,3855,2220,19595,8300,8300,0,2750,10122,0,12872,3398,9473,6723,0
50226688,FA2022 ,14269,7231,7231,NULL,21500,0,0,0,NULL,0,0,0,21500,21500,21500,0
50230214,FA2023 ,14500,7000,7000,NULL,21500,0,0,0,NULL,0,0,0,21500,21500,21500,0
50224824,FA2022 ,13005,515,3855,2690,20065,7750,7250,500,12750,8050,0,20800,5470,12015,-735,0
50224824,FA2023 ,13500,550,4560,2535,21145,7750,1250,6500,10351,12310,0,22661,1740,8835,-1516,0
50224824,FA2024 ,14750,600,4790,2450,22590,8250,1250,7000,1580,22640,0,24220,-7290,-50,-1630,0
50224824,SP2022 ,13005,515,3855,2690,20065,7750,7250,500,12750,7750,0,20500,5770,12315,-435,0
50224824,SP2023 ,13500,550,4560,2535,21145,7750,1250,6500,10351,12310,0,22661,1740,8835,-1516,0
50224824,SP2024 ,14750,600,4790,2450,22590,8250,1250,7000,8250,13640,0,21890,1710,8950,700,0
50228886,FA2023 ,13500,550,5150,2745,21945,5500,5500,0,18695,5500,0,24195,8550,16445,-2250,-883.25
50228886,FA2024 ,14750,600,5410,2450,23210,5500,5500,0,19946,5500,0,25446,9850,17710,-2236,-883.25
50228886,SP2023 ,13500,550,5150,2745,21945,5500,5500,0,16010,5500,0,21510,8550,16445,435,-883.25
50228886,SP2024 ,14750,600,5410,2450,23210,5500,5500,0,19946,5500,0,25446,9850,17710,-2236,-883.25
50216700,FA2021 ,12625,500,4580,2110,19815,8425,8425,0,3250,17448,0,20698,-4323,2367,-883,0
50216700,FA2022 ,13005,515,4810,2220,20550,8425,8425,0,3750,17098,0,20848,-3578,3452,-298,0
50216700,FA2023 ,13500,550,5440,1200,20690,8425,8425,0,3750,17898,0,21648,-3848,2792,-958,0
50216700,SP2021 ,12625,500,4580,2110,19815,8425,8425,0,3250,18447,0,21697,-5322,1368,-1882,0
50216700,SP2022 ,13005,515,4810,2220,20550,8425,8425,0,3750,17097,0,20847,-3577,3453,-297,0
50232274,FA2024 ,14750,600,4200,2450,22000,9000,9000,0,2750,9000,0,11750,6350,13000,10250,3469.68
50232274,SP2024 ,14750,600,4200,2450,22000,9000,9000,0,2750,9000,0,11750,6350,13000,10250,3469.68
50231630,FA2024 ,14750,600,5410,2900,23660,8550,8550,0,2750,12498,0,15248,2852,11162,8412,2709
50231630,SP2024 ,14750,600,5410,2450,23210,8550,8550,0,2750,12497,0,15247,2853,10713,7963,2709
50232079,FA2024 ,14750,600,4200,2450,22000,10200,10200,0,0,18398,0,18398,-3048,3602,3602,-928.44
50232079,SP2024 ,14750,600,4200,2450,22000,10200,10200,0,0,15147,0,15147,203,6853,6853,-928.44
50232560,FA2024 ,14750,600,4200,2450,22000,9450,9450,0,2750,13398,0,16148,1952,8602,5852,-1000
50232560,SP2024 ,14750,600,4200,2450,22000,9450,9450,0,2750,13397,0,16147,1953,8603,5853,-1000
50228646,FA2023 ,13500,550,5150,2745,21945,7000,7000,0,2750,7000,0,9750,7050,14945,12195,0
50228646,SP2023 ,13500,550,5150,2535,21735,7000,7000,0,2750,7000,0,9750,7050,14735,11985,0
50221802,FA2021 ,12625,500,4580,2110,19815,4925,4925,0,3250,6425,0,9675,6700,13390,10140,0
50221802,FA2022 ,13005,515,4810,2220,20550,6575,5925,650,3750,6575,0,10325,6945,13975,10225,0
50221802,FA2023 ,13500,550,5150,2325,21525,5675,250,5425,3750,5775,0,9525,8275,15750,12000,0
50221802,SP2021 ,12625,500,4580,2110,19815,4925,4925,0,3250,4925,0,8175,8200,14890,11640,0
50221802,SP2022 ,13005,515,4810,2220,20550,5925,5925,0,3750,5925,0,9675,7595,14625,10875,0
50221802,SP2023 ,13500,550,5150,2325,21525,5675,250,5425,3750,5675,0,9425,8375,15850,12100,0
50222287,FA2021 ,12625,500,3740,2110,18975,8000,8000,0,12090,9000,0,21090,4125,9975,-2115,0
50222287,FA2022 ,13005,515,3855,2220,19595,7500,7500,0,13414,7500,0,20914,6020,12095,-1319,0
50222287,FA2023 ,13500,550,4000,1200,19250,7500,7500,0,3750,7500,0,11250,6550,11750,8000,0
50222287,FA2024 ,14750,600,5720,NULL,21070,7500,5000,2500,9470,7500,0,16970,7850,13570,4100,0
50222287,SP2021 ,12625,500,3740,2110,18975,8000,8000,0,10347,8000,0,18347,5125,10975,628,0
50222287,SP2022 ,13005,515,3855,2220,19595,7500,7500,0,11639,7500,0,19139,6020,12095,456,0
50222287,SP2023 ,13500,550,4000,1200,19250,7500,7500,0,13445,7500,0,20945,6550,11750,-1695,0
50222287,SP2024 ,14750,600,5720,NULL,21070,7500,5000,2500,14399,7500,0,21899,7850,13570,-829,0
50224598,FA2022 ,13005,515,3855,2220,19595,10500,0,10500,1750,14973,0,16723,-1453,4622,2872,0
50224598,FA2023 ,13500,550,4560,2325,20935,11000,500,10500,3250,18098,0,21348,-4048,2837,-413,0
50224598,FA2024 ,14750,600,4200,1270,20820,13550,0,13550,1000,19748,0,20748,-4398,1072,72,0
50224598,SP2022 ,13005,515,3855,2220,19595,9500,0,9500,1750,13972,0,15722,-452,5623,3873,0
50224598,SP2023 ,13500,550,4560,2325,20935,10050,500,9550,3250,14147,0,17397,-97,6788,3538,0
50224598,SP2024 ,14750,600,4200,1270,20820,9500,0,9500,1000,15697,0,16697,-347,5123,4123,0
50229932,FA2023 ,13500,550,NULL,NULL,14050,4140,4140,0,2750,4140,0,6890,9910,9910,7160,2810.32
50229932,FA2024 ,14750,600,NULL,NULL,15350,4140,4140,0,3250,4140,0,7390,11210,11210,7960,2810.32
50229932,SP2023 ,13500,550,NULL,NULL,14050,4140,4140,0,2750,4140,0,6890,9910,9910,7160,2810.32
50229932,SP2024 ,14750,600,NULL,NULL,15350,4140,4140,0,3250,4140,0,7390,11210,11210,7960,2810.32
50120485,FA2024 ,14750,600,4200,2900,22450,10700,10700,0,2750,11770,0,14520,3580,10680,7930,2344.64
50120485,SP2024 ,14750,600,4200,2450,22000,10700,10700,0,2750,11770,0,14520,3580,10230,7480,2344.64
50222335,FA2021 ,12625,500,4580,2110,19815,6500,6500,0,2750,6500,0,9250,6625,13315,10565,0
50222335,FA2022 ,13005,515,4810,2220,20550,6000,6000,0,3250,6000,0,9250,7520,14550,11300,0
50222335,FA2023 ,13500,550,4790,1200,20040,6000,6000,0,NULL,6000,0,6000,8050,14040,14040,0
50222335,FA2024 ,14750,600,5030,2450,22830,6000,6000,0,NULL,6000,0,6000,9350,16830,16830,0
50222335,SP2021 ,12625,500,4580,2110,19815,6500,6500,0,2750,6500,0,9250,6625,13315,10565,0
50222335,SP2022 ,13005,515,4810,2220,20550,6000,6000,0,3250,6000,0,9250,7520,14550,11300,0
50222335,SP2023 ,13500,550,4790,2325,21165,6000,6000,0,NULL,6000,0,6000,8050,15165,15165,0
60001067,FA2022 ,7170,257,NULL,NULL,7427,0,0,0,NULL,7170,7170,7170,257,257,257,0
60001067,SP2021 ,3470,NULL,NULL,NULL,3470,0,0,0,NULL,3470,3470,3470,0,0,0,0
50208993,FA2021 ,12625,500,4050,2110,19285,1925,1925,0,3750,2925,0,6675,10200,16360,12610,0
50208993,FA2022 ,13005,515,4810,2220,20550,1925,1925,0,3750,1925,0,5675,11595,18625,14875,0
50208993,SP2021 ,12625,500,4050,2110,19285,1925,1925,0,3750,1925,0,5675,11200,17360,13610,0
50208993,SP2022 ,13005,515,4810,2220,20550,1925,1925,0,3750,1925,0,5675,11595,18625,14875,0
50223079,FA2021 ,12625,500,4050,2110,19285,5500,5500,0,2750,11273,0,14023,1852,8012,5262,0
50223079,FA2022 ,13005,515,NULL,NULL,13520,3450,3450,0,3250,3450,0,6700,10070,10070,6820,0
50223079,SP2021 ,12625,500,NULL,NULL,13125,4519,4519,0,2750,8791,0,11541,4334,4334,1584,0
50223079,SP2022 ,13005,515,NULL,NULL,13520,3450,3450,0,3250,3450,0,6700,10070,10070,6820,0
50217131,FA2021 ,12625,500,NULL,NULL,13125,925,0,925,NULL,1425,0,1425,11700,11700,11700,0
50217131,FA2022 ,7170,257,NULL,NULL,7427,510,510,0,NULL,510,0,510,6917,6917,6917,0
50217131,SP2021 ,12625,500,NULL,NULL,13125,925,0,925,NULL,925,0,925,12200,12200,12200,0
50221228,FA2021 ,12625,500,3740,2110,18975,7500,7500,0,2750,12248,0,14998,877,6727,3977,0
50221228,FA2022 ,13005,515,3855,2220,19595,7100,6975,125,11473,10947,0,22420,2573,8648,-2825,0
50221228,FA2023 ,13500,550,4560,2325,20935,6650,6525,125,11573,11248,0,22821,2802,9687,-1886,0
50221228,FA2024 ,14750,600,5030,1270,21650,6750,5000,1750,12250,10848,0,23098,4502,10802,-1448,0
50221228,SP2021 ,12625,500,3740,2110,18975,7550,7550,0,2750,11857,0,14607,1268,7118,4368,0
50221228,SP2022 ,13005,515,3855,2220,19595,6750,6625,125,11473,10598,0,22071,2922,8997,-2476,0
50221228,SP2023 ,13500,550,5440,1200,20690,6250,6125,125,11973,10847,0,22820,3203,9843,-2130,0
50221228,SP2024 ,14750,600,5030,1270,21650,6750,5000,1750,12250,10847,0,23097,4503,10803,-1447,0
50204324,FA2021 ,19340,860,5130,1080,25550,9750,6900,2850,12000,15773,0,27773,4427,9777,-2223,0
50204324,FA2022 ,19910,890,5700,2220,27830,12500,4500,8000,12393,16973,0,29366,3827,10857,-1536,0
50204324,SP2021 ,19340,860,5130,1080,25550,9750,6900,2850,12000,13772,0,25772,6428,11778,-222,0
50204324,SP2022 ,10970,890,5700,2220,18890,4756,2481,2275,13107,7031,0,20138,4829,11859,-1248,0
50204922,FA2021 ,12625,500,4830,NULL,17955,4675,0,4675,3750,6175,0,9925,6950,11780,8030,0
50204922,SP2021 ,12625,500,4830,NULL,17955,4675,0,4675,3750,4675,0,8425,8450,13280,9530,0
50225734,FA2022 ,13005,515,NULL,NULL,13520,3105,3105,0,1500,3105,0,4605,10415,10415,8915,0
50225734,FA2023 ,13500,550,NULL,NULL,14050,3260,3260,0,3250,3260,0,6510,10790,10790,7540,0
50225734,FA2024 ,14750,600,NULL,NULL,15350,3105,3105,0,NULL,3105,0,3105,12245,12245,12245,0
50225734,SP2022 ,13005,515,NULL,NULL,13520,3105,3105,0,1500,3105,0,4605,10415,10415,8915,0
50225734,SP2023 ,13500,550,NULL,NULL,14050,3260,3260,0,3250,3260,0,6510,10790,10790,7540,0
50225734,SP2024 ,14750,600,NULL,NULL,15350,3105,3105,0,NULL,3105,0,3105,12245,12245,12245,0
50231876,FA2024 ,14750,600,4200,2900,22450,6000,6000,0,NULL,6000,0,6000,9350,16450,16450,0
50231876,SP2023 ,13500,550,5150,2535,21735,6000,6000,0,NULL,6000,0,6000,8050,15735,15735,0
50231876,SP2024 ,14750,600,4200,2680,22230,6000,6000,0,NULL,6000,0,6000,9350,16230,16230,0
50215203,FA2021 ,12625,500,4240,2110,19475,2925,2925,0,NULL,2925,0,2925,10200,16550,16550,0
50215203,SP2021 ,12625,500,4240,2110,19475,2925,2925,0,NULL,2925,0,2925,10200,16550,16550,0
50204319,FA2021 ,12625,500,4270,1080,18475,0,0,0,18750,1500,0,20250,11625,16975,-1775,0
50204319,SP2021 ,12625,500,4270,1080,18475,0,0,0,18750,0,0,18750,13125,18475,-275,0
50203936,FA2021 ,12625,500,4580,2550,20255,2425,0,2425,3750,3925,0,7675,9200,16330,12580,0
50203936,FA2022 ,13005,515,3855,1140,18515,2425,0,2425,3750,2425,0,6175,11095,16090,12340,0
50203936,SP2021 ,12625,500,4580,2550,20255,2425,0,2425,3750,2425,0,6175,10700,17830,14080,0
50203936,SP2022 ,13005,515,3855,1140,18515,2425,0,2425,250,2425,0,2675,11095,16090,15840,0
50221530,FA2021 ,12625,500,3740,2110,18975,9500,9500,0,2750,18386,0,21136,-5261,589,-2161,0
50221530,FA2022 ,13005,515,4380,2220,20120,9500,9500,0,3250,11386,0,14636,2134,8734,5484,0
50221530,SP2021 ,12625,500,3740,2110,18975,9500,9500,0,2750,11386,0,14136,1739,7589,4839,0
50227624,FA2022 ,13005,515,4810,2220,20550,5750,5750,0,15551,5750,0,21301,7770,14800,-751,0
50236722,SP2024 ,14750,600,5410,2450,23210,9000,9000,0,2750,14197,0,16947,1153,9013,6263,2586.92
50204505,FA2021 ,12625,500,5160,1080,19365,1925,0,1925,3750,2925,0,6675,10200,16440,12690,0
50204505,SP2021 ,12625,500,5160,1080,19365,1925,0,1925,3750,1925,0,5675,11200,17440,13690,0
50228888,FA2023 ,13500,550,5150,2325,21525,8150,5500,2650,12750,8150,0,20900,5900,13375,625,-2477
50228888,FA2024 ,14750,600,4790,2450,22590,8200,5550,2650,13250,10883,0,24133,4467,11707,-1543,-2477
50228888,SP2023 ,13500,550,5150,2325,21525,8150,5500,2650,14096,8150,0,22246,5900,13375,-721,-2477
50228888,SP2024 ,14750,600,4790,2450,22590,8200,5550,2650,13250,10882,0,24132,4468,11708,-1542,-2477
50230088,FA2023 ,13500,550,5150,2325,21525,9150,9150,0,2750,9150,0,11900,4900,12375,9625,3062.7
50230088,FA2024 ,14750,600,5410,2450,23210,9150,9150,0,0,12848,0,12848,2502,10362,10362,3062.7
50230088,SP2023 ,13500,550,5150,2325,21525,9150,9150,0,2750,9150,0,11900,4900,12375,9625,3062.7
50230088,SP2024 ,14750,7250,7250,NULL,22000,9150,9150,0,0,12847,0,12847,9153,9153,9153,3062.7
50232119,FA2024 ,14750,600,4200,2450,22000,7500,6500,1000,17750,7500,0,25250,7850,14500,-3250,-2698.19
50232119,SP2024 ,14750,600,4200,2450,22000,6500,6500,0,17750,6500,0,24250,8850,15500,-2250,-2698.19
50221917,FA2021 ,12625,500,3740,2110,18975,4500,4500,0,2750,5500,0,8250,7625,13475,10725,0
50221917,FA2022 ,13005,515,4810,2220,20550,4000,4000,0,16500,4000,0,20500,9520,16550,50,0
50221917,SP2022 ,13005,515,4810,2220,20550,4000,4000,0,16500,4000,0,20500,9520,16550,50,0
50211374,FA2021 ,12625,500,3740,2110,18975,9275,9275,0,3750,14515,0,18265,-1390,4460,710,0
50211374,FA2022 ,13005,515,4610,NULL,18130,9775,9775,0,3750,9775,0,13525,3745,8355,4605,0
50211374,SP2021 ,12625,500,3740,2110,18975,9275,9275,0,3750,13015,0,16765,110,5960,2210,0
50211374,SP2022 ,13005,515,4610,NULL,18130,9775,9775,0,3750,9775,0,13525,3745,8355,4605,0
50227969,FA2023 ,13500,550,4000,2325,20375,8550,8550,0,2750,10973,0,13723,3077,9402,6652,148.71
50227969,FA2024 ,14750,600,5410,2450,23210,9050,7000,2050,12125,9845,0,21970,5505,13365,1240,148.71
50227969,SP2023 ,13500,550,4000,2325,20375,8550,8550,0,2750,11372,0,14122,2678,9003,6253,148.71
50227969,SP2024 ,14750,600,5410,2450,23210,9050,7000,2050,13797,9845,0,23642,5505,13365,-432,148.71
50221443,FA2021 ,12625,500,4650,2110,19885,7250,7250,0,2750,7250,0,10000,5875,12635,9885,0
50221443,FA2022 ,13005,515,4800,2220,20540,6500,6500,0,3250,6500,0,9750,7020,14040,10790,0
50221443,FA2023 ,13500,550,4990,2325,21365,6500,6500,0,NULL,6500,0,6500,7550,14865,14865,0
50221443,FA2024 ,14750,600,5240,2450,23040,6500,6500,0,NULL,6500,0,6500,8850,16540,16540,0
50221443,SP2021 ,12625,500,4650,2110,19885,7250,7250,0,2750,7250,0,10000,5875,12635,9885,0
50221443,SP2022 ,13005,515,4800,2220,20540,6500,6500,0,3250,6500,0,9750,7020,14040,10790,0
50221443,SP2023 ,13500,550,4990,2325,21365,6500,6500,0,NULL,6500,0,6500,7550,14865,14865,0
50221443,SP2024 ,14750,600,5240,2450,23040,6500,6500,0,NULL,6500,0,6500,8850,16540,16540,0
50221689,FA2021 ,12625,500,4580,2110,19815,5500,5500,0,2750,5500,0,8250,7625,14315,11565,5
50221689,FA2022 ,13005,515,4810,2220,20550,5000,5000,0,3250,5000,0,8250,8520,15550,12300,5
50221689,FA2023 ,13500,550,5150,2325,21525,5000,5000,0,3750,5000,0,8750,9050,16525,12775,5
50221689,FA2024 ,14750,600,5410,2450,23210,5000,5000,0,3750,5000,0,8750,10350,18210,14460,5
50221689,SP2021 ,12625,500,4240,2110,19475,5500,5500,0,2750,5500,0,8250,7625,13975,11225,5
50221689,SP2022 ,13005,515,4810,2220,20550,5000,5000,0,3250,5000,0,8250,8520,15550,12300,5
50221689,SP2023 ,13500,550,5150,2325,21525,5000,5000,0,3750,5000,0,8750,9050,16525,12775,5
50221689,SP2024 ,14750,600,5410,2450,23210,5000,5000,0,3750,5000,0,8750,10350,18210,14460,5
50231984,FA2024 ,14750,600,5410,2450,23210,9500,0,9500,3750,9500,0,13250,5850,13710,9960,2455.66
50231984,SP2024 ,14750,600,5410,2450,23210,9500,0,9500,3750,9500,0,13250,5850,13710,9960,2455.66
50233269,FA2024 ,14750,600,4200,2450,22000,6500,6500,0,2750,6500,0,9250,8850,15500,12750,0
50233269,SP2024 ,14750,600,4200,2450,22000,6500,6500,0,2750,6500,0,9250,8850,15500,12750,0
50221010,FA2022 ,13005,515,NULL,NULL,13520,5925,3925,2000,4750,12023,0,16773,1497,1497,-3253,0
50221010,FA2023 ,13500,550,NULL,NULL,14050,3425,3425,0,5250,9897,0,15147,4153,4153,-1097,0
50221010,SP2022 ,13005,515,NULL,NULL,13520,3925,3925,0,4750,10022,0,14772,3498,3498,-1252,0
50231024,FA2023 ,13500,550,4000,2325,20375,7700,7700,0,2750,11398,0,14148,2652,8977,6227,12547.32
50231024,FA2024 ,14750,600,5720,1270,22340,12700,8750,3950,3250,14170,0,17420,1180,8170,4920,12547.32
50231024,SP2023 ,13500,550,4000,2325,20375,7700,7700,0,2750,11397,0,14147,2653,8978,6228,12547.32
50231024,SP2024 ,14750,600,5720,1270,22340,10700,8750,1950,3250,12170,0,15420,3180,10170,6920,12547.32
50210984,FA2021 ,12625,500,NULL,NULL,13125,400,0,400,NULL,11125,10725,11125,2000,2000,2000,0
50210984,FA2022 ,13005,515,NULL,NULL,13520,780,0,780,NULL,11505,10725,11505,2015,2015,2015,0
50210984,FA2023 ,3720,NULL,NULL,NULL,3720,0,0,0,NULL,0,0,0,3720,3720,3720,0
50210984,SP2021 ,12625,500,NULL,NULL,13125,400,0,400,NULL,11125,10725,11125,2000,2000,2000,0
50210984,SP2022 ,7170,257,NULL,NULL,7427,430,0,430,NULL,6343,5913,6343,1084,1084,1084,0
50220869,FA2021 ,12625,500,4050,2110,19285,9000,9000,0,2750,10000,0,12750,3125,9285,6535,0
50220869,SP2021 ,12625,500,4050,2110,19285,9000,9000,0,2750,9000,0,11750,4125,10285,7535,0
50224248,FA2021 ,12625,500,4270,1080,18475,6000,6000,0,NULL,6000,0,6000,7125,12475,12475,0
50224248,FA2022 ,13005,515,3855,2220,19595,5500,5500,0,NULL,5500,0,5500,8020,14095,14095,0
50224248,SP2021 ,12625,500,4270,1080,18475,6000,6000,0,NULL,6000,0,6000,7125,12475,12475,0
50228682,FA2023 ,13500,550,4000,2325,20375,9100,9100,0,2750,9573,0,12323,4477,10802,8052,-105
50228682,FA2024 ,14750,600,4200,2450,22000,9100,6000,3100,3250,9100,0,12350,6250,12900,9650,-105
50228682,SP2023 ,13500,550,4000,2325,20375,9100,9100,0,2750,9572,0,12322,4478,10803,8053,-105
50228682,SP2024 ,14750,600,4200,2450,22000,9100,6000,3100,3250,9100,0,12350,6250,12900,9650,-105
50234390,FA2024 ,14750,600,4200,2450,22000,6000,6000,0,16324,6000,0,22324,9350,16000,-324,0
50234390,SP2024 ,14750,600,4200,2450,22000,6000,6000,0,16324,6000,0,22324,9350,16000,-324,0
50228722,FA2023 ,13500,550,5150,2325,21525,6000,6000,0,2750,6000,0,8750,8050,15525,12775,5496
50228722,FA2024 ,14750,600,4200,2450,22000,6500,6500,0,3250,6500,0,9750,8850,15500,12250,5496
50228722,SP2023 ,13500,550,5150,2325,21525,8000,6000,2000,2750,8000,0,10750,6050,13525,10775,5496
50228722,SP2024 ,14750,600,4200,2450,22000,6500,6500,0,3250,6500,0,9750,8850,15500,12250,5496
50234309,FA2024 ,14750,600,4790,2450,22590,7400,7400,0,2750,12598,0,15348,2752,9992,7242,2433.66
50234309,SP2024 ,14750,600,4790,2450,22590,7400,7400,0,2750,12597,0,15347,2753,9993,7243,2433.66
50229247,FA2023 ,13500,550,4000,2325,20375,8000,7000,1000,2750,8000,0,10750,6050,12375,9625,3996
50229247,FA2024 ,14750,600,4200,2450,22000,8000,7000,1000,3250,8000,0,11250,7350,14000,10750,3996
50229247,SP2023 ,13500,550,4000,2325,20375,7000,7000,0,2750,7000,0,9750,7050,13375,10625,3996
50229247,SP2024 ,14750,600,4200,2450,22000,7000,7000,0,3250,7000,0,10250,8350,15000,11750,3996
50215204,FA2021 ,12625,500,4580,2110,19815,6750,6750,0,3250,7750,0,11000,5375,12065,8815,0
50215204,FA2022 ,13005,515,4610,NULL,18130,6250,6250,0,3750,6250,0,10000,7270,11880,8130,0
50215204,FA2023 ,13500,6825,6825,NULL,20325,0,0,0,3750,2273,0,6023,18052,18052,14302,0
50215204,SP2021 ,12625,500,4580,2110,19815,6750,6750,0,3250,6750,0,10000,6375,13065,9815,0
50215204,SP2022 ,13005,515,4610,NULL,18130,6250,6250,0,3750,6250,0,10000,7270,11880,8130,0
50235005,FA2024 ,14750,600,4790,2450,22590,9528,9528,0,3250,9528,0,12778,5822,13062,9812,5196
50235005,SP2024 ,14750,600,4790,2450,22590,9528,9528,0,3250,9528,0,12778,5822,13062,9812,5196
50231193,FA2024 ,14750,600,4790,2450,22590,9000,6000,3000,NULL,9000,0,9000,6350,13590,13590,7106.49
50231193,SP2023 ,13500,550,5150,2325,21525,9000,9000,0,NULL,9000,0,9000,5050,12525,12525,7106.49
50231193,SP2024 ,14750,600,4790,2450,22590,9000,6000,3000,NULL,9000,0,9000,6350,13590,13590,7106.49
50234237,FA2024 ,14750,600,4200,2450,22000,12250,2000,10250,2750,17248,0,19998,-1898,4752,2002,616.84
50234237,SP2024 ,14750,600,4200,2450,22000,10250,2000,8250,2750,15247,0,17997,103,6753,4003,616.84
50216398,FA2021 ,12625,500,4580,2110,19815,6675,6675,0,NULL,6675,0,6675,6450,13140,13140,0
50216398,FA2022 ,13005,515,5420,1140,20080,6675,6675,0,NULL,8602,0,8602,4918,11478,11478,0
50216398,FA2023 ,13500,550,5800,NULL,19850,6675,6575,100,NULL,7175,0,7175,6875,12675,12675,0
50216398,SP2021 ,12625,500,4580,2110,19815,6675,6675,0,NULL,6675,0,6675,6450,13140,13140,0
50216398,SP2022 ,13005,515,5420,1140,20080,6675,6675,0,NULL,8603,0,8603,4917,11477,11477,0
50216398,SP2023 ,13500,550,5800,NULL,19850,6675,6575,100,NULL,7175,0,7175,6875,12675,12675,0
60001196,SP2023 ,3720,NULL,NULL,NULL,3720,0,0,0,NULL,3720,3720,3720,0,0,0,0
50210121,FA2021 ,12625,500,3740,2110,18975,12875,0,12875,3250,19115,0,22365,-5990,-140,-3390,0
50210121,FA2022 ,13005,515,4610,1140,19270,8425,5775,2650,0,24951,0,24951,-11431,-5681,-5681,0
50210121,SP2021 ,12625,500,3740,2110,18975,9877,202,9675,3250,13617,0,16867,-492,5358,2108,0
50204107,FA2021 ,6960,500,4830,1080,13370,510,510,0,NULL,510,0,510,6950,12860,12860,0
50204107,SP2021 ,6960,500,4830,1080,13370,510,510,0,NULL,510,0,510,6950,12860,12860,0
50203326,FA2021 ,12625,500,5160,NULL,18285,5575,5575,0,3750,7375,0,11125,5750,10910,7160,0
50203326,SP2021 ,12625,6350,6350,NULL,18975,3050,3050,0,3750,3350,0,7100,15625,15625,11875,0
50225184,FA2022 ,13005,515,4260,2220,20000,7000,7000,0,2750,7000,0,9750,6520,13000,10250,0
50225184,FA2023 ,5570,275,NULL,NULL,5845,1992,1992,0,2750,1992,0,4742,3853,3853,1103,0
50225184,SP2022 ,13005,515,4260,2220,20000,7000,7000,0,2750,7000,0,9750,6520,13000,10250,0
50224353,FA2022 ,13005,515,4810,2220,20550,5250,5250,0,2750,5250,0,8000,8270,15300,12550,0
50224353,FA2023 ,13500,550,5440,1200,20690,5250,5250,0,3250,5250,0,8500,8800,15440,12190,0
50224353,FA2024 ,14750,600,5030,1270,21650,5250,5250,0,13750,5250,0,19000,10100,16400,2650,0
50224353,SP2022 ,13005,515,4810,2220,20550,5250,5250,0,2750,5250,0,8000,8270,15300,12550,0
50224353,SP2023 ,13500,550,5440,1200,20690,5250,5250,0,3250,5250,0,8500,8800,15440,12190,0
50224353,SP2024 ,14750,600,5030,1270,21650,5250,5250,0,13750,5250,0,19000,10100,16400,2650,0
50216173,FA2021 ,19340,860,860,NULL,20200,16000,12000,4000,3250,20500,0,23750,-300,-300,-3550,0
50216173,FA2022 ,19910,890,890,NULL,20800,12000,12000,0,3750,14000,0,17750,6800,6800,3050,0
50216173,FA2023 ,13500,550,NULL,NULL,14050,0,0,0,3750,14500,13500,18250,-450,-450,-4200,0
50216173,SP2021 ,19340,860,860,NULL,20200,12000,12000,0,3250,12000,0,15250,8200,8200,4950,0
50216173,SP2022 ,19910,890,890,NULL,20800,12000,12000,0,3750,14000,0,17750,6800,6800,3050,0
50216173,SP2023 ,13500,550,NULL,NULL,14050,0,0,0,3750,13500,13500,17250,550,550,-3200,0
50226260,FA2022 ,13005,515,4260,2220,20000,6500,6500,0,4300,6500,0,10800,7020,13500,9200,0
50226260,FA2023 ,13500,550,5150,2325,21525,6500,6500,0,3250,6500,0,9750,7550,15025,11775,0
50226260,SP2022 ,13005,515,4260,2220,20000,6500,6500,0,4300,6500,0,10800,7020,13500,9200,0
50226260,SP2023 ,13500,550,5150,2325,21525,6500,6500,0,3250,6500,0,9750,7550,15025,11775,0
50228804,FA2023 ,13500,550,4000,2325,20375,9000,9000,0,2750,11000,0,13750,3050,9375,6625,-174
50228804,FA2024 ,14750,600,5410,2450,23210,9000,9000,0,17245,9000,0,26245,6350,14210,-3035,-174
50228804,SP2023 ,13500,550,4000,2325,20375,9000,9000,0,13150,9000,0,22150,5050,11375,-1775,-174
50228804,SP2024 ,14750,600,5410,2450,23210,9000,9000,0,16250,9000,0,25250,6350,14210,-2040,-174
50222232,FA2021 ,12625,500,3740,2110,18975,5500,5500,0,0,5500,0,5500,7625,13475,13475,0
50222232,SP2021 ,12625,500,3740,2110,18975,5500,5500,0,0,5500,0,5500,7625,13475,13475,0
50208932,FA2021 ,12625,500,5160,NULL,18285,9675,0,9675,11750,11175,0,22925,1950,7110,-4640,0
50208932,FA2022 ,14680,515,5420,NULL,20615,9675,0,9675,16270,9675,0,25945,5520,10940,-5330,0
50208932,SP2021 ,12625,500,5160,NULL,18285,7675,0,7675,10250,7675,0,17925,5450,10610,360,0
50208932,SP2022 ,13005,515,5420,1140,20080,7675,0,7675,12230,7675,0,19905,5845,12405,175,0
50233836,FA2024 ,14750,600,4200,2450,22000,8200,8200,0,2750,8200,0,10950,7150,13800,11050,6981.49
50233836,SP2024 ,14750,600,4200,2450,22000,8200,8200,0,2750,8200,0,10950,7150,13800,11050,6981.49
50233350,FA2024 ,14750,600,5410,2450,23210,6000,6000,0,5750,9698,0,15448,5652,13512,7762,-2136
50233350,SP2024 ,14750,600,5410,2450,23210,6000,6000,0,5750,9697,0,15447,5653,13513,7763,-2136
50219898,FA2021 ,12625,6350,6350,NULL,18975,5175,4425,750,10000,6675,0,16675,12300,12300,2300,0
50219898,FA2022 ,13005,515,4800,2220,20540,5175,4425,750,9750,9023,0,18773,4497,11517,1767,0
50219898,SP2021 ,12625,500,3740,2110,18975,5175,4425,750,15000,5175,0,20175,7950,13800,-1200,0
50219898,SP2022 ,13005,515,4800,2220,20540,5175,4425,750,8750,9022,0,17772,4498,11518,2768,0
50120171,FA2024 ,14750,600,4200,2450,22000,11160,8000,3160,0,28110,0,28110,-12760,-6110,-6110,0
50120171,SP2024 ,14750,600,4200,2450,22000,10000,8000,2000,0,16750,0,16750,-1400,5250,5250,0
50234230,FA2024 ,14750,600,5030,1270,21650,6550,5500,1050,3750,9545,0,13295,5805,12105,8355,0
50234230,SP2024 ,14750,600,5030,NULL,20380,6550,5500,1050,3750,9545,0,13295,5805,10835,7085,0
50225968,FA2022 ,13005,515,4810,2220,20550,9500,5500,4000,2000,15998,0,17998,-2478,4552,2552,0
50225968,FA2023 ,13500,550,5150,2325,21525,9500,500,9000,3250,16448,0,19698,-2398,5077,1827,0
50225968,FA2024 ,14750,600,5410,2680,23440,9541,541,9000,3750,16489,0,20239,-1139,6951,3201,0
50225968,SP2022 ,13005,515,4810,2220,20550,7500,5500,2000,1000,14997,0,15997,-1477,5553,4553,0
50225968,SP2023 ,13500,550,5150,2535,21735,7500,500,7000,3250,14447,0,17697,-397,7288,4038,0
50225968,SP2024 ,14750,600,5410,2680,23440,7500,500,7000,3750,14447,0,18197,903,8993,5243,0
50228163,FA2023 ,13500,550,5150,2325,21525,9000,9000,0,2750,9000,0,11750,5050,12525,9775,1221.33
50228163,FA2024 ,14750,600,5410,2450,23210,9000,9000,0,3250,9000,0,12250,6350,14210,10960,1221.33
50228163,SP2023 ,13500,550,5150,2325,21525,9000,9000,0,2750,9000,0,11750,5050,12525,9775,1221.33
50228163,SP2024 ,14750,600,5410,2450,23210,9000,9000,0,3250,9000,0,12250,6350,14210,10960,1221.33
50228780,FA2023 ,13500,550,5150,2325,21525,9000,9000,0,0,21976,0,21976,-7926,-451,-451,-3592
50228780,FA2024 ,14750,600,5720,1270,22340,9000,9000,0,0,23890,0,23890,-8540,-1550,-1550,-3592
50228780,SP2023 ,13500,550,5150,2325,21525,9000,9000,0,0,15447,0,15447,-1397,6078,6078,-3592
50228780,SP2024 ,14750,600,5720,1270,22340,9000,9000,0,0,24820,0,24820,-9470,-2480,-2480,-3592
50204213,FA2021 ,12625,500,5160,NULL,18285,5225,4075,1150,3750,6725,0,10475,6400,11560,7810,0
50204213,SP2021 ,12625,500,5160,NULL,18285,5225,4175,1050,3750,5225,0,8975,7900,13060,9310,0
50215288,FA2021 ,12625,500,4050,2110,19285,6675,6125,550,0,7675,0,7675,5450,11610,11610,0
50215288,FA2022 ,13005,515,5080,1140,19740,7675,6675,1000,NULL,7675,0,7675,5845,12065,12065,0
50215288,FA2023 ,13500,550,4790,NULL,18840,7675,500,7175,1750,7675,0,9425,6375,11165,9415,0
50215288,SP2021 ,12625,6350,6350,NULL,18975,6675,6675,0,0,6675,0,6675,12300,12300,12300,0
50215288,SP2022 ,13005,515,4260,1140,18920,7675,6675,1000,NULL,7675,0,7675,5845,11245,11245,0
50215288,SP2023 ,13500,550,4790,NULL,18840,7675,500,7175,2750,7675,0,10425,6375,11165,8415,0
50230909,FA2023 ,13500,550,4560,2325,20935,5000,5000,0,0,8673,0,8673,5377,12262,12262,0
50230909,FA2024 ,14750,600,5410,2450,23210,5000,5000,0,3250,8698,0,11948,6652,14512,11262,0
50230909,SP2023 ,13500,550,4560,2325,20935,5000,5000,0,0,8672,0,8672,5378,12263,12263,0
50204070,FA2021 ,12625,500,NULL,1080,14205,0,0,0,3750,1000,0,4750,12125,13205,9455,0
50204070,SP2021 ,12625,500,NULL,1080,14205,0,0,0,3750,0,0,3750,13125,14205,10455,0
50235061,FA2024 ,14750,600,4200,1270,20820,13578,13578,0,NULL,13578,0,13578,1772,7242,7242,0
50235061,SP2024 ,14750,600,4200,1270,20820,13578,13578,0,NULL,13578,0,13578,1772,7242,7242,0
50209542,FA2021 ,12625,500,3740,2110,18975,1425,1425,0,3750,2425,0,6175,10700,16550,12800,0
50209542,FA2022 ,13005,515,4610,1140,19270,1425,1425,0,3750,1425,0,5175,12095,17845,14095,0
50209542,SP2021 ,12625,500,3740,2110,18975,1425,1425,0,3750,1425,0,5175,11700,17550,13800,0
50209542,SP2022 ,13005,515,4610,1140,19270,1425,1425,0,3750,1425,0,5175,12095,17845,14095,0
50229853,FA2023 ,13500,550,5150,2325,21525,5500,5500,0,17718,5500,0,23218,8550,16025,-1693,0
50229853,SP2023 ,13500,550,5150,2325,21525,5500,5500,0,15662,5500,0,21162,8550,16025,363,0
50231180,FA2024 ,14750,600,4200,2680,22230,6500,6500,0,NULL,6500,0,6500,8850,15730,15730,0
50231180,SP2024 ,14750,600,4200,2450,22000,6500,6500,0,NULL,6500,0,6500,8850,15500,15500,0
50230489,FA2024 ,14750,600,4790,2450,22590,10000,9000,1000,11750,11000,0,22750,4350,11590,-160,0
50230489,SP2024 ,14750,600,4780,2450,22580,10000,9000,1000,11750,10000,0,21750,5350,12580,830,0
50221391,FA2021 ,12625,500,3740,2110,18975,8000,8000,0,2750,9000,0,11750,4125,9975,7225,0
50221391,FA2022 ,13005,515,3855,1140,18515,7000,7000,0,3250,7000,0,10250,6520,11515,8265,0
50221391,SP2021 ,12625,500,3740,2110,18975,8000,8000,0,2750,8000,0,10750,5125,10975,8225,0
50221391,SP2022 ,13005,6590,6590,NULL,19595,6500,6500,0,3250,6500,0,9750,13095,13095,9845,0
50225092,FA2022 ,13005,515,4810,2220,20550,8500,8500,0,2500,8500,0,11000,5020,12050,9550,0
50225092,FA2023 ,13500,550,4560,2325,20935,8500,8500,0,3250,13060,0,16310,990,7875,4625,0
50225092,FA2024 ,14750,600,5720,NULL,21070,10500,6500,4000,3750,12600,0,16350,2750,8470,4720,0
50225092,SP2022 ,13005,515,4810,2220,20550,8500,8500,0,2500,8500,0,11000,5020,12050,9550,0
50225092,SP2023 ,13500,550,4560,2325,20935,8500,8500,0,3250,13060,0,16310,990,7875,4625,0
50225092,SP2024 ,14750,600,5720,NULL,21070,10500,6500,4000,3750,12600,0,16350,2750,8470,4720,0
50229088,FA2023 ,13500,550,5150,2325,21525,10000,8500,1500,0,10000,0,10000,4050,11525,11525,0
50229088,FA2024 ,14750,600,4200,2450,22000,10000,7500,2500,3250,10000,0,13250,5350,12000,8750,0
50229088,SP2023 ,13500,550,5150,2325,21525,10000,8500,1500,0,10000,0,10000,4050,11525,11525,0
50229088,SP2024 ,22710,6355,6355,NULL,29065,10000,7500,2500,3250,10000,0,13250,19065,19065,15815,0
50215508,FA2021 ,12625,500,4580,2110,19815,10525,10525,0,3250,12025,0,15275,1100,7790,4540,0
50215508,FA2022 ,13005,515,4810,2220,20550,10525,10525,0,3750,10525,0,14275,2995,10025,6275,0
50215508,FA2023 ,13500,550,5150,1200,20400,10525,0,10525,3750,12848,0,16598,1202,7552,3802,0
50215508,SP2021 ,12625,500,4580,2110,19815,10525,10525,0,3250,10525,0,13775,2600,9290,6040,0
50215508,SP2022 ,13005,515,4810,1140,19470,10525,10525,0,3750,10525,0,14275,2995,8945,5195,0
50212061,FA2021 ,12625,500,4580,2110,19815,9775,9775,0,3250,11275,0,14525,1850,8540,5290,0
50212061,SP2021 ,12625,500,4580,2110,19815,9775,9775,0,3250,9775,0,13025,3350,10040,6790,0
50223225,FA2021 ,12625,500,3740,2110,18975,4500,4500,0,NULL,4500,0,4500,8625,14475,14475,0
50223225,SP2021 ,12625,500,3740,2110,18975,4500,4500,0,NULL,4500,0,4500,8625,14475,14475,0
50224498,FA2021 ,12625,500,4580,2110,19815,4500,4500,0,15193,4500,0,19693,8625,15315,122,0.5
50224498,FA2022 ,13005,515,4810,2220,20550,4000,4000,0,12750,4000,0,16750,9520,16550,3800,0.5
50224498,FA2023 ,13500,550,5150,2325,21525,4000,4000,0,18751,4000,0,22751,10050,17525,-1226,0.5
50224498,FA2024 ,14750,600,5410,2450,23210,4000,4000,0,15507,4000,0,19507,11350,19210,3703,0.5
50224498,SP2021 ,12625,500,4580,2110,19815,4500,4500,0,17382,4500,0,21882,8625,15315,-2067,0.5
50224498,SP2022 ,13005,515,4810,2220,20550,4000,4000,0,13658,4000,0,17658,9520,16550,2892,0.5
50224498,SP2023 ,13500,550,5150,2325,21525,4000,4000,0,16910,4000,0,20910,10050,17525,615,0.5
50231834,SP2023 ,13500,550,5150,2325,21525,7450,7450,0,13293,11148,0,24441,2902,10377,-2916,0
50222204,FA2021 ,12625,500,4580,2110,19815,5500,5000,500,2750,10248,0,12998,2877,9567,6817,2706
50222204,FA2022 ,13005,515,4810,2220,20550,4500,4500,0,3250,8348,0,11598,5172,12202,8952,2706
50222204,FA2023 ,13500,550,5150,2325,21525,4500,4500,0,3750,8598,0,12348,5452,12927,9177,2706
50222204,FA2024 ,14750,600,5410,2450,23210,4500,4500,0,6250,8598,0,14848,6752,14612,8362,2706
50222204,SP2021 ,12625,500,4580,2110,19815,5500,5000,500,2750,9807,0,12557,3318,10008,7258,2706
50222204,SP2022 ,13005,515,4810,2220,20550,4500,4500,0,3250,8347,0,11597,5173,12203,8953,2706
50222204,SP2023 ,13500,550,5150,2325,21525,4500,4500,0,3750,8597,0,12347,5453,12928,9178,2706
50222204,SP2024 ,14750,600,5410,2450,23210,4500,4500,0,6250,8597,0,14847,6753,14613,8363,2706
50211012,FA2021 ,12625,500,4580,2110,19815,3925,250,3675,3250,5425,0,8675,7700,14390,11140,0
50211012,FA2022 ,13005,515,4260,1140,18920,3925,250,3675,3750,3925,0,7675,9595,14995,11245,0
50211012,SP2021 ,12625,500,4580,2110,19815,3925,250,3675,3250,3925,0,7175,9200,15890,12640,0
50211012,SP2022 ,13005,515,4260,1140,18920,3925,250,3675,3750,3925,0,7675,9595,14995,11245,0
50225826,FA2022 ,13005,515,4260,2220,20000,8350,8350,0,15883,8350,0,24233,5170,11650,-4233,0
50225826,SP2022 ,13005,515,4260,2220,20000,8350,8350,0,15221,8350,0,23571,5170,11650,-3571,0
50222137,FA2021 ,12625,500,4580,2110,19815,6950,6950,0,0,10673,0,10673,2452,9142,9142,3140.66
50222137,FA2022 ,13005,515,3855,2220,19595,8450,8450,0,5250,8450,0,13700,5070,11145,5895,3140.66
50222137,FA2023 ,13500,550,4790,1200,20040,7700,7700,0,7750,12950,0,20700,1100,7090,-660,3140.66
50222137,FA2024 ,14750,600,5030,1270,21650,7850,7850,0,6250,12238,0,18488,3112,9412,3162,3140.66
50222137,SP2021 ,12625,500,4580,2110,19815,6950,6950,0,0,9172,0,9172,3953,10643,10643,3140.66
50222137,SP2022 ,13005,515,3855,2220,19595,8450,8450,0,5250,8450,0,13700,5070,11145,5895,3140.66
50222137,SP2023 ,13500,550,4790,1200,20040,7700,7700,0,14765,7700,0,22465,6350,12340,-2425,3140.66
50222137,SP2024 ,14750,600,6090,1270,22710,7850,7850,0,6250,12237,0,18487,3113,10473,4223,3140.66
50231871,FA2024 ,14750,600,4200,2450,22000,13500,9300,4200,0,17198,0,17198,-1848,4802,4802,4628
50231969,SP2023 ,14500,7000,7000,NULL,21500,0,0,0,NULL,0,0,0,21500,21500,21500,0
50215205,FA2021 ,12625,500,3740,2110,18975,6725,5725,1000,2750,14723,0,17473,-1598,4252,1502,0
50215205,FA2022 ,13005,515,4260,2220,20000,6725,4775,1950,3750,13148,0,16898,372,6852,3102,0
50215205,FA2023 ,13500,550,4560,1200,19810,7975,0,7975,3750,9975,0,13725,4075,9835,6085,0
50215205,SP2021 ,12625,500,3740,2110,18975,6725,5725,1000,2750,13782,0,16532,-657,5193,2443,0
50215205,SP2022 ,13005,515,4260,2220,20000,6725,4775,1950,3750,13147,0,16897,373,6853,3103,0
50215205,SP2023 ,13500,550,4560,1200,19810,7975,0,7975,3750,9975,0,13725,4075,9835,6085,0
50224938,SP2021 ,13867,6974,6974,NULL,20841,0,0,0,NULL,0,0,0,20841,20841,20841,0
50232080,FA2024 ,14750,600,5410,2450,23210,7900,7900,0,0,7900,0,7900,7450,15310,15310,0
50232080,SP2024 ,14750,600,5410,2450,23210,7900,7900,0,2750,7900,0,10650,7450,15310,12560,0
50223977,FA2022 ,13005,515,4810,2220,20550,8100,8100,0,2750,8100,0,10850,5420,12450,9700,-205
50223977,FA2023 ,13500,550,5150,2325,21525,7600,5750,1850,3250,7600,0,10850,6450,13925,10675,-205
50223977,FA2024 ,14750,600,5410,2450,23210,7600,5750,1850,3750,7600,0,11350,7750,15610,11860,-205
50223977,SP2022 ,13005,515,4810,2220,20550,8100,8100,0,2750,8100,0,10850,5420,12450,9700,-205
50223977,SP2023 ,13500,550,5150,2325,21525,7600,5750,1850,3250,7600,0,10850,6450,13925,10675,-205
50223977,SP2024 ,14750,600,5410,2450,23210,7600,5750,1850,3750,7600,0,11350,7750,15610,11860,-205
50229276,FA2023 ,13500,550,5150,2325,21525,7000,7000,0,2750,7000,0,9750,7050,14525,11775,0
50229276,FA2024 ,14750,600,5410,2450,23210,7000,7000,0,3250,7000,0,10250,8350,16210,12960,0
50229276,SP2023 ,13500,550,5150,2325,21525,7000,7000,0,2750,7000,0,9750,7050,14525,11775,0
50229276,SP2024 ,14750,600,5410,2450,23210,7000,7000,0,3250,7000,0,10250,8350,16210,12960,0
50198861,FA2022 ,13005,515,NULL,NULL,13520,2925,2925,0,NULL,2925,0,2925,10595,10595,10595,-1252.79
50198861,FA2023 ,3720,NULL,NULL,NULL,3720,0,0,0,NULL,0,0,0,3720,3720,3720,-1252.79
50198861,SP2021 ,6960,500,4830,NULL,12290,2439,2439,0,NULL,2439,0,2439,5021,9851,9851,-1252.79
50198861,SP2022 ,13005,515,NULL,NULL,13520,2925,2925,0,NULL,2925,0,2925,10595,10595,10595,-1252.79
50216506,FA2021 ,12625,500,3740,2110,18975,7425,0,7425,2750,8425,0,11175,4700,10550,7800,0
50216506,FA2022 ,13005,515,4610,NULL,18130,7425,7425,0,10915,7425,0,18340,6095,10705,-210,0
50216506,FA2023 ,13500,550,5800,NULL,19850,7425,7425,0,15350,7425,0,22775,6625,12425,-2925,0
50216506,SP2021 ,12625,500,4580,2110,19815,7425,0,7425,12798,7425,0,20223,5700,12390,-408,0
50216506,SP2022 ,13005,515,4610,NULL,18130,7425,7425,0,8750,7425,0,16175,6095,10705,1955,0
50212052,FA2021 ,12625,500,4580,2110,19815,1425,1425,0,18912,2425,0,21337,10700,17390,-1522,0
50212052,FA2022 ,13005,515,5080,NULL,18600,1425,1425,0,18629,1425,0,20054,12095,17175,-1454,0
50212052,SP2021 ,12625,500,4580,2110,19815,1425,1425,0,18912,1425,0,20337,11700,18390,-522,0
50212052,SP2022 ,13005,515,5080,NULL,18600,1425,1425,0,18629,1425,0,20054,12095,17175,-1454,0
50226201,FA2023 ,13500,550,5150,2325,21525,6500,6500,0,16808,6500,0,23308,7550,15025,-1783,0
50226201,FA2024 ,14750,600,5720,1270,22340,6500,6500,0,16280,6500,0,22780,8850,15840,-440,0
50226201,SP2023 ,13500,550,5150,2325,21525,6500,6500,0,16808,6500,0,23308,7550,15025,-1783,0
50226201,SP2024 ,14750,600,5720,1270,22340,6500,6500,0,16280,6500,0,22780,8850,15840,-440,0
50228838,FA2023 ,13500,550,4560,2325,20935,6500,6500,0,NULL,6500,0,6500,7550,14435,14435,7999.99
50228838,FA2024 ,14750,600,4790,2450,22590,6500,6500,0,NULL,6500,0,6500,8850,16090,16090,7999.99
50228838,SP2023 ,13500,550,4560,2325,20935,6500,6500,0,NULL,6500,0,6500,7550,14435,14435,7999.99
50228838,SP2024 ,14750,600,4200,2450,22000,6500,6500,0,NULL,6500,0,6500,8850,15500,15500,7999.99
50233539,FA2024 ,14750,600,4200,2450,22000,7000,7000,0,2750,7500,0,10250,7850,14500,11750,5049.32
50233539,SP2024 ,14750,600,4200,2450,22000,7000,7000,0,2750,7000,0,9750,8350,15000,12250,5049.32
50208960,FA2021 ,12625,500,3740,2110,18975,4875,3975,900,3750,6375,0,10125,6750,12600,8850,0
50208960,FA2022 ,13005,515,5080,NULL,18600,6875,3025,3850,3750,6875,0,10625,6645,11725,7975,0
50208960,SP2021 ,12625,500,4270,NULL,17395,4875,3975,900,3750,4875,0,8625,8250,12520,8770,0
50208960,SP2022 ,13005,515,4810,1140,19470,4875,3025,1850,3750,4875,0,8625,8645,14595,10845,0
50216705,FA2021 ,12625,500,4050,2110,19285,2925,2925,0,3250,4425,0,7675,8700,14860,11610,0
50216705,FA2022 ,13005,515,5080,1140,19740,2925,2925,0,3750,2925,0,6675,10595,16815,13065,0
50216705,FA2023 ,13500,550,4790,1200,20040,2925,0,2925,3750,2925,0,6675,11125,17115,13365,0
50216705,FA2024 ,14750,600,5030,1270,21650,2925,0,2925,2000,2925,0,4925,12425,18725,16725,0
50216705,SP2021 ,12625,500,4050,2110,19285,2925,2925,0,3250,2925,0,6175,10200,16360,13110,0
50216705,SP2022 ,13005,515,5080,1140,19740,2925,2925,0,3750,2925,0,6675,10595,16815,13065,0
50216705,SP2023 ,13500,550,4790,1200,20040,2925,0,2925,3750,2925,0,6675,11125,17115,13365,0
50232122,FA2024 ,14750,600,4200,2450,22000,11750,11750,0,2750,11750,0,14500,3600,10250,7500,440
50232122,SP2024 ,14750,600,4200,2450,22000,11750,11750,0,2750,11750,0,14500,3600,10250,7500,440
50215387,FA2021 ,12625,500,4240,2110,19475,8850,6000,2850,2750,15885,0,18635,-2760,3590,840,0
50215387,FA2022 ,13005,515,4380,2220,20120,7850,5000,2850,3250,7850,0,11100,5670,12270,9020,0
50215387,FA2023 ,13500,550,4550,2745,21345,8350,5000,3350,3750,8350,0,12100,5700,12995,9245,0
50215387,SP2021 ,12625,500,4240,2110,19475,8850,6000,2850,2750,9672,0,12422,3453,9803,7053,0
50215387,SP2022 ,13005,6590,6590,NULL,19595,6200,6200,0,3250,6200,0,9450,13395,13395,10145,0
50215387,SP2023 ,13500,550,4550,2745,21345,8350,5000,3350,3750,8350,0,12100,5700,12995,9245,0
50215238,FA2021 ,12625,500,3740,1080,17945,7140,4575,2565,9195,12380,0,21575,745,5565,-3630,0
50215238,FA2022 ,13005,515,4800,2220,20540,6425,4575,1850,3750,6425,0,10175,7095,14115,10365,0
50215238,FA2023 ,13500,550,NULL,NULL,14050,4433,0,4433,2750,8131,0,10881,5919,5919,3169,0
50215238,SP2021 ,12625,500,3740,1080,17945,6425,4575,1850,12160,10165,0,22325,2960,7780,-4380,0
50215238,SP2023 ,13500,550,NULL,NULL,14050,4434,0,4434,0,8131,0,8131,5919,5919,5919,0
50225855,FA2022 ,13005,515,4260,2220,20000,8500,6500,2000,2750,8500,0,11250,5020,11500,8750,1808
50225855,FA2023 ,13500,550,4560,2325,20935,6500,6500,0,3250,11060,0,14310,2990,9875,6625,1808
50225855,FA2024 ,14750,600,5410,2450,23210,6500,6500,0,0,11910,0,11910,3440,11300,11300,1808
50225855,SP2022 ,13005,515,4260,2220,20000,6750,6750,0,2750,6750,0,9500,6770,13250,10500,1808
50225855,SP2023 ,13500,550,4560,2325,20935,8500,6500,2000,3250,13060,0,16310,990,7875,4625,1808
50225855,SP2024 ,14750,600,5410,2450,23210,8500,6500,2000,3750,13910,0,17660,1440,9300,5550,1808
50218768,FA2021 ,12625,500,4050,2110,19285,2925,2925,0,2750,3925,0,6675,9200,15360,12610,0
50205547,FA2021 ,12625,500,4830,1080,19035,7666,7666,0,NULL,15016,0,15016,-1891,4019,4019,2601.09
50205547,SP2021 ,12625,500,4050,2110,19285,10668,7668,3000,NULL,18888,0,18888,-5763,397,397,2601.09
50210306,FA2021 ,12625,500,NULL,NULL,13125,2475,2475,0,3000,10473,0,13473,2652,2652,-348,0
50210306,FA2022 ,13005,515,NULL,NULL,13520,975,975,0,3750,5248,0,8998,8272,8272,4522,0
50210306,SP2021 ,12625,500,NULL,NULL,13125,2475,2475,0,3000,9532,0,12532,3593,3593,593,0
50210306,SP2022 ,13005,515,NULL,NULL,13520,975,975,0,3750,5247,0,8997,8273,8273,4523,0
50212622,FA2021 ,12625,6350,6350,NULL,18975,3838,3338,500,19412,7560,0,26972,11415,11415,-7997,0
50212622,FA2022 ,13005,515,5080,1140,19740,6675,6675,0,18368,6675,0,25043,6845,13065,-5303,0
50212622,SP2021 ,12625,500,4050,2110,19285,6675,6175,500,12386,8798,0,21184,4327,10487,-1899,0
50212622,SP2022 ,13005,515,5080,1140,19740,6675,6675,0,18368,6675,0,25043,6845,13065,-5303,0
50235032,FA2024 ,14750,600,4780,2450,22580,10923,10923,0,3750,12811,0,16561,2539,9769,6019,2168
50235032,SP2024 ,14750,600,4780,2450,22580,10923,10923,0,3750,12810,0,16560,2540,9770,6020,2168
50187334,FA2021 ,12625,500,NULL,NULL,13125,9847,0,9847,NULL,15347,0,15347,-2222,-2222,-2222,0
50187334,SP2021 ,12625,500,NULL,NULL,13125,12647,0,12647,NULL,21147,0,21147,-8022,-8022,-8022,0
50216094,FA2021 ,12625,500,4270,1080,18475,8675,8675,0,0,13548,0,13548,-423,4927,4927,0
50216094,FA2022 ,13005,515,3855,NULL,17375,8675,8675,0,3750,11848,0,15598,1672,5527,1777,0
50216094,FA2023 ,13500,550,4790,NULL,18840,11675,10675,1000,0,14398,0,14398,-348,4442,4442,0
50216094,SP2021 ,12625,500,4270,NULL,17395,8675,8675,0,0,11547,0,11547,1578,5848,5848,0
50216094,SP2022 ,13005,515,3855,NULL,17375,8675,8675,0,3750,11847,0,15597,1673,5528,1778,0
50219822,FA2021 ,12625,500,4580,2110,19815,3375,0,3375,18502,4875,0,23377,8250,14940,-3562,-1101.25
50219822,FA2022 ,13005,515,4810,2220,20550,3375,0,3375,15669,3375,0,19044,10145,17175,1506,-1101.25
50219822,FA2023 ,13500,550,4790,1200,20040,3375,0,3375,19767,3375,0,23142,10675,16665,-3102,-1101.25
50219822,FA2024 ,14750,600,4790,2450,22590,3375,0,3375,14776,7473,0,22249,7877,15117,341,-1101.25
50219822,SP2022 ,13005,515,4810,2220,20550,3375,0,3375,18368,3375,0,21743,10145,17175,-1193,-1101.25
50219822,SP2023 ,13500,550,4790,1200,20040,3375,0,3375,16280,3375,0,19655,10675,16665,385,-1101.25
50219822,SP2024 ,14750,600,4790,2450,22590,3375,0,3375,17432,7472,0,24904,7878,15118,-2314,-1101.25
50205543,FA2021 ,19340,860,5690,0,25030,11750,10250,1500,3750,12750,0,16500,7450,12280,8530,0
50205543,SP2021 ,19340,860,5690,NULL,25030,11750,10250,1500,3750,11750,0,15500,8450,13280,9530,0
50119360,FA2021 ,12625,500,3740,2110,18975,6500,6500,0,9640,12223,0,21863,902,6752,-2888,16.51
50119360,FA2022 ,13005,515,3855,2220,19595,6000,6000,0,7855,12398,0,20253,1122,7197,-658,16.51
50119360,FA2023 ,13500,550,4000,2325,20375,6000,6000,0,10977,9623,0,20600,4427,10752,-225,16.51
50119360,FA2024 ,8140,600,5030,1270,15040,3946,3311,635,9447,6681,0,16128,2059,8359,-1088,16.51
50119360,SP2021 ,12625,500,3740,2110,18975,6500,6500,0,8515,10722,0,19237,2403,8253,-262,16.51
50119360,SP2022 ,13005,515,3855,2220,19595,6000,6000,0,7855,12397,0,20252,1123,7198,-657,16.51
50119360,SP2023 ,13500,550,4000,2325,20375,6000,6000,0,10977,9622,0,20599,4428,10753,-224,16.51
50119360,SP2024 ,8140,600,5030,16.51,13786.51,3946,3311,635,9447,6198,0,15645,2542,7588.51,-1858.49,16.51
50210304,FA2021 ,12625,500,3740,2110,18975,925,925,0,3750,1925,0,5675,11200,17050,13300,0
50210304,FA2022 ,13005,515,3855,NULL,17375,925,925,0,3750,925,0,4675,12595,16450,12700,0
50210304,SP2021 ,12625,500,3740,2110,18975,925,925,0,3750,925,0,4675,12200,18050,14300,0
50210304,SP2022 ,13005,515,3855,NULL,17375,925,925,0,3750,925,0,4675,12595,16450,12700,0
50231169,FA2023 ,13500,550,4000,1200,19250,5500,5500,0,0,5500,0,5500,8550,13750,13750,3816
50231169,FA2024 ,14750,600,5410,2450,23210,5500,5500,0,3750,5500,0,9250,9850,17710,13960,3816
50231169,SP2023 ,13500,550,4000,2325,20375,5500,5500,0,0,5500,0,5500,8550,14875,14875,3816
50231169,SP2024 ,14750,600,5410,2450,23210,5500,5500,0,3750,5500,0,9250,9850,17710,13960,3816
50229675,FA2023 ,13500,550,4000,2325,20375,9700,6500,3200,0,11173,0,11173,2877,9202,9202,-1531
50229675,FA2024 ,14750,600,4200,2450,22000,9700,0,9700,2750,16195,0,18945,-845,5805,3055,-1531
50229675,SP2023 ,13500,550,4000,2325,20375,11700,6500,5200,0,13172,0,13172,878,7203,7203,-1531
50229675,SP2024 ,14750,600,4200,2450,22000,9700,0,9700,2750,16195,0,18945,-845,5805,3055,-1531
50209908,FA2021 ,12625,500,3740,1080,17945,9175,9175,0,3750,10675,0,14425,2450,7270,3520,0
50209908,FA2022 ,13005,515,4610,1140,19270,9175,9175,0,3750,12175,0,15925,1345,7095,3345,0
50209908,SP2021 ,12625,500,3740,1080,17945,9175,9175,0,3750,9175,0,12925,3950,8770,5020,0
50209908,SP2022 ,13005,515,4610,1140,19270,9175,9175,0,3750,12175,0,15925,1345,7095,3345,0
50210637,FA2021 ,12625,6350,6350,NULL,18975,3425,3425,0,3750,4425,0,8175,14550,14550,10800,0
50210637,FA2022 ,13005,515,3855,2220,19595,3425,3425,0,3750,3425,0,7175,10095,16170,12420,0
50210637,SP2021 ,12625,500,4270,1080,18475,3425,3425,0,3750,3425,0,7175,9700,15050,11300,0
50210637,SP2022 ,13005,515,3855,2220,19595,3425,3425,0,3750,3425,0,7175,10095,16170,12420,0
50197602,FA2021 ,6960,500,5160,2110,14730,1888,0,1888,12500,2888,0,15388,4572,11842,-658,0
50197602,SP2021 ,3470,NULL,5160,2110,10740,0,0,0,12500,0,0,12500,3470,10740,-1760,0
50210265,FA2021 ,12625,500,4270,2550,19945,2425,2425,0,17000,3925,0,20925,9200,16020,-980,0
50210265,FA2022 ,13005,515,4610,2690,20820,2425,2425,0,19500,2425,0,21925,11095,18395,-1105,0
50210265,SP2021 ,12625,500,4270,2550,19945,2425,2425,0,17000,2425,0,19425,10700,17520,520,0
50210265,SP2022 ,7170,515,4610,2690,14985,1337,1337,0,19500,1337,0,20837,6348,13648,-5852,0
50228214,SP2024 ,14750,600,5410,2450,23210,6000,6000,0,21750,6000,0,27750,9350,17210,-4540,0
50218417,FA2021 ,12625,500,NULL,NULL,13125,5925,4525,1400,2750,7425,0,10175,5700,5700,2950,0
50218417,FA2022 ,13005,515,NULL,NULL,13520,7925,5325,2600,3750,7925,0,11675,5595,5595,1845,0
50218417,FA2023 ,13500,550,NULL,NULL,14050,7123,0,7123,3750,7123,0,10873,6927,6927,3177,0
50218417,SP2021 ,12625,500,NULL,NULL,13125,5925,4525,1400,2750,5925,0,8675,7200,7200,4450,0
50218417,SP2022 ,13005,515,NULL,NULL,13520,5925,5325,600,3750,5925,0,9675,7595,7595,3845,0
50218417,SP2023 ,13500,550,NULL,NULL,14050,5123,0,5123,3750,5123,0,8873,8927,8927,5177,0
50227928,FA2023 ,13500,550,4560,2325,20935,6000,6000,0,15750,6000,0,21750,8050,14935,-815,0
50227928,SP2023 ,13500,550,4560,2325,20935,6000,6000,0,15750,6000,0,21750,8050,14935,-815,0
50223121,FA2021 ,12625,500,4050,2550,19725,5500,5500,0,0,5500,0,5500,7625,14225,14225,0
50223121,FA2022 ,13005,515,4810,2220,20550,5000,5000,0,0,5000,0,5000,8520,15550,15550,0
50223121,SP2021 ,12625,500,4050,2110,19285,5500,5500,0,0,5500,0,5500,7625,13785,13785,0
50228699,FA2023 ,13500,550,4000,2325,20375,7500,7500,0,0,7500,0,7500,6550,12875,12875,-900
50228699,FA2024 ,14750,600,4790,2450,22590,7500,7500,0,NULL,7500,0,7500,7850,15090,15090,-900
50228699,SP2024 ,14750,600,4790,1270,21410,7500,7500,0,NULL,7500,0,7500,7850,13910,13910,-900
50204820,FA2021 ,12625,500,4270,1080,18475,2825,0,2825,14257,8948,0,23205,4177,9527,-4730,0
50204820,SP2021 ,12625,500,4270,NULL,17395,2825,0,2825,14257,6947,0,21204,6178,10448,-3809,0
50222216,FA2021 ,12625,500,3740,2110,18975,250,250,0,0,13875,12625,13875,-750,5100,5100,7225
50222216,FA2022 ,13005,515,3855,2220,19595,0,0,0,3250,13005,13005,16255,515,6590,3340,7225
50222216,FA2023 ,13500,550,4000,2325,20375,0,0,0,3750,13500,13500,17250,550,6875,3125,7225
50222216,FA2024 ,18520,600,5030,0,24150,0,0,0,NULL,18520,18520,18520,600,5630,5630,7225
50222216,SP2021 ,12625,500,3740,2110,18975,0,0,0,2750,12625,12625,15375,500,6350,3600,7225
50222216,SP2022 ,13005,515,3855,2220,19595,0,0,0,3250,13005,13005,16255,515,6590,3340,7225
50222216,SP2023 ,13500,550,4000,2325,20375,0,0,0,3750,13500,13500,17250,550,6875,3125,7225
50222216,SP2024 ,14750,600,5030,NULL,20380,0,0,0,NULL,14750,14750,14750,600,5630,5630,7225
50221337,FA2021 ,12625,500,4050,2110,19285,6500,6500,0,7750,6500,0,14250,6625,12785,5035,2350.32
50221337,FA2022 ,13005,515,4260,2220,20000,6000,6000,0,8250,6000,0,14250,7520,14000,5750,2350.32
50221337,FA2023 ,13500,550,4790,1200,20040,6000,6000,0,9750,6000,0,15750,8050,14040,4290,2350.32
50221337,FA2024 ,14750,600,5030,1270,21650,6000,6000,0,9750,6000,0,15750,9350,15650,5900,2350.32
50221337,SP2021 ,12625,500,4050,2110,19285,6500,6500,0,7750,6500,0,14250,6625,12785,5035,2350.32
50221337,SP2022 ,13005,515,4260,2220,20000,6000,6000,0,8250,6000,0,14250,7520,14000,5750,2350.32
50221337,SP2023 ,13500,6825,6825,NULL,20325,6000,6000,0,9750,6000,0,15750,14325,14325,4575,2350.32
50221337,SP2024 ,14750,600,5030,1270,21650,6000,6000,0,9750,6000,0,15750,9350,15650,5900,2350.32
50231610,FA2024 ,14750,600,5410,2450,23210,8000,8000,0,2750,8625,0,11375,6725,14585,11835,0
50231610,SP2024 ,14750,600,5410,2450,23210,8000,8000,0,2750,8625,0,11375,6725,14585,11835,0
50232485,FA2024 ,14750,600,4200,2450,22000,10000,8000,2000,2750,10000,0,12750,5350,12000,9250,5582
50232485,SP2024 ,14750,600,4200,2450,22000,8000,8000,0,2750,8000,0,10750,7350,14000,11250,5582
50184290,FA2022 ,3580,NULL,NULL,NULL,3580,0,0,0,0,0,0,0,3580,3580,3580,0
50184290,SP2022 ,7170,257,NULL,NULL,7427,1902,1902,0,5250,3264,0,8514,4163,4163,-1087,0
50231971,SP2023 ,14500,7000,7000,NULL,21500,0,0,0,NULL,0,0,0,21500,21500,21500,0
50197206,FA2024 ,14750,600,NULL,NULL,15350,6650,5000,1650,8250,6650,0,14900,8700,8700,450,4289.17
50197206,SP2023 ,13500,550,NULL,NULL,14050,4550,4550,0,6250,9423,0,15673,4627,4627,-1623,4289.17
50197206,SP2024 ,14750,600,NULL,NULL,15350,6650,5000,1650,8250,6650,0,14900,8700,8700,450,4289.17
50204210,FA2021 ,12625,500,4830,1080,19035,3425,3425,0,3750,4425,0,8175,8700,14610,10860,0
50204210,SP2021 ,12625,500,4830,NULL,17955,3425,3425,0,3750,3425,0,7175,9700,14530,10780,0
50215717,FA2021 ,12625,500,4050,2110,19285,7425,7425,0,1500,8425,0,9925,4700,10860,9360,0
50215717,SP2021 ,12625,500,4050,2110,19285,7425,7425,0,1500,7425,0,8925,5700,11860,10360,0
50231619,FA2024 ,14750,600,5410,2450,23210,9000,9000,0,2750,9000,0,11750,6350,14210,11460,-250
50231619,SP2024 ,14750,600,5410,2450,23210,9000,9000,0,2750,16850,0,19600,-1500,6360,3610,-250
50231425,FA2024 ,14750,600,4790,2900,23040,10700,6500,4200,2750,14323,0,17073,1027,8717,5967,0
50231425,SP2024 ,14750,600,4790,2450,22590,8700,6500,2200,2750,12322,0,15072,3028,10268,7518,0
50222293,FA2021 ,12625,500,4580,2110,19815,5000,5000,0,16063,5000,0,21063,8125,14815,-1248,-608
50222293,FA2022 ,13005,515,4810,2220,20550,4500,4500,0,17346,4500,0,21846,9020,16050,-1296,-608
50222293,FA2023 ,13500,550,5150,2325,21525,4500,4500,0,19122,4500,0,23622,9550,17025,-2097,-608
50222293,FA2024 ,14750,600,4790,2450,22590,4500,4500,0,19545,4500,0,24045,10850,18090,-1455,-608
50222293,SP2021 ,12625,500,4580,2110,19815,5000,5000,0,16063,5000,0,21063,8125,14815,-1248,-608
50222293,SP2022 ,13005,515,4810,2220,20550,4500,4500,0,17346,4500,0,21846,9020,16050,-1296,-608
50222293,SP2023 ,13500,550,5150,2325,21525,4500,4500,0,19122,4500,0,23622,9550,17025,-2097,-608
50222293,SP2024 ,14750,600,4790,2450,22590,4500,4500,0,19545,4500,0,24045,10850,18090,-1455,-608
50235932,SP2024 ,15000,7500,7500,NULL,22500,0,0,0,NULL,0,0,0,22500,22500,22500,0
50203219,FA2021 ,19340,860,4600,1080,25020,13500,13000,500,3750,14500,0,18250,5700,10520,6770,0
50203219,FA2022 ,19910,890,5700,2220,27830,13500,13000,500,2000,13500,0,15500,7300,14330,12330,0
50203219,SP2021 ,19340,860,4600,1080,25020,13500,13000,500,3750,13500,0,17250,6700,11520,7770,0
50223273,FA2021 ,12625,500,4050,2110,19285,7000,5500,1500,13226,11223,0,24449,1902,8062,-5164,0
50223273,FA2022 ,13005,515,5420,1140,20080,6500,5000,1500,12142,6900,0,19042,6620,13180,1038,0
50223273,FA2023 ,13500,550,5800,1200,21050,5000,5000,0,16204,8472,0,24676,5578,12578,-3626,0
50223273,SP2021 ,12625,500,4050,2110,19285,5500,5500,0,13826,8222,0,22048,4903,11063,-2763,0
50223273,SP2022 ,13005,515,5420,1140,20080,5000,5000,0,13658,5400,0,19058,8120,14680,1022,0
50223273,SP2023 ,13500,550,5800,1200,21050,5000,5000,0,13550,8473,0,22023,5577,12577,-973,0
50204575,FA2021 ,12625,500,4830,1080,19035,1175,0,1175,3750,2175,0,5925,10950,16860,13110,0
50222132,FA2021 ,12625,500,NULL,NULL,13125,0,0,0,0,12625,0,12625,500,500,500,0
50222132,FA2022 ,13005,515,NULL,NULL,13520,13005,13005,0,NULL,13005,0,13005,515,515,515,0
50222132,FA2023 ,13500,550,NULL,NULL,14050,13500,13500,0,NULL,13500,0,13500,550,550,550,0
50222132,FA2024 ,14750,600,5030,NULL,20380,14750,14750,0,NULL,14750,0,14750,600,5630,5630,0
50222132,SP2021 ,12625,500,NULL,NULL,13125,0,0,0,0,12625,0,12625,500,500,500,0
50222132,SP2022 ,13005,515,NULL,NULL,13520,13005,13005,0,NULL,13005,0,13005,515,515,515,0
50222132,SP2023 ,13500,550,NULL,NULL,14050,13500,13500,0,NULL,13500,0,13500,550,550,550,0
50222132,SP2024 ,14750,600,5030,NULL,20380,14750,14750,0,NULL,14750,0,14750,600,5630,5630,0
50230552,FA2023 ,13500,550,4000,2325,20375,14050,14050,0,NULL,14050,0,14050,0,6325,6325,0
50225258,FA2022 ,13005,515,4610,1140,19270,5500,5500,0,16093,5500,0,21593,8020,13770,-2323,0
50225258,FA2023 ,13500,550,5150,2325,21525,5500,5500,0,19892,5500,0,25392,8550,16025,-3867,0
50225258,FA2024 ,14750,600,4790,2450,22590,5500,5500,0,18320,5500,0,23820,9850,17090,-1230,0
50225258,SP2021 ,12625,500,NULL,NULL,13125,4140,4140,0,14600,4140,0,18740,8985,8985,-5615,0
50225258,SP2023 ,13500,550,5150,2325,21525,5500,5500,0,17750,5500,0,23250,8550,16025,-1725,0
50211263,FA2021 ,12625,500,4240,2110,19475,6500,6500,0,3750,6500,0,10250,6625,12975,9225,0
50211263,FA2022 ,13005,515,3855,2220,19595,6750,6000,750,3750,6750,0,10500,6770,12845,9095,0
50211263,FA2023 ,13500,550,5800,1200,21050,6000,6000,0,2750,6000,0,8750,8050,15050,12300,0
50211263,SP2021 ,12625,500,4240,2110,19475,6500,6500,0,3750,6500,0,10250,6625,12975,9225,0
50211263,SP2022 ,13005,515,3855,2220,19595,6750,6000,750,3750,6750,0,10500,6770,12845,9095,0
50216128,FA2021 ,12625,500,NULL,NULL,13125,7075,7075,0,2250,13223,0,15473,-98,-98,-2348,0
50216128,FA2022 ,13005,515,NULL,1140,14660,6325,6325,0,6250,9548,0,15798,3972,5112,-1138,0
50216128,FA2023 ,13500,550,NULL,1200,15250,7575,7575,0,6250,7575,0,13825,6475,7675,1425,0
50216128,SP2021 ,12625,500,NULL,1080,14205,7075,7075,0,2250,12282,0,14532,843,1923,-327,0
50216128,SP2022 ,13005,515,NULL,1140,14660,6325,6325,0,6250,9547,0,15797,3973,5113,-1137,0
50221955,FA2021 ,12625,500,3740,2110,18975,6500,6500,0,2750,18500,0,21250,-5375,475,-2275,-4499.8
50221955,FA2022 ,13005,515,3855,2220,19595,6500,6500,0,0,17750,0,17750,-4230,1845,1845,-4499.8
50221955,FA2023 ,13500,550,5440,1200,20690,6000,6000,0,3750,17250,0,21000,-3200,3440,-310,-4499.8
50221955,FA2024 ,14750,7250,7250,NULL,22000,3850,3850,0,2750,18130,0,20880,3870,3870,1120,-4499.8
50221955,SP2021 ,12625,500,3740,2110,18975,6500,6500,0,1000,17500,0,18500,-4375,1475,475,-4499.8
50221955,SP2022 ,13005,515,3855,2220,19595,6500,6500,0,0,18750,0,18750,-5230,845,845,-4499.8
50221955,SP2023 ,13500,550,5440,NULL,19490,6000,6000,0,3750,17250,0,21000,-3200,2240,-1510,-4499.8
50221955,SP2024 ,14750,600,5030,NULL,20380,6000,6000,0,2750,20280,0,23030,-4930,100,-2650,-4499.8
50225021,FA2022 ,13005,515,4810,2220,20550,5200,5200,0,0,8373,0,8373,5147,12177,12177,0
50225021,SP2022 ,13005,515,4810,2220,20550,5200,5200,0,12337,8372,0,20709,5148,12178,-159,0
50233726,FA2024 ,14750,600,4200,2450,22000,10450,10450,0,2750,12740,0,15490,2610,9260,6510,-50
50233726,SP2024 ,14750,600,4200,2450,22000,10450,10450,0,2750,13340,0,16090,2010,8660,5910,-50
50218721,FA2021 ,12625,500,4050,2110,19285,7925,6425,1500,3250,9425,0,12675,3700,9860,6610,0
50218721,SP2021 ,12625,500,4050,2110,19285,6925,6425,500,3250,6925,0,10175,6200,12360,9110,0
50232871,FA2024 ,14750,600,5410,2450,23210,8250,8250,0,0,8250,0,8250,7100,14960,14960,0
50232871,SP2024 ,14750,600,5410,2450,23210,8250,8250,0,2750,8250,0,11000,7100,14960,12210,0
50229484,FA2023 ,13500,550,5150,2325,21525,7500,7500,0,NULL,7500,0,7500,6550,14025,14025,4475
50229484,FA2024 ,14750,600,4200,1270,20820,7500,7500,0,NULL,7500,0,7500,7850,13320,13320,4475
50229484,SP2023 ,13500,550,5150,2325,21525,7500,7500,0,NULL,7500,0,7500,6550,14025,14025,4475
50229484,SP2024 ,14750,600,4200,1270,20820,7500,7500,0,NULL,7500,0,7500,7850,13320,13320,4475
50231693,FA2024 ,14750,600,4200,2900,22450,9000,9000,0,NULL,9000,0,9000,6350,13450,13450,0
50231693,SP2024 ,14750,600,4200,2450,22000,9000,9000,0,NULL,9000,0,9000,6350,13000,13000,0
50226605,FA2022 ,13005,515,4810,2220,20550,5500,5500,0,NULL,5500,0,5500,8020,15050,15050,230
50226605,FA2023 ,13500,550,5150,2325,21525,5500,5500,0,NULL,5500,0,5500,8550,16025,16025,230
50226605,FA2024 ,14750,600,5030,1270,21650,5500,5500,0,NULL,5500,0,5500,9850,16150,16150,230
50226605,SP2022 ,13005,515,4810,2220,20550,5500,5500,0,NULL,5500,0,5500,8020,15050,15050,230
50226605,SP2023 ,13500,550,5150,2325,21525,5500,5500,0,NULL,5500,0,5500,8550,16025,16025,230
50226605,SP2024 ,14750,600,NULL,NULL,15350,5500,5500,0,NULL,5500,0,5500,9850,9850,9850,230
50217714,FA2021 ,12625,500,4050,2110,19285,7175,7175,0,12465,8675,0,21140,4450,10610,-1855,0
50217714,FA2022 ,13005,515,4260,2220,20000,7175,7175,0,11964,9348,0,21312,4172,10652,-1312,0
50217714,FA2023 ,13500,550,5440,1200,20690,7675,7175,500,13147,9198,0,22345,4852,11492,-1655,0
50217714,SP2021 ,12625,500,4050,2110,19285,7175,7175,0,13061,7175,0,20236,5950,12110,-951,0
50217714,SP2022 ,13005,515,4260,2220,20000,7175,7175,0,12003,9347,0,21350,4173,10653,-1350,0
50217714,SP2023 ,7450,550,5440,1200,14640,4236,3960,276,12308,5018,0,17326,2982,9622,-2686,0
50224868,FA2022 ,13005,515,4810,2220,20550,7250,7250,0,2750,7250,0,10000,6270,13300,10550,0
50224868,FA2023 ,13500,550,4560,2325,20935,7250,7250,0,3250,7250,0,10500,6800,13685,10435,0
50224868,FA2024 ,14750,600,5720,67.41,21137.41,7250,6750,500,3750,7250,0,11000,8100,13887.41,10137.41,0
50224868,SP2022 ,13005,515,4810,2220,20550,7250,7250,0,2750,7250,0,10000,6270,13300,10550,0
50224868,SP2023 ,13500,550,4560,2325,20935,7250,7250,0,3250,7250,0,10500,6800,13685,10435,0
50224868,SP2024 ,14750,600,5720,NULL,21070,7250,6750,500,3750,7250,0,11000,8100,13820,10070,0
50204588,FA2021 ,12625,500,NULL,NULL,13125,1075,0,1075,13869,9073,0,22942,4052,4052,-9817,276.32
50204588,FA2022 ,13005,515,NULL,NULL,13520,1825,0,1825,12750,6923,0,19673,6597,6597,-6153,276.32
50204588,FA2023 ,3720,NULL,NULL,NULL,3720,444,0,444,4000,2491,0,6491,1229,1229,-2771,276.32
50204588,SP2021 ,12625,500,NULL,NULL,13125,1075,0,1075,5554,8132,0,13686,4993,4993,-561,276.32
50204588,SP2022 ,13005,515,NULL,NULL,13520,1825,0,1825,3750,6922,0,10672,6598,6598,2848,276.32
50204588,SP2023 ,5570,275,NULL,NULL,5845,444,0,444,2500,645,0,3145,5200,5200,2700,276.32
50207075,FA2022 ,13005,515,4810,2220,20550,8050,8050,0,14213,8050,0,22263,5470,12500,-1713,-2538
50207075,FA2023 ,13500,550,5150,2325,21525,7800,7800,0,15461,7800,0,23261,6250,13725,-1736,-2538
50207075,FA2024 ,14750,600,5410,2450,23210,0,0,0,10250,14750,14750,25000,600,8460,-1790,-2538
50207075,SP2021 ,12625,500,4580,2110,19815,8050,8050,0,14608,8050,0,22658,5075,11765,-2843,-2538
50207075,SP2022 ,13005,515,4810,2220,20550,7550,7550,0,14214,7550,0,21764,5970,13000,-1214,-2538
50207075,SP2023 ,13500,550,5150,2325,21525,7800,7800,0,15461,7800,0,23261,6250,13725,-1736,-2538
50207075,SP2024 ,14750,600,5410,2450,23210,0,0,0,10250,14750,14750,25000,600,8460,-1790,-2538
50207079,FA2021 ,12625,500,3740,2110,18975,5925,5925,0,14735,7425,0,22160,5700,11550,-3185,0
50207079,FA2022 ,13005,515,3855,2220,19595,5925,5925,0,12103,5925,0,18028,7595,13670,1567,0
50207079,FA2023 ,13500,550,5440,2325,21815,5925,5925,0,18123,5925,0,24048,8125,15890,-2233,0
50207079,SP2021 ,12625,500,3740,2110,18975,5925,5925,0,14736,5925,0,20661,7200,13050,-1686,0
50207079,SP2022 ,13005,515,3855,2220,19595,5925,5925,0,12103,5925,0,18028,7595,13670,1567,0
50207079,SP2023 ,13500,550,5800,2325,22175,5925,5925,0,18124,5925,0,24049,8125,16250,-1874,0
50221421,FA2021 ,12625,500,3740,2110,18975,6350,6350,0,14605,7350,0,21955,5775,11625,-2980,-4588.5
50221421,FA2022 ,13005,515,4810,2220,20550,6350,6350,0,14213,6350,0,20563,7170,14200,-13,-4588.5
50221421,FA2023 ,13500,550,5150,2325,21525,6350,6350,0,17187,6350,0,23537,7700,15175,-2012,-4588.5
50221421,FA2024 ,14750,600,5410,2450,23210,0,0,0,9750,14750,14750,24500,600,8460,-1290,-4588.5
50221421,SP2021 ,12625,500,4580,2110,19815,6350,6350,0,14606,6350,0,20956,6775,13465,-1141,-4588.5
50221421,SP2022 ,13005,515,4810,2220,20550,6350,6350,0,14214,6350,0,20564,7170,14200,-14,-4588.5
50221421,SP2023 ,13500,550,5150,2325,21525,6350,6350,0,17187,6350,0,23537,7700,15175,-2012,-4588.5
50221421,SP2024 ,14750,600,5410,2450,23210,0,0,0,9750,14750,14750,24500,600,8460,-1290,-4588.5
50222839,FA2021 ,12625,500,4050,2110,19285,6550,6550,0,14996,10173,0,25169,2952,9112,-5884,0
50222839,SP2021 ,12625,500,4050,2110,19285,6550,6550,0,11112,8672,0,19784,4453,10613,-499,0
50226569,FA2022 ,13005,515,3855,2220,19595,6000,6000,0,7250,6000,0,13250,7520,13595,6345,85
50226569,FA2023 ,13500,550,4560,1200,19810,6000,6000,0,7750,6000,0,13750,8050,13810,6060,85
50226569,FA2024 ,14750,600,5720,NULL,21070,6000,5000,1000,7750,6000,0,13750,9350,15070,7320,85
50226569,SP2022 ,13005,515,3855,2220,19595,6000,6000,0,7250,6000,0,13250,7520,13595,6345,85
50226569,SP2023 ,13500,550,4560,1200,19810,6000,6000,0,7750,6000,0,13750,8050,13810,6060,85
50226569,SP2024 ,14750,600,5720,NULL,21070,6000,5000,1000,7750,6000,0,13750,9350,15070,7320,85
50227704,FA2023 ,13500,550,4000,2325,20375,9500,0,9500,2750,13523,0,16273,527,6852,4102,-24
50227704,FA2024 ,14750,600,4200,2450,22000,9500,0,9500,12750,9500,0,22250,5850,12500,-250,-24
50227704,SP2023 ,13500,550,4000,2325,20375,9500,0,9500,2750,10522,0,13272,3528,9853,7103,-24
50227704,SP2024 ,14750,600,4200,2450,22000,9500,0,9500,12750,9500,0,22250,5850,12500,-250,-24
50232126,FA2024 ,14750,600,4200,2450,22000,9000,9000,0,2750,12698,0,15448,2652,9302,6552,0
50232126,SP2024 ,14750,600,4200,2450,22000,9000,9000,0,2750,12697,0,15447,2653,9303,6553,0
50225287,FA2022 ,13005,515,4810,2220,20550,6500,6500,0,2750,6500,0,9250,7020,14050,11300,0
50225287,FA2023 ,13500,550,5150,2325,21525,6500,5750,750,3250,6500,0,9750,7550,15025,11775,0
50225287,FA2024 ,14750,600,5720,67.3,21137.3,6500,6500,0,3750,6500,0,10250,8850,14637.3,10887.3,0
50225287,SP2022 ,13005,515,4810,2220,20550,6500,6500,0,2750,6500,0,9250,7020,14050,11300,0
50225287,SP2023 ,13500,550,5150,2325,21525,6500,5750,750,15250,6500,0,21750,7550,15025,-225,0
50225287,SP2024 ,14750,600,5720,NULL,21070,6500,6500,0,14959,6500,0,21459,8850,14570,-389,0
50211020,FA2021 ,12625,500,4270,NULL,17395,7300,7300,0,3750,8300,0,12050,4825,9095,5345,0
50211020,FA2022 ,13005,515,4610,NULL,18130,7300,7300,0,860,7300,0,8160,6220,10830,9970,0
50211020,SP2021 ,12625,6350,6350,NULL,18975,5825,5825,0,3750,5825,0,9575,13150,13150,9400,0
50211020,SP2022 ,13005,515,4610,NULL,18130,7300,7300,0,860,7300,0,8160,6220,10830,9970,0
50228195,FA2023 ,13500,550,5150,2325,21525,7000,7000,0,2750,8000,0,10750,6050,13525,10775,2914
50228195,FA2024 ,14750,600,5410,2450,23210,7000,7000,0,3250,8000,0,11250,7350,15210,11960,2914
50228195,SP2023 ,13500,550,5150,2325,21525,7000,7000,0,2750,7000,0,9750,7050,14525,11775,2914
50228195,SP2024 ,14750,600,5410,2450,23210,7000,7000,0,3250,7000,0,10250,8350,16210,12960,2914
50208729,FA2024 ,14750,600,NULL,NULL,15350,4900,3300,1600,6250,8598,0,14848,6752,6752,502,2492
50205043,FA2021 ,19340,860,4910,1080,25330,10500,9000,1500,NULL,10500,0,10500,9700,14830,14830,0
50205043,SP2021 ,7970,860,4910,1080,13960,4325,3707,618,NULL,4325,0,4325,4505,9635,9635,0
50217097,FA2022 ,13005,515,3855,1140,18515,6525,6525,0,12418,8648,0,21066,4872,9867,-2551,0
50217097,SP2022 ,7170,515,3855,1140,12680,3597,3597,0,10426,4658,0,15084,3027,8022,-2404,0
50221229,FA2021 ,12625,500,4580,2110,19815,6700,6700,0,1543,8900,0,10443,4225,10915,9372,0
50221359,FA2021 ,12625,500,3740,2110,18975,10000,8000,2000,4750,15848,0,20598,-2723,3127,-1623,-8736.67
50221359,FA2022 ,13005,515,3855,2220,19595,8350,6350,2000,1206,20098,0,21304,-6578,-503,-1709,-8736.67
50221359,FA2023 ,13500,550,4790,1200,20040,9500,7500,2000,1958,20598,0,22556,-6548,-558,-2516,-8736.67
50221359,FA2024 ,14750,600,5720,1270,22340,7500,7500,0,6250,18598,0,24848,-3248,3742,-2508,-8736.67
50221359,SP2021 ,12625,500,3740,2110,18975,8000,8000,0,4750,13407,0,18157,-282,5568,818,-8736.67
50221359,SP2022 ,13005,515,3855,2220,19595,10650,10650,0,0,21397,0,21397,-7877,-1802,-1802,-8736.67
50221359,SP2023 ,13500,550,4790,1200,20040,7500,7500,0,4295,18597,0,22892,-4547,1443,-2852,-8736.67
50221359,SP2024 ,14750,600,5720,1270,22340,7500,7500,0,2750,22097,0,24847,-6747,243,-2507,-8736.67
50226066,FA2022 ,13005,515,3855,2220,19595,5500,5500,0,15000,5500,0,20500,8020,14095,-905,-23
50226066,FA2023 ,13500,550,4560,2325,20935,5500,5500,0,0,5500,0,5500,8550,15435,15435,-23
50226066,FA2024 ,14750,600,5720,1270,22340,5500,5500,0,21000,5500,0,26500,9850,16840,-4160,-23
50226066,SP2022 ,13005,515,3855,2220,19595,5500,5500,0,15000,5500,0,20500,8020,14095,-905,-23
50226066,SP2023 ,13500,550,4560,2325,20935,5500,5500,0,15000,5500,0,20500,8550,15435,435,-23
50226066,SP2024 ,14750,600,5720,1270,22340,5500,5500,0,19000,5500,0,24500,9850,16840,-2160,-23
50227971,SP2022 ,13005,515,NULL,NULL,13520,3260,3260,0,NULL,3260,0,3260,10260,10260,10260,-50
50227971,SP2023 ,13500,550,NULL,NULL,14050,2760,2760,0,0,2760,0,2760,11290,11290,11290,-50
50209965,FA2021 ,12625,500,4270,NULL,17395,2425,2425,0,NULL,2425,0,2425,10700,14970,14970,0
50209965,FA2022 ,13005,515,4610,NULL,18130,2425,0,2425,NULL,2425,0,2425,11095,15705,15705,0
50209965,SP2021 ,12625,500,4270,NULL,17395,2425,2425,0,NULL,2425,0,2425,10700,14970,14970,0
50207617,FA2021 ,12625,500,5160,1080,19365,2425,2425,0,500,3425,0,3925,9700,15940,15440,0
50207617,SP2021 ,6960,500,5160,1080,13700,1337,1337,0,500,1337,0,1837,6123,12363,11863,0
50225124,FA2022 ,13005,515,3855,2220,19595,8500,8500,0,2750,9000,0,11750,4520,10595,7845,0
50225124,FA2023 ,13500,550,4000,2325,20375,9000,8500,500,11750,9000,0,20750,5050,11375,-375,0
50225124,FA2024 ,14750,7250,7250,NULL,22000,8145,8145,0,11250,8145,0,19395,13855,13855,2605,0
50225124,SP2022 ,13005,515,3855,2220,19595,8500,8500,0,5750,8500,0,14250,5020,11095,5345,0
50225124,SP2023 ,13500,550,4000,2325,20375,9000,8500,500,11750,9000,0,20750,5050,11375,-375,0
50225124,SP2024 ,14750,600,4200,2450,22000,8500,8500,0,11250,8500,0,19750,6850,13500,2250,0
50228781,FA2023 ,13500,550,4000,2325,20375,6500,6500,0,NULL,6500,0,6500,7550,13875,13875,0
50228781,SP2022 ,13005,515,4810,2220,20550,6500,6500,0,NULL,6500,0,6500,7020,14050,14050,0
50228781,SP2023 ,13500,550,4000,2325,20375,6500,6500,0,NULL,6500,0,6500,7550,13875,13875,0
50217105,FA2021 ,12625,500,3740,1080,17945,9175,7675,1500,5250,16898,0,22148,-3773,1047,-4203,0
50217105,FA2022 ,13005,515,4800,1140,19460,10993,8493,2500,3250,18490,0,21740,-4970,970,-2280,0
50217105,FA2023 ,13500,550,5800,NULL,19850,8675,1775,6900,3750,17523,0,21273,-3473,2327,-1423,0
50217105,SP2021 ,12625,500,3740,1080,17945,9175,7675,1500,5250,15397,0,20647,-2272,2548,-2702,0
50217105,SP2022 ,13005,515,4800,1140,19460,10102,10102,0,5250,16600,0,21850,-3080,2860,-2390,0
50217105,SP2023 ,13500,550,5800,NULL,19850,8675,1775,6900,3750,17522,0,21272,-3472,2328,-1422,0
50235079,FA2024 ,14750,600,NULL,NULL,15350,9103,9103,0,2750,9103,0,11853,6247,6247,3497,2250.66
50235079,SP2024 ,14750,600,NULL,NULL,15350,9103,9103,0,2750,9103,0,11853,6247,6247,3497,2250.66
50204595,FA2021 ,12625,500,4830,1080,19035,5425,0,5425,3750,9148,0,12898,3977,9887,6137,0
50204595,SP2021 ,6960,500,4830,1080,13370,5439,0,5439,3750,6321,0,10071,1139,7049,3299,0
50217328,FA2022 ,13005,515,3855,2220,19595,4575,4575,0,4750,4575,0,9325,8945,15020,10270,0
50217328,SP2021 ,12625,500,4270,1080,18475,4575,4575,0,4750,9283,0,14033,3842,9192,4442,0
50217328,SP2022 ,7170,257,NULL,21.9,7448.9,1740,1740,0,4750,1740,0,6490,5687,5708.9,958.9,0
50229470,FA2023 ,13500,550,4550,2325,20925,7000,7000,0,2750,8000,0,10750,6050,12925,10175,135
50229470,FA2024 ,14750,600,5410,2450,23210,7000,5500,1500,3250,7000,0,10250,8350,16210,12960,135
50229470,SP2023 ,13500,550,4550,2325,20925,7000,7000,0,2750,8000,0,10750,6050,12925,10175,135
50229470,SP2024 ,14750,600,5410,2450,23210,7000,5500,1500,3250,7000,0,10250,8350,16210,12960,135
50233370,FA2024 ,14750,600,4200,2450,22000,7150,7150,0,10449,11173,0,21622,4177,10827,378,4533
50203630,FA2021 ,6960,500,4270,1080,12810,2577,2577,0,3750,8077,0,11827,-617,4733,983,0
50203630,SP2021 ,12625,500,4270,1080,18475,4675,4675,0,3750,4675,0,8425,8450,13800,10050,0
50209113,FA2021 ,12625,500,4580,2110,19815,9425,6750,2675,3750,15505,0,19255,-2380,4310,560,0
50209113,FA2022 ,13005,515,4610,NULL,18130,9425,0,9425,6598,13247,0,19845,273,4883,-1715,0
50209113,SP2021 ,12625,500,4580,1080,18785,9425,6750,2675,3750,14005,0,17755,-880,4780,1030,0
50216217,FA2021 ,12625,500,3740,2110,18975,9725,8975,750,7426,11225,0,18651,1900,7750,324,0
50216217,FA2022 ,13005,515,4810,2220,20550,9725,8525,1200,11381,9725,0,21106,3795,10825,-556,0
50216217,SP2021 ,12625,500,3740,2110,18975,9725,8975,750,8837,9725,0,18562,3400,9250,413,0
50216217,SP2022 ,13005,515,4810,2220,20550,9725,8525,1200,11382,9725,0,21107,3795,10825,-557,0
50223736,FA2021 ,12625,500,4580,2110,19815,5000,5000,0,14250,9748,0,23998,3377,10067,-4183,0
50223736,FA2022 ,13005,515,4260,2220,20000,5000,5000,0,15292,8847,0,24139,4673,11153,-4139,0
50223736,FA2023 ,13500,550,4000,2325,20375,5000,5000,0,6250,9098,0,15348,4952,11277,5027,0
50223736,SP2021 ,12625,500,4580,2110,19815,5000,5000,0,13350,9307,0,22657,3818,10508,-2842,0
50223736,SP2022 ,13005,515,4260,2220,20000,5000,5000,0,12308,8848,0,21156,4672,11152,-1156,0
50223736,SP2023 ,13500,550,4000,2325,20375,5000,5000,0,6250,9097,0,15347,4953,11278,5028,0
50233950,FA2024 ,14750,600,4200,2450,22000,9500,9500,0,NULL,9500,0,9500,5850,12500,12500,0
50233950,SP2024 ,14750,600,4200,2450,22000,9500,9500,0,NULL,9500,0,9500,5850,12500,12500,0
50204752,FA2021 ,12625,500,4830,1080,19035,6850,2850,4000,3750,8350,0,12100,4775,10685,6935,0
50204752,SP2021 ,12625,500,4830,1080,19035,6850,2850,4000,3750,6850,0,10600,6275,12185,8435,0
50228128,FA2023 ,13500,550,5150,2325,21525,7500,7500,0,2750,7500,0,10250,6550,14025,11275,0
50228128,FA2024 ,14750,600,5410,1270,22030,7500,7500,0,3250,7500,0,10750,7850,14530,11280,0
50228128,SP2023 ,13500,550,4000,2325,20375,7500,7500,0,2750,7500,0,10250,6550,12875,10125,0
50228128,SP2024 ,14750,600,0,0,15350,10076,10076,0,3250,10076,0,13326,5274,5274,2024,0
50210413,FA2021 ,12625,500,4050,2110,19285,7000,7000,0,12839,8000,0,20839,5125,11285,-1554,0
50210413,FA2022 ,13005,515,4260,2220,20000,6500,6500,0,13823,6500,0,20323,7020,13500,-323,0
50210413,SP2021 ,12625,500,4050,2110,19285,7000,7000,0,12839,7000,0,19839,6125,12285,-554,0
50210413,SP2022 ,13005,515,4260,2220,20000,6500,6500,0,13823,6500,0,20323,7020,13500,-323,0
50215512,FA2021 ,19340,860,5440,2110,26890,15700,13525,2175,10875,17200,0,28075,3000,9690,-1185,0
50215512,FA2022 ,19910,890,5970,1140,27020,15700,12775,2925,3750,15700,0,19450,5100,11320,7570,0
50215512,FA2023 ,20670,950,6750,2325,29745,15700,10750,4950,3750,15700,0,19450,5920,14045,10295,0
50215512,SP2021 ,19340,860,5440,2110,26890,15700,13525,2175,10876,15700,0,26576,4500,11190,314,0
50215512,SP2022 ,19910,890,5970,1140,27020,15700,12775,2925,3750,15700,0,19450,5100,11320,7570,0
50215512,SP2023 ,20670,950,6390,2325,29385,15700,10750,4950,3750,15700,0,19450,5920,13685,9935,0
50236462,SP2024 ,14750,600,5410,2450,23210,24658,24658,0,NULL,24658,0,24658,-9308,-1448,-1448,0
50213037,FA2021 ,12625,500,4580,2110,19815,8425,8425,0,3250,9425,0,12675,3700,10390,7140,0
50213037,FA2022 ,13005,6590,6590,NULL,19595,8425,0,8425,3750,8425,0,12175,11170,11170,7420,0
50213037,FA2023 ,13500,550,4790,1200,20040,8425,0,8425,3750,8425,0,12175,5625,11615,7865,0
50213037,SP2021 ,12625,500,4580,2110,19815,8425,8425,0,3250,8425,0,11675,4700,11390,8140,0
50213037,SP2022 ,13005,515,4260,1140,18920,8425,0,8425,3750,8425,0,12175,5095,10495,6745,0
50213037,SP2023 ,13500,550,4790,1200,20040,8425,0,8425,3750,8425,0,12175,5625,11615,7865,0
50221445,FA2021 ,12625,500,4050,2110,19285,7000,7000,0,2750,7000,0,9750,6125,12285,9535,60
50221445,FA2022 ,13005,515,4260,2220,20000,6550,6550,0,3250,6550,0,9800,6970,13450,10200,60
50221445,FA2023 ,13500,550,5440,1200,20690,6250,6250,0,3750,6250,0,10000,7800,14440,10690,60
50221445,FA2024 ,14750,600,6090,1270,22710,6250,6250,0,3750,6250,0,10000,9100,16460,12710,60
50221445,SP2021 ,12625,500,4050,2110,19285,6750,6750,0,2750,6750,0,9500,6375,12535,9785,60
50221445,SP2022 ,13005,515,4260,2220,20000,6250,6250,0,3250,6250,0,9500,7270,13750,10500,60
50221445,SP2023 ,13500,6825,6825,NULL,20325,0,0,0,3750,0,0,3750,20325,20325,16575,60
50221445,SP2024 ,14750,600,6090,0,21440,6250,6250,0,3750,6250,0,10000,9100,15190,11440,60
50225022,FA2022 ,13005,515,4810,2220,20550,5750,5750,0,14405,8250,0,22655,5270,12300,-2105,-1240.68
50225022,FA2023 ,13500,550,5150,2325,21525,5750,5750,0,5250,5750,0,11000,8300,15775,10525,-1240.68
50225022,FA2024 ,14750,600,5410,2450,23210,5750,5750,0,13306,5750,0,19056,9600,17460,4154,-1240.68
50225022,SP2022 ,13005,515,4810,2220,20550,5750,5750,0,14618,5750,0,20368,7770,14800,182,-1240.68
50225022,SP2023 ,13500,550,5150,2325,21525,5750,5750,0,5250,5750,0,11000,8300,15775,10525,-1240.68
50225022,SP2024 ,14750,600,5410,2450,23210,5750,5750,0,13306,5750,0,19056,9600,17460,4154,-1240.68
50209750,FA2021 ,12625,500,4050,1080,18255,9796,9046,750,NULL,11296,0,11296,1829,6959,6959,0
50209750,SP2021 ,12625,500,4050,1080,18255,9358,8608,750,NULL,9358,0,9358,3767,8897,8897,0
50228062,FA2023 ,13500,550,4560,2325,20935,7000,7000,0,12500,7000,0,19500,7050,13935,1435,0
50228062,FA2024 ,14750,600,5410,2450,23210,7000,7000,0,12250,7000,0,19250,8350,16210,3960,0
50228062,SP2023 ,13500,550,4560,2325,20935,7000,7000,0,12500,7000,0,19500,7050,13935,1435,0
50228062,SP2024 ,14750,600,5410,2450,23210,7000,7000,0,12250,7000,0,19250,8350,16210,3960,0
50229657,FA2023 ,13500,550,5150,2325,21525,9000,9000,0,2750,9000,0,11750,5050,12525,9775,4472.32
50229657,FA2024 ,14750,600,4200,2450,22000,9000,9000,0,NULL,9000,0,9000,6350,13000,13000,4472.32
50229657,SP2023 ,13500,550,5150,2325,21525,9000,9000,0,2750,9000,0,11750,5050,12525,9775,4472.32
50229657,SP2024 ,14750,600,4200,2450,22000,9000,9000,0,NULL,9000,0,9000,6350,13000,13000,4472.32
50230883,FA2023 ,13500,550,4000,2325,20375,7000,0,7000,2750,7000,0,9750,7050,13375,10625,0
50230883,FA2024 ,14750,600,4790,2450,22590,7000,7000,0,NULL,7000,0,7000,8350,15590,15590,0
50230883,SP2023 ,13500,550,4000,2325,20375,7000,0,7000,2750,7000,0,9750,7050,13375,10625,0
50230883,SP2024 ,14750,7250,7250,NULL,22000,7000,7000,0,NULL,7000,0,7000,15000,15000,15000,0
50204504,FA2021 ,12625,500,4830,1080,19035,2425,2425,0,3750,3425,0,7175,9700,15610,11860,0
50204504,SP2021 ,12625,500,4830,1080,19035,2425,2425,0,3750,2425,0,6175,10700,16610,12860,0
50221163,FA2024 ,14750,600,4790,2450,22590,9000,9000,0,NULL,9000,0,9000,6350,13590,13590,0
50221163,SP2023 ,13500,550,4560,2325,20935,9000,6500,2500,NULL,9000,0,9000,5050,11935,11935,0
50221163,SP2024 ,14750,600,4790,2450,22590,9000,9000,0,NULL,9000,0,9000,6350,13590,13590,0
50226828,FA2023 ,13500,550,5150,2325,21525,9550,9550,0,0,14073,0,14073,-23,7452,7452,2343.66
50226828,FA2024 ,14750,600,5410,2450,23210,10550,7000,3550,0,20248,0,20248,-4898,2962,2962,2343.66
50226828,SP2023 ,13500,550,5150,2325,21525,9550,9550,0,0,11572,0,11572,2478,9953,9953,2343.66
50226828,SP2024 ,14750,600,5410,2450,23210,10550,7000,3550,0,14247,0,14247,1103,8963,8963,2343.66
50216501,FA2021 ,12625,500,4580,2110,19815,6425,5700,725,3250,7925,0,11175,5200,11890,8640,0
50202994,FA2021 ,13440,500,4830,1080,19850,6850,6850,0,14500,10173,0,24673,3767,9677,-4823,0
50214452,FA2021 ,12625,500,4050,2110,19285,5425,5425,0,NULL,5425,0,5425,7700,13860,13860,0
50214452,FA2022 ,13005,515,4810,2220,20550,5425,5425,0,NULL,10235,0,10235,3285,10315,10315,0
50214452,FA2023 ,13500,550,5800,1200,21050,5425,0,5425,NULL,5425,0,5425,8625,15625,15625,0
50214452,SP2021 ,12625,500,4050,2110,19285,5675,5675,0,NULL,5675,0,5675,7450,13610,13610,0
50214452,SP2022 ,13005,515,4810,2220,20550,5425,5425,0,NULL,10235,0,10235,3285,10315,10315,0
50214452,SP2023 ,13500,550,5800,1200,21050,5425,0,5425,NULL,5425,0,5425,8625,15625,15625,0
50228088,FA2023 ,13500,550,4000,2325,20375,7500,7500,0,2750,7500,0,10250,6550,12875,10125,4824.66
50228088,FA2024 ,14750,600,4200,2450,22000,7500,7500,0,NULL,7500,0,7500,7850,14500,14500,4824.66
50228088,SP2023 ,13500,550,4000,2325,20375,7500,7500,0,2750,7500,0,10250,6550,12875,10125,4824.66
50228088,SP2024 ,14750,600,4200,2450,22000,7500,7500,0,NULL,7500,0,7500,7850,14500,14500,4824.66
50210632,FA2021 ,12625,500,4830,1080,19035,2425,2425,0,8550,3425,0,11975,9700,15610,7060,0
50210632,FA2022 ,13005,515,5080,1140,19740,2425,2425,0,5500,2425,0,7925,11095,17315,11815,0
50210632,SP2021 ,12625,500,4830,1080,19035,2425,2425,0,8450,2425,0,10875,10700,16610,8160,0
50210632,SP2022 ,3580,NULL,5080,1140,9800,0,0,0,NULL,0,0,0,3580,9800,9800,0
50221531,FA2021 ,12625,500,4580,2110,19815,6750,6750,0,2750,6750,0,9500,6375,13065,10315,0
50221531,FA2022 ,13005,515,4810,2220,20550,6250,6250,0,NULL,6250,0,6250,7270,14300,14300,0
50221531,FA2023 ,13500,550,5150,2325,21525,6250,6250,0,NULL,6250,0,6250,7800,15275,15275,0
50221531,FA2024 ,14750,600,6090,2680,24120,6250,6250,0,NULL,6250,0,6250,9100,17870,17870,0
50221531,SP2021 ,12625,500,4580,2110,19815,6750,6750,0,2750,6750,0,9500,6375,13065,10315,0
50221531,SP2022 ,13005,515,4810,2220,20550,6250,6250,0,NULL,6250,0,6250,7270,14300,14300,0
50221531,SP2023 ,13500,550,5150,2325,21525,6250,6250,0,NULL,6250,0,6250,7800,15275,15275,0
50221531,SP2024 ,14750,600,6090,2450,23890,6250,6250,0,NULL,6250,0,6250,9100,17640,17640,0
50118064,FA2021 ,12625,500,NULL,NULL,13125,0,0,0,NULL,13625,12625,13625,-500,-500,-500,1200
50118064,FA2022 ,13005,515,5420,1140,20080,0,0,0,3750,13005,13005,16755,515,7075,3325,1200
50118064,FA2023 ,13500,550,5440,1200,20690,0,0,0,NULL,13500,13500,13500,550,7190,7190,1200
50118064,FA2024 ,4070,NULL,NULL,NULL,4070,0,0,0,NULL,4070,4070,4070,0,0,0,1200
50118064,SP2021 ,12625,500,NULL,NULL,13125,0,0,0,NULL,12625,12625,12625,500,500,500,1200
50118064,SP2022 ,13005,515,5420,1140,20080,0,0,0,3750,13005,13005,16755,515,7075,3325,1200
50118064,SP2023 ,13500,550,NULL,NULL,14050,0,0,0,NULL,13500,13500,13500,550,550,550,1200
50118064,SP2024 ,2120,NULL,NULL,NULL,2120,0,0,0,NULL,2120,2120,2120,0,0,0,1200
50119097,FA2021 ,12625,500,3740,2110,18975,0,0,0,3250,14125,12625,17375,-1000,4850,1600,130
50119097,FA2022 ,13005,515,5080,1140,19740,0,0,0,3750,13005,13005,16755,515,6735,2985,130
50119097,FA2023 ,13500,550,5150,2325,21525,0,0,0,NULL,13500,13500,13500,550,8025,8025,130
50119097,FA2024 ,4070,NULL,NULL,NULL,4070,0,0,0,NULL,4070,4070,4070,0,0,0,130
50119097,SP2021 ,12625,500,3740,2110,18975,0,0,0,3250,12625,12625,15875,500,6350,3100,130
50119097,SP2022 ,13005,515,5080,1140,19740,0,0,0,3750,13005,13005,16755,515,6735,2985,130
50119097,SP2023 ,13500,550,5150,2325,21525,0,0,0,NULL,13500,13500,13500,550,8025,8025,130
50119869,FA2021 ,3470,NULL,NULL,NULL,3470,0,0,0,NULL,3470,3470,3470,0,0,0,0
50232443,SP2023 ,12500,4300,4300,NULL,16800,0,0,0,NULL,0,0,0,16800,16800,16800,0
50204360,FA2021 ,12625,500,NULL,1080,14205,925,0,925,13750,2425,0,16175,10700,11780,-1970,0
50204360,SP2021 ,6960,250,NULL,1080,8290,510,0,510,6450,510,0,6960,6700,7780,1330,0
50209587,FA2021 ,12625,500,3740,2110,18975,6925,5650,1275,12739,8425,0,21164,4700,10550,-2189,0
50209587,FA2022 ,13005,515,4610,1140,19270,6925,5650,1275,12103,6925,0,19028,6595,12345,242,0
50209587,SP2021 ,12625,500,3740,2110,18975,6925,5650,1275,3750,6925,0,10675,6200,12050,8300,0
50217651,FA2021 ,12625,500,4580,2110,19815,3925,3550,375,0,4925,0,4925,8200,14890,14890,6846
50217651,FA2023 ,13500,550,4000,2535,20585,3925,3550,375,3750,3925,0,7675,10125,16660,12910,6846
50217651,FA2024 ,14750,600,5030,1270,21650,7850,0,7850,3750,7850,0,11600,7500,13800,10050,6846
50217651,SP2021 ,12625,500,4580,2110,19815,3925,3550,375,0,3925,0,3925,9200,15890,15890,6846
50217651,SP2022 ,13005,515,3855,2220,19595,3925,3550,375,NULL,3925,0,3925,9595,15670,15670,6846
50217651,SP2023 ,13500,550,4000,2535,20585,3925,3550,375,3750,3925,0,7675,10125,16660,12910,6846
50217651,SP2024 ,14750,600,5030,1270,21650,7850,0,7850,3750,7850,0,11600,7500,13800,10050,6846
50206635,FA2021 ,12625,500,5160,0,18285,675,0,675,3750,1675,0,5425,11450,16610,12860,0
50206635,SP2021 ,12625,500,5160,NULL,18285,675,0,675,3750,675,0,4425,12450,17610,13860,0
50226721,FA2023 ,13500,550,4000,2325,20375,21800,7500,14300,NULL,21800,0,21800,-7750,-1425,-1425,13861.7
50226721,FA2024 ,14750,600,4200,2450,22000,19650,7500,12150,NULL,19650,0,19650,-4300,2350,2350,13861.7
50226721,SP2022 ,13005,515,3855,2220,19595,15000,7500,7500,NULL,15000,0,15000,-1480,4595,4595,13861.7
50226721,SP2023 ,13500,550,4000,2325,20375,7500,7500,0,NULL,7500,0,7500,6550,12875,12875,13861.7
50226721,SP2024 ,14750,600,4200,2450,22000,19650,7500,12150,NULL,19650,0,19650,-4300,2350,2350,13861.7
50226020,FA2022 ,13005,515,4810,2220,20550,7000,6500,500,2750,7000,0,9750,6520,13550,10800,0
50226020,FA2023 ,13500,550,4560,2325,20935,6500,6500,0,3250,6500,0,9750,7550,14435,11185,0
50226020,FA2024 ,14750,600,4790,2450,22590,6500,6500,0,NULL,6500,0,6500,8850,16090,16090,0
50226020,SP2022 ,13005,515,4810,2220,20550,7000,6500,500,2750,7000,0,9750,6520,13550,10800,0
50226020,SP2023 ,13500,550,4560,2325,20935,6500,6500,0,3250,6500,0,9750,7550,14435,11185,0
50226020,SP2024 ,14750,600,5410,2450,23210,6500,6500,0,NULL,6500,0,6500,8850,16710,16710,0
50209221,FA2021 ,12625,500,3740,2110,18975,6425,6425,0,3750,7925,0,11675,5200,11050,7300,0
50209221,FA2022 ,13005,515,4610,2220,20350,6425,6425,0,3750,9098,0,12848,4422,11252,7502,0
50209221,SP2021 ,12625,500,3740,2110,18975,6425,6425,0,3750,6425,0,10175,6700,12550,8800,0
50209221,SP2022 ,13005,515,4260,2220,20000,6425,6425,0,3750,9097,0,12847,4423,10903,7153,0
50204249,FA2021 ,12625,500,4050,2110,19285,2925,0,2925,NULL,2925,0,2925,10200,16360,16360,0
50204249,SP2021 ,12625,500,4050,2110,19285,2925,0,2925,NULL,2925,0,2925,10200,16360,16360,0
50221484,FA2021 ,12625,500,4580,2110,19815,7250,7250,0,NULL,7250,0,7250,5875,12565,12565,410
50221484,FA2022 ,13005,515,3855,2220,19595,6750,6750,0,NULL,6750,0,6750,6770,12845,12845,410
50221484,FA2023 ,13500,550,5440,1200,20690,6750,6750,0,NULL,6750,0,6750,7300,13940,13940,410
50221484,FA2024 ,14750,600,5030,1270,21650,6750,6750,0,NULL,6750,0,6750,8600,14900,14900,410
50221484,SP2021 ,12625,500,4580,2110,19815,7250,7250,0,NULL,7250,0,7250,5875,12565,12565,410
50221484,SP2022 ,13005,515,3855,2220,19595,6750,6750,0,NULL,6750,0,6750,6770,12845,12845,410
50221484,SP2023 ,13500,6825,6825,NULL,20325,6750,6750,0,NULL,6750,0,6750,13575,13575,13575,410
50221484,SP2024 ,14750,600,5030,1270,21650,6750,6750,0,NULL,6750,0,6750,8600,14900,14900,410
50220987,FA2021 ,12625,500,3740,2110,18975,11500,9500,2000,0,15100,0,15100,-1975,3875,3875,0
50220987,FA2022 ,13005,515,3855,NULL,17375,9000,9000,0,3250,9000,0,12250,4520,8375,5125,0
50220987,FA2023 ,13500,550,4000,1200,19250,11000,9000,2000,8500,11000,0,19500,3050,8250,-250,0
50220987,FA2024 ,14750,600,5240,2450,23040,9668,9000,668,7750,10668,0,18418,4682,12372,4622,0
50220987,SP2021 ,12625,500,3740,2110,18975,9500,9500,0,0,9500,0,9500,3625,9475,9475,0
50220987,SP2022 ,13005,515,3855,NULL,17375,11000,9000,2000,3250,11000,0,14250,2520,6375,3125,0
50220987,SP2023 ,13500,550,4000,1200,19250,9000,9000,0,8500,9000,0,17500,5050,10250,1750,0
50220987,SP2024 ,14750,600,5240,2450,23040,10666,9000,1666,7750,10666,0,18416,4684,12374,4624,0
50214276,FA2022 ,13005,515,NULL,NULL,13520,3605,3605,0,NULL,3605,0,3605,9915,9915,9915,-14972.4
50214276,FA2023 ,13500,550,NULL,NULL,14050,3605,3605,0,NULL,3605,0,3605,10445,10445,10445,-14972.4
50214276,FA2024 ,14750,600,NULL,NULL,15350,3450,3450,0,NULL,3450,0,3450,11900,11900,11900,-14972.4
50214276,SP2022 ,13005,515,NULL,NULL,13520,3605,3605,0,NULL,3605,0,3605,9915,9915,9915,-14972.4
50214276,SP2023 ,13500,550,NULL,NULL,14050,3605,3605,0,NULL,3605,0,3605,10445,10445,10445,-14972.4
50214276,SP2024 ,14750,7250,7250,NULL,22000,5000,5000,0,NULL,5000,0,5000,17000,17000,17000,-14972.4
50217194,FA2021 ,12625,500,4050,2110,19285,10425,10425,0,2750,11925,0,14675,1200,7360,4610,0
50217194,FA2022 ,13005,6590,6590,NULL,19595,10425,10425,0,3750,10425,0,14175,9170,9170,5420,0
50217194,FA2023 ,13500,550,4790,1200,20040,10425,0,10425,3750,10425,0,14175,3625,9615,5865,0
50217194,SP2021 ,12625,500,4050,2110,19285,10425,10425,0,2750,10425,0,13175,2700,8860,6110,0
50217194,SP2023 ,13500,550,4790,1200,20040,10425,0,10425,3750,10425,0,14175,3625,9615,5865,0
50228621,FA2023 ,13500,550,5150,2535,21735,7500,7500,0,2750,9500,0,12250,4550,12235,9485,0
50228621,FA2024 ,14750,600,4200,2450,22000,8500,7500,1000,0,8500,0,8500,6850,13500,13500,0
50228621,SP2023 ,13500,550,5150,2535,21735,7500,7500,0,2750,7500,0,10250,6550,14235,11485,0
50228621,SP2024 ,14750,600,4200,2450,22000,8500,7500,1000,0,8500,0,8500,6850,13500,13500,0
50228917,FA2023 ,13500,550,5150,2325,21525,2000,0,2000,2750,15500,13500,18250,-1450,6025,3275,0
50228917,SP2023 ,13500,550,5150,2325,21525,0,0,0,2750,13500,13500,16250,550,8025,5275,0
50229562,FA2023 ,13500,550,5150,2325,21525,2000,0,2000,2750,15500,13500,18250,-1450,6025,3275,25
50229562,FA2024 ,14750,600,4790,2450,22590,0,0,0,3250,14750,14750,18000,600,7840,4590,25
50229562,SP2023 ,13500,550,5150,2325,21525,0,0,0,2750,13500,13500,16250,550,8025,5275,25
50229562,SP2024 ,14750,600,4790,2450,22590,0,0,0,3250,14750,14750,18000,600,7840,4590,25
50226831,FA2023 ,2700,110,300,465,3575,2000,1600,400,0,2000,0,2000,810,1575,1575,0
50220852,FA2021 ,12625,500,3740,2110,18975,7250,7250,0,4750,8250,0,13000,4875,10725,5975,10453.26
50220852,FA2022 ,13005,515,3855,2220,19595,6750,6750,0,5250,6750,0,12000,6770,12845,7595,10453.26
50220852,FA2023 ,13500,550,4000,2325,20375,6750,6750,0,6250,6750,0,13000,7300,13625,7375,10453.26
50220852,FA2024 ,14750,600,5030,1270,21650,7750,6750,1000,3750,7750,0,11500,7600,13900,10150,10453.26
50220852,SP2021 ,12625,500,3740,2110,18975,7250,7250,0,4750,7250,0,12000,5875,11725,6975,10453.26
50220852,SP2022 ,13005,515,3855,2220,19595,6750,6750,0,5250,6750,0,12000,6770,12845,7595,10453.26
50220852,SP2023 ,13500,550,4000,2325,20375,6750,6750,0,6250,6750,0,13000,7300,13625,7375,10453.26
50220852,SP2024 ,14750,600,5030,1270,21650,7750,6750,1000,3750,7750,0,11500,7600,13900,10150,10453.26
50225496,FA2022 ,13005,515,4260,2220,20000,5500,5500,0,2750,6200,0,8950,7320,13800,11050,4505.1
50225496,FA2023 ,13500,550,5150,2325,21525,5500,5500,0,0,5500,0,5500,8550,16025,16025,4505.1
50225496,FA2024 ,14750,600,5720,NULL,21070,6000,5500,500,3250,6000,0,9250,9350,15070,11820,4505.1
50225496,SP2022 ,13005,515,4260,2220,20000,5500,5500,0,2750,5500,0,8250,8020,14500,11750,4505.1
50225496,SP2023 ,13500,550,5150,2325,21525,5500,5500,0,0,5500,0,5500,8550,16025,16025,4505.1
50225496,SP2024 ,14750,600,5720,NULL,21070,6000,5500,500,3250,6000,0,9250,9350,15070,11820,4505.1
50221921,FA2021 ,12625,500,NULL,1080,14205,4657,4657,0,2750,4657,0,7407,8468,9548,6798,0
50221921,FA2022 ,13005,515,NULL,NULL,13520,4140,4140,0,NULL,4140,0,4140,9380,9380,9380,0
50221921,FA2023 ,13500,550,NULL,NULL,14050,6000,6000,0,NULL,6000,0,6000,8050,8050,8050,0
50221921,FA2024 ,14750,600,NULL,NULL,15350,6000,6000,0,NULL,6000,0,6000,9350,9350,9350,0
50221921,SP2021 ,12625,500,NULL,1080,14205,4658,4658,0,2750,4658,0,7408,8467,9547,6797,0
50221921,SP2022 ,13005,515,NULL,NULL,13520,4140,4140,0,NULL,4140,0,4140,9380,9380,9380,0
50221921,SP2023 ,13500,6825,6825,NULL,20325,6000,6000,0,NULL,6000,0,6000,14325,14325,14325,0
50221921,SP2024 ,14750,600,NULL,NULL,15350,6000,6000,0,NULL,6000,0,6000,9350,9350,9350,0
50209216,FA2021 ,12625,500,3740,2110,18975,4425,4425,0,3750,5925,0,9675,7200,13050,9300,0
50209216,FA2022 ,13005,515,5080,NULL,18600,5175,4425,750,3750,5175,0,8925,8345,13425,9675,0
50209216,SP2021 ,12625,500,3740,2110,18975,4425,4425,0,3750,5425,0,9175,7700,13550,9800,0
50209216,SP2022 ,13005,515,5080,NULL,18600,5175,4425,750,3750,5175,0,8925,8345,13425,9675,0
50209666,FA2021 ,12625,500,4580,2110,19815,6890,5175,1715,3750,8390,0,12140,4735,11425,7675,0
50209666,SP2021 ,12625,500,4580,2110,19815,6175,5175,1000,3750,6175,0,9925,6950,13640,9890,0
50230221,FA2023 ,13500,550,4000,NULL,18050,9850,7350,2500,3750,13123,0,16873,927,4927,1177,0
50230221,FA2024 ,14750,600,5720,145.81,21215.81,11100,9500,1600,0,13385,0,13385,1965,7830.81,7830.81,0
50230221,SP2023 ,13500,550,4000,NULL,18050,9850,7350,2500,3750,13122,0,16872,928,4928,1178,0
50211730,FA2021 ,12625,500,3740,2110,18975,4425,3325,1100,3750,6425,0,10175,6700,12550,8800,0
50211730,FA2022 ,13005,515,3855,2220,19595,4425,3325,1100,3750,4925,0,8675,8595,14670,10920,0
50211730,SP2021 ,12625,500,3740,2110,18975,4425,3325,1100,3750,4925,0,8675,8200,14050,10300,0
50211730,SP2022 ,13005,515,3855,1140,18515,4425,3325,1100,3750,4925,0,8675,8595,13590,9840,0
50225857,FA2022 ,13005,515,4810,2690,21020,6500,6500,0,2750,6500,0,9250,7020,14520,11770,0
50225857,SP2022 ,13005,515,4810,2690,21020,6500,6500,0,2750,6500,0,9250,7020,14520,11770,0
50202953,FA2021 ,12625,500,4830,1080,19035,4325,3555,770,17153,5825,0,22978,7300,13210,-3943,0
50202953,SP2021 ,12625,500,4830,1080,19035,4325,3555,770,17153,4325,0,21478,8800,14710,-2443,0
50203820,FA2021 ,12625,500,4830,1080,19035,4925,1987,2938,3750,6425,0,10175,6700,12610,8860,0
50203820,SP2021 ,12625,500,4830,1080,19035,4925,1988,2937,3750,4925,0,8675,8200,14110,10360,0
50218314,FA2023 ,13500,550,NULL,NULL,14050,4175,4175,0,2750,4175,0,6925,9875,9875,7125,0
50220706,FA2021 ,12625,500,4580,2110,19815,7250,7250,0,2750,8250,0,11000,4875,11565,8815,0
50220706,FA2022 ,13005,515,3855,2220,19595,6750,6750,0,7250,6750,0,14000,6770,12845,5595,0
50220706,FA2023 ,13500,550,4000,1200,19250,6750,6750,0,3750,6750,0,10500,7300,12500,8750,0
50220706,SP2021 ,12625,500,4580,2110,19815,7250,7250,0,2750,7250,0,10000,5875,12565,9815,0
50220706,SP2022 ,13005,515,3855,2220,19595,6750,6750,0,7250,6750,0,14000,6770,12845,5595,0
50220706,SP2023 ,13500,550,4000,NULL,18050,6750,6750,0,3750,6750,0,10500,7300,11300,7550,0
50232696,FA2024 ,14750,600,4200,2450,22000,7500,7500,0,2750,7500,0,10250,7850,14500,11750,0
50232696,SP2024 ,14750,600,4200,2450,22000,7500,7500,0,2750,7500,0,10250,7850,14500,11750,0
50225735,FA2022 ,13005,515,3855,2220,19595,8550,8550,0,2750,9873,0,12623,3647,9722,6972,3132.49
50225735,FA2023 ,13500,550,4000,2325,20375,8550,8550,0,3250,11573,0,14823,2477,8802,5552,3132.49
50225735,FA2024 ,14750,600,4200,1270,20820,8550,5500,3050,3750,12648,0,16398,2702,8172,4422,3132.49
50225735,SP2022 ,13005,515,3855,2220,19595,8550,8550,0,2750,9872,0,12622,3648,9723,6973,3132.49
50225735,SP2023 ,13500,550,4000,2325,20375,8550,8550,0,3250,11572,0,14822,2478,8803,5553,3132.49
50225735,SP2024 ,14750,600,4200,1270,20820,8550,5500,3050,3750,12647,0,16397,2703,8173,4423,3132.49
50230180,FA2023 ,13500,550,5150,2325,21525,6000,6000,0,NULL,6000,0,6000,8050,15525,15525,5884
50230180,FA2024 ,14750,600,5410,2450,23210,6000,6000,0,NULL,6000,0,6000,9350,17210,17210,5884
50230180,SP2023 ,13500,550,5150,2325,21525,6000,6000,0,NULL,6000,0,6000,8050,15525,15525,5884
50230180,SP2024 ,14750,600,5410,2450,23210,6000,6000,0,NULL,6000,0,6000,9350,17210,17210,5884
50217124,FA2021 ,6960,250,NULL,NULL,7210,1668,1668,0,6250,3168,0,9418,4042,4042,-2208,0
50223541,FA2021 ,12625,500,NULL,NULL,13125,2969,2969,0,2750,6142,0,8892,6983,6983,4233,411
50223541,FA2022 ,13005,515,NULL,NULL,13520,5261,2136,3125,2750,5261,0,8011,8259,8259,5509,411
50223541,FA2023 ,13500,550,NULL,NULL,14050,5761,2636,3125,3750,5761,0,9511,8289,8289,4539,411
50223541,FA2024 ,14750,600,NULL,NULL,15350,6606,1981,4625,6250,11804,0,18054,3546,3546,-2704,411
50223541,SP2022 ,13005,515,NULL,NULL,13520,5261,2136,3125,2750,5261,0,8011,8259,8259,5509,411
50223541,SP2023 ,13500,550,NULL,NULL,14050,5761,2636,3125,3750,5761,0,9511,8289,8289,4539,411
50223541,SP2024 ,2120,NULL,NULL,NULL,2120,0,0,0,0,629,0,629,1491,1491,1491,411
50224444,FA2022 ,13005,515,4810,2220,20550,7000,7000,0,2750,7000,0,9750,6520,13550,10800,0
50224444,FA2023 ,13500,550,4790,1200,20040,7000,7000,0,3750,7000,0,10750,7050,13040,9290,0
50224444,SP2022 ,13005,515,4810,2220,20550,7000,7000,0,2750,7000,0,9750,6520,13550,10800,0
50224444,SP2023 ,13500,550,4790,1200,20040,6500,6500,0,3750,6500,0,10250,7550,13540,9790,0
50235062,FA2024 ,14750,600,NULL,NULL,15350,12103,12103,0,NULL,12103,0,12103,3247,3247,3247,659.6
50235062,SP2024 ,8140,300,NULL,NULL,8440,6679,6679,0,NULL,6679,0,6679,1761,1761,1761,659.6
50235063,FA2024 ,14750,600,NULL,NULL,15350,12228,12228,0,NULL,12228,0,12228,3122,3122,3122,1294.33
50235063,SP2024 ,14750,600,NULL,NULL,15350,12228,12228,0,NULL,12228,0,12228,3122,3122,3122,1294.33
50234380,FA2024 ,15000,7500,7500,NULL,22500,0,0,0,NULL,0,0,0,22500,22500,22500,0
50228261,FA2023 ,13500,550,5150,2745,21945,7000,7000,0,2750,7000,0,9750,7050,14945,12195,3829.5
50228261,FA2024 ,14750,600,NULL,1270,16620,4830,4830,0,3250,4830,0,8080,10520,11790,8540,3829.5
50228261,SP2023 ,13500,550,5150,2535,21735,7000,7000,0,2750,7000,0,9750,7050,14735,11985,3829.5
50228261,SP2024 ,14750,600,NULL,NULL,15350,4830,4830,0,3250,4830,0,8080,10520,10520,7270,3829.5
50210676,FA2021 ,12625,500,3740,2550,19415,3425,3425,0,3750,4925,0,8675,8200,14490,10740,0
50210676,FA2022 ,13005,515,NULL,NULL,13520,1925,1925,0,3493,5373,0,8866,8147,8147,4654,0
50210676,SP2021 ,12625,500,3740,2550,19415,3425,3425,0,3750,3425,0,7175,9700,15990,12240,0
50210676,SP2022 ,13005,515,NULL,NULL,13520,1925,1925,0,0,5372,0,5372,8148,8148,8148,0
50216267,FA2021 ,12625,500,3740,2550,19415,6500,6500,0,2750,6500,0,9250,6625,12915,10165,0
50216267,FA2022 ,13005,515,NULL,NULL,13520,4140,4140,0,6250,7588,0,13838,5932,5932,-318,0
50216267,FA2023 ,7450,275,NULL,NULL,7725,3311,3311,0,2750,6084,0,8834,1641,1641,-1109,0
50216267,SP2021 ,12625,500,3740,2550,19415,6500,6500,0,2750,6500,0,9250,6625,12915,10165,0
50216267,SP2022 ,13005,515,NULL,NULL,13520,4140,4140,0,6250,7587,0,13837,5933,5933,-317,0
50203987,FA2021 ,12625,500,4830,1080,19035,9925,9925,0,3750,10925,0,14675,2200,8110,4360,0
50203987,SP2021 ,12625,500,4830,1080,19035,9925,9925,0,3750,9925,0,13675,3200,9110,5360,0
50218815,FA2021 ,12625,500,NULL,NULL,13125,6425,6425,0,NULL,7925,0,7925,5200,5200,5200,0
50218815,FA2022 ,13005,515,NULL,1140,14660,3675,3675,0,1750,9773,0,11523,3747,4887,3137,0
50218815,FA2023 ,13500,6825,6825,NULL,20325,4800,4800,0,4750,10398,0,15148,9927,9927,5177,0
50218815,SP2021 ,12625,500,NULL,NULL,13125,6425,6425,0,NULL,6425,0,6425,6700,6700,6700,0
50218815,SP2022 ,13005,515,1500,1140,16160,3675,3675,0,1750,9772,0,11522,3748,6388,4638,0
50225497,FA2024 ,14750,600,4200,2450,22000,13303,13303,0,3750,19733,0,23483,-4383,2267,-1483,0
50225497,SP2024 ,14750,600,4200,2450,22000,13303,13303,0,3750,14733,0,18483,617,7267,3517,0
50219047,FA2021 ,12625,500,4580,2110,19815,4725,4725,0,13191,10373,0,23564,2752,9442,-3749,-4683
50219047,FA2023 ,13500,550,4000,2325,20375,1725,1725,0,16302,5725,0,22027,8325,14650,-1652,-4683
50219047,FA2024 ,14750,600,5030,0,20380,4725,4725,0,14604,10095,0,24699,5255,10285,-4319,-4683
50219047,SP2022 ,13005,515,4810,2220,20550,4725,4725,0,9515,7048,0,16563,6472,13502,3987,-4683
50219047,SP2023 ,13500,550,4000,2325,20375,4725,4725,0,16302,4725,0,21027,9325,15650,-652,-4683
50219047,SP2024 ,14750,600,5030,NULL,20380,4725,4725,0,19500,5095,0,24595,10255,15285,-4215,-4683
50225666,FA2022 ,13005,515,4810,2220,20550,5500,5500,0,NULL,5500,0,5500,8020,15050,15050,0
50225666,FA2023 ,13500,550,5150,2325,21525,5500,5500,0,NULL,5500,0,5500,8550,16025,16025,0
50225666,FA2024 ,14750,600,5720,2450,23520,5500,5500,0,NULL,5500,0,5500,9850,18020,18020,0
50225666,SP2022 ,13005,515,4810,2220,20550,5500,5500,0,NULL,5500,0,5500,8020,15050,15050,0
50225666,SP2023 ,13500,550,5150,2325,21525,5500,5500,0,NULL,5500,0,5500,8550,16025,16025,0
50225666,SP2024 ,14750,600,5720,1270,22340,5500,5500,0,NULL,5500,0,5500,9850,16840,16840,0
50228806,FA2023 ,13500,550,5150,2745,21945,6000,6000,0,NULL,6000,0,6000,8050,15945,15945,5743.32
50228806,FA2024 ,14750,600,5240,2450,23040,6000,6000,0,NULL,6000,0,6000,9350,17040,17040,5743.32
50228806,SP2023 ,13500,550,5150,2745,21945,6000,6000,0,NULL,6000,0,6000,8050,15945,15945,5743.32
50228806,SP2024 ,14750,600,5240,2450,23040,6000,6000,0,NULL,6000,0,6000,9350,17040,17040,5743.32
50231405,FA2024 ,14750,600,4200,2450,22000,6500,6500,0,2750,6500,0,9250,8850,15500,12750,5325
50231405,SP2024 ,14750,600,4200,2450,22000,6500,6500,0,2750,6500,0,9250,8850,15500,12750,5325
50219749,FA2021 ,12625,500,NULL,NULL,13125,1975,1175,800,6250,9573,0,15823,3552,3552,-2698,0
50219749,SP2021 ,12625,500,NULL,NULL,13125,1725,925,800,6250,7132,0,13382,5993,5993,-257,0
50230527,FA2023 ,13500,550,5150,2325,21525,7500,7500,0,15800,7500,0,23300,6550,14025,-1775,0
50213038,FA2021 ,12625,500,4050,2110,19285,6000,6000,0,2750,7000,0,9750,6125,12285,9535,0
50225008,FA2022 ,13005,515,4260,2220,20000,7000,7000,0,2750,7000,0,9750,6520,13000,10250,0
50225008,FA2023 ,13500,550,5150,2325,21525,7000,7000,0,3250,7000,0,10250,7050,14525,11275,0
50225008,FA2024 ,14750,600,5720,1270,22340,7000,7000,0,3750,7000,0,10750,8350,15340,11590,0
50225008,SP2022 ,13005,515,4260,2220,20000,7000,7000,0,2750,7000,0,9750,6520,13000,10250,0
50225008,SP2023 ,13500,550,5150,2325,21525,7000,7000,0,3250,7000,0,10250,7050,14525,11275,0
50225008,SP2024 ,14750,600,5720,NULL,21070,7000,7000,0,3750,7000,0,10750,8350,14070,10320,0
50220723,FA2021 ,12625,500,4580,2110,19815,6809,6809,0,2750,20277,0,23027,-7152,-462,-3212,0
50220723,SP2021 ,12625,500,4580,2110,19815,9291,9291,0,10410,12323,0,22733,802,7492,-2918,0
50118849,FA2021 ,12625,500,4270,NULL,17395,6275,6275,0,3250,6775,0,10025,6350,10620,7370,0
50235052,FA2024 ,14750,600,4790,2450,22590,0,0,0,3250,16636,14750,19886,-1286,5954,2704,1074.33
50235052,SP2024 ,14750,600,4790,2450,22590,0,0,0,3250,16636,14750,19886,-1286,5954,2704,1074.33
50209969,FA2021 ,12625,500,4580,2110,19815,4175,3575,600,3250,8848,0,12098,4277,10967,7717,0
50209969,FA2022 ,13005,515,5080,1140,19740,5425,4825,600,5250,5425,0,10675,8095,14315,9065,0
50209969,FA2023 ,13500,550,4790,NULL,18840,5425,0,5425,3750,5425,0,9175,8625,13415,9665,0
50209969,SP2021 ,12625,500,4580,2110,19815,4175,3575,600,3250,6847,0,10097,6278,12968,9718,0
50209969,SP2022 ,13005,515,5080,1140,19740,5425,4825,600,5250,5425,0,10675,8095,14315,9065,0
50209969,SP2023 ,3720,NULL,4790,NULL,8510,0,0,0,0,3720,3720,3720,0,4790,4790,0
50204008,FA2021 ,12625,6350,6350,NULL,18975,5425,3925,1500,NULL,6925,0,6925,12050,12050,12050,0
50204008,SP2021 ,12625,500,NULL,NULL,13125,2925,2425,500,NULL,2925,0,2925,10200,10200,10200,0
50221883,FA2021 ,12625,500,3740,2110,18975,8250,8250,0,10250,11473,0,21723,1652,7502,-2748,0
50221883,FA2022 ,13005,515,4810,2220,20550,7750,7750,0,8750,7750,0,16500,5770,12800,4050,0
50221883,FA2023 ,13500,550,5150,2325,21525,7750,7750,0,15750,7750,0,23500,6300,13775,-1975,0
50221883,SP2021 ,12625,500,3740,2110,18975,8250,8250,0,10250,9972,0,20222,3153,9003,-1247,0
50221883,SP2022 ,13005,515,4810,2220,20550,7750,7750,0,8750,7750,0,16500,5770,12800,4050,0
50221883,SP2023 ,13500,550,5150,2325,21525,7750,7750,0,3750,7750,0,11500,6300,13775,10025,0
50228667,FA2023 ,13500,550,4000,2325,20375,9500,0,9500,2750,9500,0,12250,4550,10875,8125,3227.06
50228667,FA2024 ,14750,600,4200,2450,22000,9500,0,9500,3250,9500,0,12750,5850,12500,9250,3227.06
50228667,SP2023 ,13500,550,4000,2325,20375,9500,0,9500,2750,9500,0,12250,4550,10875,8125,3227.06
50228667,SP2024 ,14750,600,4200,2450,22000,9500,0,9500,3250,9500,0,12750,5850,12500,9250,3227.06
40001017,FA2022 ,13005,515,4810,2220,20550,5500,5500,0,NULL,5500,0,5500,8020,15050,15050,0
40001017,FA2023 ,13500,550,5150,2325,21525,5500,5500,0,NULL,5500,0,5500,8550,16025,16025,0
40001017,SP2022 ,13005,515,4810,2220,20550,5500,5500,0,NULL,5500,0,5500,8020,15050,15050,0
40001017,SP2023 ,13500,550,5150,2325,21525,5500,5500,0,NULL,5500,0,5500,8550,16025,16025,0
50221771,FA2021 ,12625,500,4580,2110,19815,8600,8600,0,2750,9600,0,12350,3525,10215,7465,0
50221771,FA2022 ,13005,515,4810,2220,20550,9600,6000,3600,3250,9600,0,12850,3920,10950,7700,0
50221771,FA2023 ,13500,550,4000,2325,20375,9600,6000,3600,3750,9600,0,13350,4450,10775,7025,0
50221771,FA2024 ,14750,600,5030,1270,21650,9550,0,9550,0,10075,0,10075,5275,11575,11575,0
50221771,SP2021 ,12625,500,4580,2110,19815,8600,8600,0,2750,8600,0,11350,4525,11215,8465,0
50221771,SP2022 ,13005,515,3855,2220,19595,9600,6000,3600,3250,9600,0,12850,3920,9995,6745,0
50221771,SP2023 ,13500,6825,6825,NULL,20325,10500,9000,1500,0,10500,0,10500,9825,9825,9825,0
50221771,SP2024 ,14750,600,5030,1270,21650,9550,0,9550,3750,10075,0,13825,5275,11575,7825,0
50210160,FA2021 ,12625,500,4650,2110,19885,5125,4500,625,3250,12297,0,15547,828,7588,4338,0
50210160,FA2022 ,13005,515,4610,1140,19270,5125,4500,625,3750,10925,0,14675,2595,8345,4595,0
50210160,SP2021 ,12625,500,4650,2110,19885,5125,4500,625,3250,10797,0,14047,2328,9088,5838,0
50210160,SP2022 ,13005,515,4610,1140,19270,5125,4500,625,3750,10925,0,14675,2595,8345,4595,0
50229454,FA2023 ,13500,550,5150,2325,21525,7500,7500,0,2750,7500,0,10250,6550,14025,11275,0
50229454,SP2023 ,13500,550,5150,2325,21525,7500,7500,0,2750,7500,0,10250,6550,14025,11275,0
50216785,FA2021 ,12625,500,4050,1080,18255,10125,0,10125,5250,16873,0,22123,-3748,1382,-3868,0
50216785,FA2022 ,13005,515,5080,NULL,18600,10125,0,10125,6250,15373,0,21623,-1853,3227,-3023,0
50216785,FA2023 ,13500,6825,6825,NULL,20325,10125,10125,0,6250,15722,0,21972,4603,4603,-1647,0
50216785,SP2021 ,12625,500,4050,1080,18255,10125,0,10125,5250,15932,0,21182,-2807,2323,-2927,0
50216785,SP2022 ,13005,515,5080,NULL,18600,10125,0,10125,6250,15372,0,21622,-1852,3228,-3022,0
50156253,FA2021 ,12625,500,4270,NULL,17395,2675,2675,0,NULL,3175,0,3175,9950,14220,14220,0
50156253,SP2021 ,5200,500,4270,NULL,9970,1102,1102,0,NULL,1102,0,1102,4598,8868,8868,0
50221064,FA2021 ,12625,500,3740,2110,18975,6000,6000,0,2750,10748,0,13498,2377,8227,5477,0
50221064,FA2022 ,13005,515,3855,2220,19595,5500,5500,0,6250,7323,0,13573,6197,12272,6022,0
50221064,SP2021 ,12625,500,3740,2110,18975,6000,6000,0,2750,10307,0,13057,2818,8668,5918,0
50221064,SP2022 ,13005,515,3855,2220,19595,5500,5500,0,6250,7322,0,13572,6198,12273,6023,0
50228345,FA2023 ,13500,550,4000,2745,20795,7500,7500,0,2750,7500,0,10250,6550,13295,10545,-450
50228345,FA2024 ,14750,600,4200,2450,22000,7500,7500,0,3250,7500,0,10750,7850,14500,11250,-450
50228345,SP2023 ,13500,550,4000,2745,20795,7500,7500,0,2750,7500,0,10250,6550,13295,10545,-450
50228345,SP2024 ,14750,600,4200,2450,22000,7500,7500,0,3250,7500,0,10750,7850,14500,11250,-450
50207585,FA2021 ,12625,500,4270,1080,18475,3125,0,3125,8545,8148,0,16693,4977,10327,1782,0
50207585,SP2021 ,12625,500,4270,1080,18475,3125,0,3125,12869,6147,0,19016,6978,12328,-541,0
50216461,FA2021 ,12625,500,4580,2110,19815,8275,8275,0,11702,9775,0,21477,3350,10040,-1662,0
50216461,FA2022 ,13005,515,5080,1140,19740,8275,8275,0,13473,8275,0,21748,5245,11465,-2008,0
50216461,FA2023 ,13500,550,5150,2325,21525,8275,8275,0,3750,8275,0,12025,5775,13250,9500,0
50216461,SP2021 ,12625,500,4580,2110,19815,8275,8275,0,3250,8275,0,11525,4850,11540,8290,0
50216461,SP2022 ,13005,515,5080,1140,19740,8275,8275,0,11852,8275,0,20127,5245,11465,-387,0
50221663,FA2021 ,12625,500,3740,2110,18975,7800,7800,0,11147,11273,0,22420,1852,7702,-3445,0
50221663,FA2022 ,13005,515,4810,2220,20550,7300,7300,0,3250,11148,0,14398,2372,9402,6152,0
50221663,FA2023 ,13500,550,4790,NULL,18840,6300,5000,1300,3750,9723,0,13473,4327,9117,5367,0
50221663,FA2024 ,14750,600,5030,2450,22830,8800,5000,3800,3750,12898,0,16648,2452,9932,6182,0
50221663,SP2021 ,12625,500,3740,2110,18975,7800,7800,0,9637,12082,0,21719,1043,6893,-2744,0
50221663,SP2022 ,13005,6590,8256,105,21366,7300,7300,0,3250,11147,0,14397,8448,10219,6969,0
50221663,SP2023 ,13500,550,4790,NULL,18840,6300,5000,1300,3750,9722,0,13472,4328,9118,5368,0
50221663,SP2024 ,14750,600,5030,NULL,20380,8800,5000,3800,3750,12898,0,16648,2452,7482,3732,0
50225300,FA2022 ,13005,515,4260,2220,20000,7750,7750,0,2750,17750,0,20500,-4230,2250,-500,-6695.57
50225300,FA2023 ,13500,550,5150,2325,21525,7750,7750,0,2750,11250,0,14000,2800,10275,7525,-6695.57
50225300,FA2024 ,14750,600,5720,1270,22340,8750,7250,1500,8243,17250,0,25493,-1900,5090,-3153,-6695.57
50225300,SP2022 ,13005,515,4260,2220,20000,7750,7750,0,2750,11250,0,14000,2270,8750,6000,-6695.57
50225300,SP2023 ,13500,550,5150,2325,21525,7750,7750,0,2750,7750,0,10500,6300,13775,11025,-6695.57
50225300,SP2024 ,14750,7250,7250,NULL,22000,8750,7250,1500,9567,14750,0,24317,7250,7250,-2317,-6695.57
50227559,FA2022 ,13005,515,NULL,NULL,13520,3795,3795,0,11727,3795,0,15522,9725,9725,-2002,58.55
50227559,FA2023 ,13500,550,NULL,NULL,14050,3795,3795,0,9388,3795,0,13183,10255,10255,867,58.55
50227559,FA2024 ,14750,600,NULL,NULL,15350,3795,3795,0,10015,5820,0,15835,9530,9530,-485,58.55
50227559,SP2022 ,13005,515,NULL,NULL,13520,3795,3795,0,11726,3795,0,15521,9725,9725,-2001,58.55
50227559,SP2023 ,13500,550,NULL,NULL,14050,3795,3795,0,9388,3795,0,13183,10255,10255,867,58.55
50227559,SP2024 ,14750,600,NULL,NULL,15350,3795,3795,0,10015,5820,0,15835,9530,9530,-485,58.55
50229176,FA2023 ,13500,550,4000,2325,20375,8100,8100,0,2750,10923,0,13673,3127,9452,6702,2407
50229176,FA2024 ,14750,600,4200,2450,22000,8100,6500,1600,3250,11798,0,15048,3552,10202,6952,2407
50229176,SP2023 ,13500,550,4000,2325,20375,8100,8100,0,2750,10922,0,13672,3128,9453,6703,2407
50229176,SP2024 ,14750,600,4200,2450,22000,8100,6500,1600,3250,11797,0,15047,3553,10203,6953,2407
50199300,FA2022 ,7170,257,NULL,NULL,7427,1425,1425,0,3750,1425,0,5175,6002,6002,2252,0
50199300,SP2022 ,7170,257,NULL,NULL,7427,786,786,0,3750,786,0,4536,6641,6641,2891,0
40000814,FA2021 ,12625,500,3740,2110,18975,0,0,0,3750,13625,12625,17375,-500,5350,1600,0
40000814,FA2022 ,7170,515,5080,NULL,12765,0,0,0,3750,7170,7170,10920,515,5595,1845,0
40000814,SP2021 ,12625,500,NULL,NULL,13125,0,0,0,3750,12625,12625,16375,500,500,-3250,0
50224500,FA2021 ,3470,NULL,NULL,NULL,3470,0,0,0,NULL,3470,3470,3470,0,0,0,0
50210806,FA2021 ,12625,500,4270,1080,18475,0,0,0,2431,14125,12625,16556,-1000,4350,1919,0
50210806,FA2022 ,13005,515,3855,1140,18515,0,0,0,2500,13005,13005,15505,515,5510,3010,0
50210806,SP2021 ,12625,500,4270,1080,18475,0,0,0,2432,12625,12625,15057,500,5850,3418,0
50210806,SP2022 ,13005,515,3855,1140,18515,0,0,0,1474,13005,13005,14479,515,5510,4036,0
50221791,FA2021 ,12625,500,3740,2110,18975,1000,1000,0,2750,16325,12625,19075,-3200,2650,-100,0
50221791,SP2021 ,12625,500,3740,2110,18975,0,0,0,2750,12625,12625,15375,500,6350,3600,0
50225452,FA2022 ,13005,515,3855,2220,19595,6500,6500,0,15075,6500,0,21575,7020,13095,-1980,0
50225452,FA2023 ,13500,550,4000,2325,20375,6500,6500,0,15780,6500,0,22280,7550,13875,-1905,0
50225452,FA2024 ,14750,600,5410,2450,23210,6500,6500,0,14191,6500,0,20691,8850,16710,2519,0
50225452,SP2022 ,13005,515,3855,2220,19595,6500,6500,0,15075,6500,0,21575,7020,13095,-1980,0
50225452,SP2023 ,13500,550,4000,2325,20375,6500,6500,0,15780,6500,0,22280,7550,13875,-1905,0
50225452,SP2024 ,14750,600,5410,2450,23210,6500,6500,0,14192,6500,0,20692,8850,16710,2518,0
50233348,FA2024 ,14750,600,5410,2450,23210,6000,6000,0,21069,6000,0,27069,9350,17210,-3859,0
50233348,SP2024 ,14750,600,5410,2450,23210,6000,6000,0,12581,6000,0,18581,9350,17210,4629,0
50203818,FA2021 ,19340,860,4600,2110,26050,12250,9000,3250,12103,13750,0,25853,6450,12300,197,0
50203818,SP2021 ,19340,860,860,NULL,20200,10750,7500,3250,12103,10750,0,22853,9450,9450,-2653,0
50235200,FA2024 ,14750,600,5410,2450,23210,14700,9700,5000,2750,18398,0,21148,-3048,4812,2062,3404.34
50235200,SP2024 ,14750,600,5410,2450,23210,14700,9700,5000,2750,18397,0,21147,-3047,4813,2063,3404.34
50234440,FA2024 ,14750,600,4200,2450,22000,8500,7500,1000,2750,14500,0,17250,850,7500,4750,30
50234440,SP2024 ,14750,600,4200,2450,22000,7500,7500,0,7750,7500,0,15250,7850,14500,6750,30
50207065,FA2021 ,12625,500,NULL,NULL,13125,2000,0,2000,6250,4423,0,10673,8702,8702,2452,0
50215522,FA2021 ,12625,500,NULL,NULL,13125,0,0,0,18725,1500,0,20225,11625,11625,-7100,0
50215522,FA2022 ,7170,257,NULL,NULL,7427,786,786,0,13750,786,0,14536,6641,6641,-7109,0
50215522,SP2021 ,12625,500,NULL,NULL,13125,0,0,0,18725,0,0,18725,13125,13125,-5600,0
50233248,SP2023 ,13500,550,4000,2325,20375,8000,8000,0,NULL,8000,0,8000,6050,12375,12375,5401.5
50229472,FA2023 ,13500,550,4000,2325,20375,9000,9000,0,2750,13198,0,15948,852,7177,4427,0
50229472,FA2024 ,14750,600,5410,2450,23210,9000,9000,0,3250,18908,0,22158,-3558,4302,1052,0
50229472,SP2023 ,13500,550,4000,2325,20375,9000,9000,0,2750,13197,0,15947,853,7178,4428,0
50229472,SP2024 ,14750,600,5410,2450,23210,9000,9000,0,3250,18907,0,22157,-3557,4303,1053,0
50038328,FA2022 ,13005,515,NULL,NULL,13520,4905,4905,0,6250,8228,0,14478,5292,5292,-958,0
50038328,FA2023 ,7450,275,NULL,NULL,7725,4056,4056,0,8966,6299,0,15265,1426,1426,-7540,0
50038328,SP2022 ,13005,515,NULL,NULL,13520,4905,4905,0,6250,8227,0,14477,5293,5293,-957,0
50038328,SP2023 ,7450,275,NULL,NULL,7725,0,0,0,NULL,0,0,0,7725,7725,7725,0
50232131,FA2024 ,14750,600,4200,2450,22000,9000,9000,0,0,15500,0,15500,-150,6500,6500,-2230
50232131,SP2024 ,14750,600,4200,2450,22000,11250,9250,2000,0,15750,0,15750,-400,6250,6250,-2230
50224906,FA2022 ,13005,515,4810,2220,20550,7000,7000,0,0,7000,0,7000,6520,13550,13550,0
50224906,FA2023 ,13500,550,5150,2325,21525,7000,7000,0,0,7000,0,7000,7050,14525,14525,0
50224906,FA2024 ,14750,600,6090,1270,22710,7000,7000,0,16227,7000,0,23227,8350,15710,-517,0
50224906,SP2022 ,13005,515,4810,2220,20550,7000,7000,0,0,7000,0,7000,6520,13550,13550,0
50224906,SP2023 ,13500,550,5150,2325,21525,7000,7000,0,0,7000,0,7000,7050,14525,14525,0
50224906,SP2024 ,14750,7250,7250,NULL,22000,7000,7000,0,15255,7000,0,22255,15000,15000,-255,0
50208964,FA2021 ,12625,500,NULL,NULL,13125,1150,0,1150,4750,8673,0,13423,4452,4452,-298,0
50232041,FA2024 ,14750,600,5410,2450,23210,10300,10300,0,2750,11208,0,13958,4142,12002,9252,3318
50232041,SP2024 ,14750,600,5410,2450,23210,10300,10300,0,2750,11207,0,13957,4143,12003,9253,3318
40000933,FA2021 ,12625,500,4050,2110,19285,1425,0,1425,NULL,1425,0,1425,11700,17860,17860,0
40000933,SP2021 ,12625,500,4050,2110,19285,1425,0,1425,NULL,1425,0,1425,11700,17860,17860,0
50110784,FA2024 ,14750,600,NULL,NULL,15350,6072,500,5572,4750,11270,0,16020,4080,4080,-670,-1061
50110784,SP2024 ,14750,600,NULL,NULL,15350,6072,500,5572,4750,11269,0,16019,4081,4081,-669,-1061
50221230,FA2021 ,12625,500,4580,2110,19815,5500,5500,0,NULL,5500,0,5500,7625,14315,14315,115
50221230,FA2022 ,13005,515,4810,1140,19470,4500,4500,0,NULL,4500,0,4500,9020,14970,14970,115
50221230,FA2023 ,13500,550,4560,NULL,18610,4500,4500,0,NULL,4500,0,4500,9550,14110,14110,115
50221230,FA2024 ,14750,600,5410,8.25,20768.25,4500,4500,0,NULL,4500,0,4500,10850,16268.25,16268.25,115
50221230,SP2021 ,12625,500,4580,2110,19815,5500,5500,0,NULL,5500,0,5500,7625,14315,14315,115
50221230,SP2022 ,13005,515,4810,1140,19470,4500,4500,0,NULL,4500,0,4500,9020,14970,14970,115
50221230,SP2024 ,14750,600,5410,NULL,20760,4500,4500,0,NULL,4500,0,4500,10850,16260,16260,115
50227710,FA2023 ,13500,550,4000,2325,20375,10050,8050,2000,8250,11050,0,19300,3000,9325,1075,1221
50227710,FA2024 ,14750,600,4790,2450,22590,9850,7850,2000,8993,10850,0,19843,4500,11740,2747,1221
50227710,SP2023 ,13500,550,4000,2325,20375,7500,7500,0,8250,7500,0,15750,6550,12875,4625,1221
50227710,SP2024 ,14750,600,4790,2450,22590,7500,7500,0,8993,7500,0,16493,7850,15090,6097,1221
50226157,SP2021 ,13867,6974,6974,NULL,20841,0,0,0,NULL,0,0,0,20841,20841,20841,0
50205472,FA2021 ,12625,500,4830,1080,19035,2675,2675,0,3750,4175,0,7925,8950,14860,11110,0
50205006,FA2021 ,12625,6350,6350,NULL,18975,9475,6975,2500,3750,10975,0,14725,8000,8000,4250,0
50205006,SP2021 ,12625,500,4830,NULL,17955,6975,6975,0,3750,6975,0,10725,6150,10980,7230,0
50216045,FA2021 ,12625,500,4580,2110,19815,8425,8425,0,3250,14505,0,17755,-1380,5310,2060,0
50216045,FA2022 ,13005,515,3855,1140,18515,8425,0,8425,3750,10352,0,14102,3168,8163,4413,0
50216045,FA2023 ,13500,550,4790,NULL,18840,8925,0,8925,3750,16525,0,20275,-2475,2315,-1435,0
50216045,SP2021 ,12625,500,4580,2110,19815,8425,8425,0,3250,13005,0,16255,120,6810,3560,0
50216045,SP2022 ,13005,515,3855,1140,18515,8425,0,8425,3750,10353,0,14103,3167,8162,4412,0
50216045,SP2023 ,13500,550,4790,NULL,18840,8925,0,8925,3750,16525,0,20275,-2475,2315,-1435,0
50221647,FA2022 ,13005,515,4810,2220,20550,6250,6250,0,15760,6250,0,22010,7270,14300,-1460,0
50221647,FA2023 ,13500,550,5150,2325,21525,6250,6250,0,16250,6250,0,22500,7800,15275,-975,0
50221647,SP2022 ,13005,515,4810,2220,20550,6250,6250,0,14523,6250,0,20773,7270,14300,-223,0
50221647,SP2023 ,13500,550,5150,2325,21525,6250,6250,0,16250,6250,0,22500,7800,15275,-975,0
9578473,FA2021 ,12625,6350,6350,NULL,18975,11175,0,11175,6250,13175,0,19425,5800,5800,-450,0
9578473,SP2021 ,12625,500,4830,NULL,17955,11175,0,11175,6250,11175,0,17425,1950,6780,530,0
50216263,FA2021 ,12625,500,3740,2110,18975,14775,10275,4500,2750,20423,0,23173,-7298,-1448,-4198,0
50216263,FA2022 ,13005,515,4610,NULL,18130,10861,8861,2000,2293,19684,0,21977,-6164,-1554,-3847,0
50216263,FA2023 ,13500,550,4790,NULL,18840,11525,6380,5145,3443,19198,0,22641,-5148,-358,-3801,0
50216263,SP2021 ,12625,500,3740,2110,18975,11775,10275,1500,2750,16482,0,19232,-3357,2493,-257,0
50216263,SP2022 ,13005,515,4610,NULL,18130,10689,10689,0,2294,19511,0,21805,-5991,-1381,-3675,0
50216263,SP2023 ,13500,550,NULL,NULL,14050,9525,6380,3145,5318,17197,0,22515,-3147,-3147,-8465,0
50218279,FA2021 ,12625,500,NULL,NULL,13125,5825,2825,3000,6250,11048,0,17298,2077,2077,-4173,0
50218279,SP2021 ,12625,500,NULL,NULL,13125,2825,2825,0,6250,6047,0,12297,7078,7078,828,0
50231302,FA2024 ,14750,600,4200,2450,22000,6000,6000,0,2750,6500,0,9250,8850,15500,12750,0
50231302,SP2024 ,14750,600,4200,2450,22000,6000,6000,0,2750,6000,0,8750,9350,16000,13250,0
50225605,FA2022 ,13005,515,3855,2690,20065,5000,5000,0,15150,5000,0,20150,8520,15065,-85,0
50225605,FA2023 ,13500,550,4790,NULL,18840,5000,5000,0,14000,5000,0,19000,9050,13840,-160,0
50225605,FA2024 ,14750,600,5030,NULL,20380,5000,5000,0,13750,5000,0,18750,10350,15380,1630,0
50225605,SP2021 ,12625,500,3740,2110,18975,5500,5500,0,15200,5500,0,20700,7625,13475,-1725,0
50225605,SP2022 ,13005,515,3855,2690,20065,5000,5000,0,14650,5000,0,19650,8520,15065,415,0
50225605,SP2023 ,13500,550,4790,0,18840,5000,5000,0,15079,5000,0,20079,9050,13840,-1239,0
50196566,FA2021 ,12625,500,NULL,NULL,13125,2425,2425,0,3750,8448,0,12198,4677,4677,927,0
50196566,SP2021 ,12625,500,NULL,NULL,13125,2425,2425,0,3750,5947,0,9697,7178,7178,3428,0
50225301,FA2022 ,13005,515,4260,2220,20000,7250,7250,0,2750,7250,0,10000,6270,12750,10000,0
50225301,FA2023 ,13500,550,5150,2325,21525,7250,7250,0,NULL,7250,0,7250,6800,14275,14275,0
50225301,FA2024 ,14750,600,5720,1270,22340,7250,7250,0,NULL,7250,0,7250,8100,15090,15090,0
50225301,SP2022 ,13005,515,4260,2220,20000,7250,7250,0,2750,7250,0,10000,6270,12750,10000,0
50225301,SP2023 ,13500,550,5150,2325,21525,7250,7250,0,NULL,7250,0,7250,6800,14275,14275,0
50225301,SP2024 ,14750,7250,7250,NULL,22000,3450,3450,0,NULL,3450,0,3450,18550,18550,18550,0
50230443,FA2023 ,13500,550,NULL,2325,16375,5589,5589,0,12357,5589,0,17946,8461,10786,-1571,0
50230443,FA2024 ,14750,600,NULL,1270,16620,8100,6000,2100,12517,8100,0,20617,7250,8520,-3997,0
50230443,SP2023 ,13500,550,NULL,1200,15250,5589,5589,0,9522,5589,0,15111,8461,9661,139,0
50230443,SP2024 ,14750,600,NULL,NULL,15350,8100,6000,2100,8190,8100,0,16290,7250,7250,-940,0
50227448,FA2022 ,13005,515,4380,2220,20120,13520,13520,0,NULL,13520,0,13520,0,6600,6600,0
50229277,FA2023 ,13500,550,4000,2325,20375,8000,8000,0,NULL,8000,0,8000,6050,12375,12375,4189
50229277,FA2024 ,14750,600,4790,1270,21410,8000,8000,0,NULL,8000,0,8000,7350,13410,13410,4189
50229277,SP2023 ,13500,550,4000,2325,20375,8000,8000,0,NULL,8000,0,8000,6050,12375,12375,4189
50229277,SP2024 ,14750,600,4790,NULL,20140,8000,8000,0,NULL,8000,0,8000,7350,12140,12140,4189
50232561,FA2024 ,14750,600,4790,1270,21410,8500,6500,2000,NULL,8500,0,8500,6850,12910,12910,3990
50232561,SP2023 ,13500,550,4000,2325,20375,8500,8500,0,NULL,8500,0,8500,5550,11875,11875,3990
50232561,SP2024 ,14750,600,4790,NULL,20140,8500,6500,2000,NULL,8500,0,8500,6850,11640,11640,3990
50232626,FA2024 ,14750,600,4790,1270,21410,8500,8500,0,NULL,8500,0,8500,6850,12910,12910,2076
50232626,SP2023 ,13500,550,4000,2325,20375,8500,8500,0,NULL,8500,0,8500,5550,11875,11875,2076
50232626,SP2024 ,14750,600,4790,NULL,20140,8500,8500,0,NULL,8500,0,8500,6850,11640,11640,2076
50233648,FA2024 ,14750,600,5240,2450,23040,7000,7000,0,2750,7000,0,9750,8350,16040,13290,0
50233648,SP2024 ,14750,600,5240,2450,23040,7000,7000,0,2750,7000,0,9750,8350,16040,13290,0
50203268,FA2021 ,19340,860,5130,2550,27020,14000,12785,1215,3750,15500,0,19250,4700,11520,7770,0
50203268,SP2021 ,10660,860,5130,2550,18340,7717,7047,670,3750,7717,0,11467,3803,10623,6873,0
50204509,FA2021 ,12625,6350,6350,NULL,18975,2925,2925,0,3750,6898,0,10648,12077,12077,8327,4750
50204509,SP2021 ,12625,500,4830,2110,20065,2925,2925,0,3750,4897,0,8647,8228,15168,11418,4750
50221448,FA2021 ,12625,500,4580,2550,20255,7000,7000,0,2750,8000,0,10750,5125,12255,9505,-220
50221448,FA2022 ,13005,515,4810,2690,21020,6500,6500,0,3250,6500,0,9750,7020,14520,11270,-220
50221448,FA2023 ,13500,550,5150,2745,21945,6500,6500,0,0,6500,0,6500,7550,15445,15445,-220
50221448,FA2024 ,14750,600,5410,2900,23660,6500,6000,500,3750,6500,0,10250,8850,17160,13410,-220
50221448,SP2021 ,12625,500,4580,2550,20255,7000,7000,0,2750,7000,0,9750,6125,13255,10505,-220
50221448,SP2022 ,13005,515,4810,2690,21020,6500,6500,0,3250,6500,0,9750,7020,14520,11270,-220
50221448,SP2023 ,13500,550,5150,2745,21945,6000,6000,0,0,6000,0,6000,8050,15945,15945,-220
50221448,SP2024 ,14750,600,5410,2680,23440,6750,6250,500,3750,7750,0,11500,7600,15690,11940,-220
50224961,FA2022 ,13005,515,4810,2690,21020,6000,6000,0,2750,6000,0,8750,7520,15020,12270,-200
50224961,FA2023 ,13500,550,5150,2745,21945,6000,6000,0,3250,6000,0,9250,8050,15945,12695,-200
50224961,FA2024 ,14750,600,5410,2900,23660,6000,6000,0,3250,6000,0,9250,9350,17660,14410,-200
50224961,SP2022 ,13005,515,4810,2690,21020,6000,6000,0,2750,8200,0,10950,5320,12820,10070,-200
50224961,SP2023 ,13500,550,5150,2745,21945,6000,6000,0,3250,6000,0,9250,8050,15945,12695,-200
50224961,SP2024 ,14750,600,5410,2900,23660,6000,6000,0,3250,7000,0,10250,8350,16660,13410,-200
50231344,FA2024 ,14750,600,5410,2900,23660,7500,7500,0,2750,7500,0,10250,7850,16160,13410,-200
50231344,SP2024 ,14750,600,5410,2900,23660,7500,7500,0,2750,10000,0,12750,5350,13660,10910,-200
50231858,FA2024 ,14750,600,5410,2450,23210,8500,8500,0,2750,13500,0,16250,1850,9710,6960,4043.66
50231858,SP2024 ,14750,600,5410,2450,23210,8500,8500,0,2750,8500,0,11250,6850,14710,11960,4043.66
50196576,FA2021 ,12625,500,4240,2110,19475,2425,2425,0,3750,3925,0,7675,9200,15550,11800,0
50196576,SP2021 ,12625,500,4240,2110,19475,2425,2425,0,3750,2425,0,6175,10700,17050,13300,0
50206132,FA2021 ,12625,500,4830,NULL,17955,4875,3875,1000,14191,6375,0,20566,6750,11580,-2611,0
50206132,SP2021 ,12625,500,4830,NULL,17955,4875,3875,1000,14192,4875,0,19067,8250,13080,-1112,0
50210100,FA2021 ,12625,500,3740,1080,17945,6375,6375,0,3750,7875,0,11625,5250,10070,6320,0
50210100,FA2022 ,7170,257,NULL,NULL,7427,2688,2688,0,3750,2688,0,6438,4739,4739,989,0
50210100,SP2021 ,12625,500,3740,1080,17945,10925,6375,4550,3750,10925,0,14675,2200,7020,3270,0
50234325,FA2024 ,14750,600,5410,2450,23210,9500,9500,0,2750,13408,0,16158,1942,9802,7052,1400
50234325,SP2024 ,14750,600,5410,2450,23210,9500,9500,0,2750,13407,0,16157,1943,9803,7053,1400
50196301,FA2021 ,12625,500,NULL,NULL,13125,0,0,0,9500,4748,0,14248,8377,8377,-1123,4450
50196301,SP2021 ,6960,250,NULL,NULL,7210,0,0,0,0,1834,0,1834,5376,5376,5376,4450
50196301,SP2022 ,3580,NULL,NULL,NULL,3580,0,0,0,NULL,0,0,0,3580,3580,3580,4450
50215623,FA2021 ,12625,500,3740,2110,18975,10225,9425,800,2750,11725,0,14475,1400,7250,4500,0
50215623,FA2022 ,13005,6590,6590,NULL,19595,6425,6425,0,2750,6425,0,9175,13170,13170,10420,0
50215623,FA2023 ,13500,550,4790,1200,20040,9525,9525,0,3750,9525,0,13275,4525,10515,6765,0
50215623,SP2021 ,12625,500,3740,2110,18975,9425,9425,0,2750,9425,0,12175,3700,9550,6800,0
50215623,SP2022 ,13005,515,4260,1140,18920,10225,9425,800,2750,10225,0,12975,3295,8695,5945,0
50215623,SP2023 ,13500,550,4790,1200,20040,9425,9425,0,3750,9425,0,13175,4625,10615,6865,0
50209543,FA2021 ,12625,500,4270,1080,18475,3425,3175,250,14750,4425,0,19175,8700,14050,-700,0
50209543,FA2022 ,13005,515,4610,1140,19270,4925,3175,1750,16250,4925,0,21175,8595,14345,-1905,0
50209543,SP2021 ,12625,500,4270,1080,18475,3425,3175,250,14250,3425,0,17675,9700,15050,800,0
50209543,SP2022 ,13005,515,4610,1140,19270,4925,3175,1750,15050,4925,0,19975,8595,14345,-705,0
50221942,FA2021 ,12625,500,4580,2110,19815,6950,6950,0,11250,10773,0,22023,2352,9042,-2208,-300
50221942,FA2022 ,13005,515,3855,2220,19595,6450,6450,0,9235,10723,0,19958,2797,8872,-363,-300
50221942,FA2023 ,13500,550,5150,2325,21525,6450,6450,0,12199,7700,0,19899,6350,13825,1626,-300
50221942,FA2024 ,14750,600,5410,2450,23210,7700,5000,2700,10250,13898,0,24148,1452,9312,-938,-300
50221942,SP2021 ,12625,500,4240,2110,19475,6950,6950,0,11250,9272,0,20522,3853,10203,-1047,-300
50221942,SP2022 ,13005,515,3855,2220,19595,6450,6450,0,9235,10722,0,19957,2798,8873,-362,-300
50221942,SP2023 ,13500,550,5150,2325,21525,6450,6450,0,12198,7700,0,19898,6350,13825,1627,-300
50221942,SP2024 ,14750,600,5410,2450,23210,7700,5000,2700,10250,12897,0,23147,2453,10313,63,-300
50209802,FA2021 ,12625,500,4830,1080,19035,5925,5875,50,3750,7425,0,11175,5700,11610,7860,0
50209802,FA2022 ,13005,515,4610,NULL,18130,5925,5875,50,3750,5925,0,9675,7595,12205,8455,0
50209802,SP2021 ,12625,500,4830,1080,19035,5925,5875,50,3750,5925,0,9675,7200,13110,9360,0
50209802,SP2022 ,13005,515,4610,NULL,18130,5925,5875,50,3750,5925,0,9675,7595,12205,8455,0
50221943,FA2021 ,12625,500,4580,2110,19815,7500,7500,0,10581,13473,0,24054,-348,6342,-4239,-156
50221943,FA2022 ,13005,515,4810,2220,20550,8000,7000,1000,3250,12723,0,15973,797,7827,4577,-156
50221943,FA2023 ,13500,550,5440,NULL,19490,9250,7000,2250,8750,12523,0,21273,1527,6967,-1783,-156
50221943,FA2024 ,14750,600,5240,NULL,20590,8000,7000,1000,5750,13598,0,19348,1752,6992,1242,-156
50221943,SP2021 ,12625,500,4580,2110,19815,7500,7500,0,2750,12322,0,15072,803,7493,4743,-156
50221943,SP2022 ,13005,515,4810,2220,20550,8000,7000,1000,3250,12722,0,15972,798,7828,4578,-156
50221943,SP2023 ,13500,6825,6825,NULL,20325,7750,6500,1250,3750,11022,0,14772,9303,9303,5553,-156
50221943,SP2024 ,14750,600,5240,NULL,20590,8000,7000,1000,5750,13597,0,19347,1753,6993,1243,-156
50216533,SP2021 ,12625,500,4580,2110,19815,6500,6500,0,NULL,6500,0,6500,6625,13315,13315,0
50213978,FA2021 ,12625,6350,6350,NULL,18975,3213,3213,0,3250,4713,0,7963,14262,14262,11012,0
50213978,FA2022 ,13005,515,NULL,1140,14660,13005,13005,0,3750,13005,0,16755,515,1655,-2095,0
50213978,FA2023 ,13500,550,NULL,NULL,14050,0,0,0,3750,13500,13500,17250,550,550,-3200,0
50213978,SP2021 ,12625,500,3740,1080,17945,0,0,0,3250,12625,0,15875,500,5320,2070,0
50213978,SP2022 ,13005,515,NULL,NULL,13520,13005,13005,0,3750,13005,0,16755,515,515,-3235,0
50213978,SP2023 ,13500,550,NULL,NULL,14050,0,0,0,3750,13500,13500,17250,550,550,-3200,0
50210200,FA2021 ,12625,500,4270,NULL,17395,7800,7800,0,3750,9300,0,13050,3825,8095,4345,0
50210200,FA2022 ,13005,515,4610,NULL,18130,7800,7800,0,3750,11073,0,14823,2447,7057,3307,0
50210200,SP2021 ,12625,500,4270,NULL,17395,7800,7800,0,3750,7800,0,11550,5325,9595,5845,0
50210200,SP2022 ,13005,515,4610,NULL,18130,7800,7800,0,3750,11072,0,14822,2448,7058,3308,0
50216382,FA2021 ,12625,500,3740,2110,18975,8675,8675,0,0,15898,0,15898,-2773,3077,3077,0
50216382,FA2022 ,13005,515,4810,2220,20550,8675,8675,0,0,15147,0,15147,-1627,5403,5403,0
50216382,FA2023 ,13500,550,4790,NULL,18840,9675,1000,8675,0,15947,0,15947,-1897,2893,2893,0
50216382,SP2021 ,12625,500,3740,2110,18975,8675,8675,0,0,13897,0,13897,-772,5078,5078,0
50216382,SP2022 ,13005,515,4810,2220,20550,8675,8675,0,3750,15148,0,18898,-1628,5402,1652,0
50216382,SP2023 ,13500,550,4790,NULL,18840,9675,1000,8675,0,15948,0,15948,-1898,2892,2892,0
50225453,FA2022 ,13005,515,4260,2220,20000,6000,6000,0,0,6973,0,6973,6547,13027,13027,0
50234520,FA2024 ,14750,600,5410,2450,23210,7250,7250,0,18248,10808,0,29056,4542,12402,-5846,-2378
50234520,SP2024 ,14750,600,5410,2450,23210,7250,7250,0,14407,10807,0,25214,4543,12403,-2004,-2378
50234634,FA2024 ,14750,600,4200,2450,22000,9850,9850,0,9630,13985,0,23615,1365,8015,-1615,0
50234634,SP2024 ,14750,600,4200,2450,22000,9850,9850,0,7750,13985,0,21735,1365,8015,265,0
50212555,FA2021 ,12625,500,4470,1080,18675,925,925,0,21511,1425,0,22936,11700,17250,-4261,0
50212555,FA2022 ,14680,515,4260,86.99,19541.99,925,925,0,21616,925,0,22541,14270,18616.99,-2999.01,0
50212555,SP2021 ,12625,500,4270,1080,18475,925,925,0,21510,925,0,22435,12200,17550,-3960,0
50212555,SP2022 ,7170,257,NULL,NULL,7427,0,0,0,15197,0,0,15197,7427,7427,-7770,0
50224445,FA2021 ,12625,500,4580,2110,19815,6000,6000,0,NULL,6500,0,6500,6625,13315,13315,20424.81
50224445,FA2022 ,13005,515,3855,2220,19595,5500,5500,0,NULL,5500,0,5500,8020,14095,14095,20424.81
50224445,FA2023 ,13500,550,4000,2325,20375,5500,5500,0,NULL,5500,0,5500,8550,14875,14875,20424.81
50224445,FA2024 ,18520,600,5030,NULL,24150,5500,5500,0,NULL,5500,0,5500,13620,18650,18650,20424.81
50224445,SP2021 ,12625,500,4580,2110,19815,6000,6000,0,NULL,6000,0,6000,7125,13815,13815,20424.81
50224445,SP2022 ,13005,515,3855,2220,19595,5500,5500,0,NULL,5500,0,5500,8020,14095,14095,20424.81
50224445,SP2023 ,13500,550,4000,2325,20375,5500,5500,0,NULL,5500,0,5500,8550,14875,14875,20424.81
50224445,SP2024 ,14750,600,5030,1270,21650,5500,5500,0,NULL,5500,0,5500,9850,16150,16150,20424.81
50230545,FA2023 ,13500,550,4000,2325,20375,6000,6000,0,NULL,6000,0,6000,8050,14375,14375,44947.5
50230545,FA2024 ,14750,600,4200,2450,22000,6000,1000,5000,NULL,6000,0,6000,9350,16000,16000,44947.5
50230545,SP2023 ,13500,550,4000,2325,20375,6000,6000,0,NULL,6000,0,6000,8050,14375,14375,44947.5
50230545,SP2024 ,14750,600,4200,2450,22000,6000,1000,5000,NULL,6000,0,6000,9350,16000,16000,44947.5
50203432,FA2021 ,12625,500,4270,1080,18475,2175,0,2175,11500,4175,0,15675,8950,14300,2800,0
50203432,SP2021 ,12625,500,4270,NULL,17395,2175,0,2175,11500,2675,0,14175,10450,14720,3220,0
50213413,FA2021 ,12625,500,3740,2110,18975,8175,8175,0,3250,10675,0,13925,2450,8300,5050,0
50213413,FA2022 ,13005,515,4380,2220,20120,8175,8175,0,3750,8675,0,12425,4845,11445,7695,0
50213413,FA2023 ,13500,550,4790,NULL,18840,8925,3650,5275,3750,9425,0,13175,4625,9415,5665,0
50213413,SP2021 ,12625,500,3740,2110,18975,8175,8175,0,3250,8675,0,11925,4450,10300,7050,0
50213413,SP2022 ,13005,515,4380,2220,20120,8175,8175,0,7550,8675,0,16225,4845,11445,3895,0
50213413,SP2023 ,13500,550,4790,NULL,18840,8925,3650,5275,3750,9425,0,13175,4625,9415,5665,0
50220934,FA2021 ,12625,500,4580,2110,19815,6750,6750,0,6905,7750,0,14655,5375,12065,5160,0
50220934,FA2022 ,13005,515,3855,2220,19595,6000,6000,0,8033,6000,0,14033,7520,13595,5562,0
50220934,SP2021 ,12625,500,4580,2110,19815,6750,6750,0,6905,6750,0,13655,6375,13065,6160,0
50220934,SP2022 ,13005,515,3855,2220,19595,6000,6000,0,14135,6000,0,20135,7520,13595,-540,0
50224942,FA2022 ,13005,515,3855,2220,19595,6050,6050,0,2750,6050,0,8800,7470,13545,10795,-18
50224942,FA2023 ,13500,550,4000,2325,20375,6050,6050,0,9251,6050,0,15301,8000,14325,5074,-18
50224942,FA2024 ,14750,600,5410,2450,23210,8050,5000,3050,17063,8050,0,25113,7300,15160,-1903,-18
50224942,SP2022 ,13005,515,3855,2220,19595,6050,6050,0,2750,6050,0,8800,7470,13545,10795,-18
50224942,SP2023 ,13500,550,4000,2325,20375,6050,6050,0,15335,6050,0,21385,8000,14325,-1010,-18
50224942,SP2024 ,14750,600,5410,2450,23210,6050,5000,1050,17951,6050,0,24001,9300,17160,-791,-18
50225192,FA2022 ,13005,515,4260,2690,20470,6000,6000,0,14671,6000,0,20671,7520,14470,-201,9007.8
50225192,FA2023 ,13500,550,5150,2325,21525,6000,5500,500,NULL,6000,0,6000,8050,15525,15525,9007.8
50225192,FA2024 ,14750,600,5720,1270,22340,6000,5500,500,NULL,6000,0,6000,9350,16340,16340,9007.8
50225192,SP2022 ,13005,515,4260,2690,20470,6000,6000,0,14671,6000,0,20671,7520,14470,-201,9007.8
50225192,SP2023 ,13500,550,5150,2325,21525,6000,5500,500,NULL,6000,0,6000,8050,15525,15525,9007.8
50225192,SP2024 ,14750,600,5720,0,21070,6000,5500,500,NULL,6000,0,6000,9350,15070,15070,9007.8
50209960,FA2021 ,12625,500,4270,1080,18475,4675,2662,2013,3250,8045,0,11295,5080,10430,7180,0
50209960,FA2022 ,13005,515,4610,NULL,18130,5925,2000,3925,3750,5925,0,9675,7595,12205,8455,0
50209960,SP2021 ,12625,500,4270,NULL,17395,6675,2663,4012,3250,8545,0,11795,4580,8850,5600,0
50209960,SP2022 ,14680,515,4610,NULL,19805,5425,1500,3925,3750,5425,0,9175,9770,14380,10630,0
50227131,FA2022 ,13005,515,3855,2220,19595,6500,6500,0,NULL,6500,0,6500,7020,13095,13095,0
50227131,FA2023 ,13500,550,4000,2325,20375,6500,6500,0,NULL,6500,0,6500,7550,13875,13875,0
50227131,FA2024 ,14750,600,5030,35.25,20415.25,6500,6500,0,NULL,6500,0,6500,8850,13915.25,13915.25,0
50227131,SP2022 ,13005,515,3855,2220,19595,6500,6500,0,NULL,6500,0,6500,7020,13095,13095,0
50227131,SP2023 ,13500,550,4000,2325,20375,6500,6500,0,NULL,6500,0,6500,7550,13875,13875,0
50227131,SP2024 ,14750,600,5030,NULL,20380,6500,6500,0,NULL,6500,0,6500,8850,13880,13880,0
50227446,FA2022 ,13005,515,4380,2220,20120,13520,13520,0,NULL,13520,0,13520,0,6600,6600,0
50226642,FA2022 ,13005,515,4810,2220,20550,6750,6750,0,2750,6750,0,9500,6770,13800,11050,2731
50226642,FA2023 ,13500,550,4000,2325,20375,6750,6100,650,3250,6750,0,10000,7300,13625,10375,2731
50226642,SP2022 ,13005,515,4810,2220,20550,6750,6750,0,2750,6750,0,9500,6770,13800,11050,2731
50226642,SP2023 ,13500,550,4000,2325,20375,6750,6100,650,3250,6750,0,10000,7300,13625,10375,2731
50230542,FA2024 ,4070,NULL,NULL,NULL,4070,0,0,0,NULL,0,0,0,4070,4070,4070,0
50210018,FA2021 ,12625,500,4270,NULL,17395,2425,2425,0,3750,3425,0,7175,9700,13970,10220,0
50210018,FA2022 ,13005,515,4610,NULL,18130,2425,2425,0,NULL,2425,0,2425,11095,15705,15705,0
50210018,SP2021 ,12625,500,4270,NULL,17395,2425,2425,0,3750,2425,0,6175,10700,14970,11220,0
50210018,SP2022 ,13005,515,4610,NULL,18130,2425,2425,0,NULL,2425,0,2425,11095,15705,15705,0
50209160,FA2021 ,12625,500,4830,1080,19035,4425,4425,0,14578,5925,0,20503,7200,13110,-1468,0
50209160,FA2022 ,13005,515,5080,1140,19740,4425,4425,0,16706,4425,0,21131,9095,15315,-1391,0
50209160,SP2021 ,12625,500,4830,1080,19035,4425,4425,0,15565,4425,0,19990,8700,14610,-955,0
50209160,SP2022 ,5360,515,5080,1140,12095,1824,1824,0,14627,1824,0,16451,4051,10271,-4356,0
50225019,FA2022 ,13005,515,4260,2220,20000,5500,5500,0,2750,5500,0,8250,8020,14500,11750,25
50225019,FA2023 ,13500,550,5150,2325,21525,5500,5500,0,3250,5500,0,8750,8550,16025,12775,25
50225019,FA2024 ,14750,600,5720,1270,22340,5500,5500,0,3750,5500,0,9250,9850,16840,13090,25
50225019,SP2022 ,13005,515,4260,2220,20000,5500,5500,0,2750,5500,0,8250,8020,14500,11750,25
50225019,SP2023 ,13500,550,5150,2325,21525,5500,5500,0,3250,5500,0,8750,8550,16025,12775,25
50225019,SP2024 ,14750,600,5720,1270,22340,5500,5500,0,3750,5500,0,9250,9850,16840,13090,25
50210982,FA2021 ,12625,500,4270,2110,19505,3925,3925,0,1000,5425,0,6425,7700,14080,13080,0
50210982,FA2022 ,13005,515,4810,2220,20550,3925,3925,0,3750,3925,0,7675,9595,16625,12875,0
50210982,SP2021 ,12625,500,4270,2110,19505,3925,3925,0,1000,3925,0,4925,9200,15580,14580,0
50210982,SP2022 ,13005,515,4810,2220,20550,3925,3925,0,3750,3925,0,7675,9595,16625,12875,0
50232595,FA2024 ,14750,600,5410,2450,23210,6000,6000,0,2750,14048,0,16798,1302,9162,6412,2253.55
50232595,SP2024 ,14750,600,5410,2450,23210,6000,6000,0,2750,9670,0,12420,5680,13540,10790,2253.55
50217971,FA2021 ,12625,500,3740,2110,18975,7175,7175,0,12250,9175,0,21425,3950,9800,-2450,0
50217971,FA2022 ,13005,515,4610,1140,19270,6675,6675,0,8750,7175,0,15925,6345,12095,3345,0
50217971,FA2023 ,13500,550,5440,NULL,19490,6675,6675,0,3750,12648,0,16398,1402,6842,3092,0
50217971,SP2021 ,12625,500,3740,2110,18975,7175,7175,0,12250,7675,0,19925,5450,11300,-950,0
50217971,SP2022 ,13005,515,4610,1140,19270,6675,6675,0,8750,7175,0,15925,6345,12095,3345,0
50217971,SP2023 ,13500,550,5440,NULL,19490,6675,6675,0,3750,12647,0,16397,1403,6843,3093,0
50205434,FA2021 ,12625,500,4830,1080,19035,425,0,425,3750,1425,0,5175,11700,17610,13860,0
50205434,FA2022 ,3580,NULL,NULL,NULL,3580,425,425,0,NULL,425,0,425,3155,3155,3155,0
50205434,FA2023 ,3720,NULL,NULL,NULL,3720,0,0,0,NULL,0,0,0,3720,3720,3720,0
50205434,SP2021 ,12625,500,4830,1080,19035,425,0,425,3750,425,0,4175,12700,18610,14860,0
50209047,FA2021 ,12625,500,4050,1080,18255,1775,1775,0,3750,4775,0,8525,8350,13480,9730,0
50209047,FA2022 ,13005,515,4810,1140,19470,1825,400,1425,3750,8635,0,12385,4885,10835,7085,0
50209047,SP2021 ,12625,500,4050,1080,18255,1425,1425,0,3750,1425,0,5175,11700,16830,13080,0
50209047,SP2022 ,5360,515,4810,1140,11825,587,0,587,3750,5878,0,9628,-3,5947,2197,0
50209296,FA2021 ,12625,500,4830,1080,19035,2925,2925,0,NULL,2925,0,2925,10200,16110,16110,0
50209296,FA2022 ,13005,515,4260,1140,18920,2925,2925,0,NULL,2925,0,2925,10595,15995,15995,0
50209296,SP2021 ,12625,500,4830,NULL,17955,2925,2925,0,NULL,2925,0,2925,10200,15030,15030,0
50209296,SP2022 ,13005,515,4260,1140,18920,2925,2925,0,NULL,2925,0,2925,10595,15995,15995,0
50211376,FA2021 ,12625,500,3740,2110,18975,11025,0,11025,3250,16673,0,19923,-3548,2302,-948,0
50211376,SP2021 ,12625,500,3740,2110,18975,11025,0,11025,3250,15732,0,18982,-2607,3243,-7,0
50215289,FA2021 ,12625,500,4580,2110,19815,500,500,0,3250,1500,0,4750,11625,18315,15065,0
50215289,FA2022 ,13005,515,4810,2220,20550,500,500,0,NULL,500,0,500,13020,20050,20050,0
50215289,FA2023 ,13500,550,5800,2535,22385,500,500,0,NULL,500,0,500,13550,21885,21885,0
50215289,SP2021 ,12625,500,4580,2110,19815,500,500,0,3250,500,0,3750,12625,19315,16065,0
50215289,SP2022 ,13005,515,4810,2220,20550,500,500,0,NULL,500,0,500,13020,20050,20050,0
50215289,SP2023 ,13500,550,5800,2745,22595,500,500,0,NULL,500,0,500,13550,22095,22095,0
50217376,FA2021 ,12625,500,4240,2110,19475,0,0,0,NULL,0,0,0,13125,19475,19475,0
50217376,SP2021 ,12625,500,5160,2110,20395,0,0,0,NULL,0,0,0,13125,20395,20395,0
50221510,FA2021 ,12625,500,3740,2110,18975,5750,5750,0,0,6250,0,6250,6875,12725,12725,0
50221510,FA2022 ,13005,515,3855,2220,19595,5250,5250,0,NULL,5250,0,5250,8270,14345,14345,0
50221510,FA2023 ,13500,550,4000,2325,20375,5250,5250,0,NULL,5250,0,5250,8800,15125,15125,0
50221510,FA2024 ,14750,600,4200,2450,22000,5250,5250,0,NULL,5250,0,5250,10100,16750,16750,0
50221510,SP2021 ,12625,500,3740,2110,18975,5750,5750,0,0,5750,0,5750,7375,13225,13225,0
50221510,SP2022 ,13005,515,3855,2220,19595,5250,5250,0,NULL,5250,0,5250,8270,14345,14345,0
50221510,SP2023 ,13500,550,4000,2325,20375,5250,5250,0,NULL,5250,0,5250,8800,15125,15125,0
50221510,SP2024 ,14750,600,4200,2450,22000,5250,5250,0,NULL,5250,0,5250,10100,16750,16750,0
50221600,FA2021 ,12625,500,3740,2550,19415,9000,9000,0,2750,10000,0,12750,3125,9415,6665,115
50221600,FA2022 ,13005,515,3855,2220,19595,8250,8250,0,3250,8250,0,11500,5270,11345,8095,115
50221600,FA2023 ,13500,550,4790,NULL,18840,8250,8250,0,3750,8250,0,12000,5800,10590,6840,115
50221600,FA2024 ,14750,600,5030,NULL,20380,8250,8250,0,3750,8250,0,12000,7100,12130,8380,115
50221600,SP2021 ,12625,500,3740,2550,19415,9000,9000,0,2750,9000,0,11750,4125,10415,7665,115
50221600,SP2022 ,13005,515,3855,2220,19595,8250,8250,0,3250,8250,0,11500,5270,11345,8095,115
50221600,SP2023 ,13500,550,4790,NULL,18840,8250,8250,0,3750,8250,0,12000,5800,10590,6840,115
50221600,SP2024 ,14750,600,5030,NULL,20380,8250,8250,0,3750,8250,0,12000,7100,12130,8380,115
50221659,FA2021 ,12625,500,4580,2110,19815,9600,9600,0,2750,11573,0,14323,1552,8242,5492,0
50221659,FA2022 ,13005,515,4810,2220,20550,9100,9100,0,10250,9100,0,19350,4420,11450,1200,0
50221659,SP2021 ,12625,500,4580,2110,19815,9764,9764,0,2750,10236,0,12986,2889,9579,6829,0
50221821,FA2021 ,12625,500,4580,2110,19815,7800,7800,0,0,8800,0,8800,4325,11015,11015,0
50221821,FA2022 ,13005,515,4260,2220,20000,7300,7300,0,NULL,7300,0,7300,6220,12700,12700,0
50221821,FA2023 ,13500,550,4560,2745,21355,7300,5000,2300,0,11323,0,11323,2727,10032,10032,0
50221821,FA2024 ,14750,600,5720,1270,22340,7300,5000,2300,NULL,7300,0,7300,8050,15040,15040,0
50221821,SP2021 ,12625,500,4580,2110,19815,7800,7800,0,0,7800,0,7800,5325,12015,12015,0
50221821,SP2022 ,13005,515,4260,2690,20470,7300,7300,0,NULL,7300,0,7300,6220,13170,13170,0
50221821,SP2023 ,13500,550,4560,2745,21355,7300,5000,2300,0,11322,0,11322,2728,10033,10033,0
50221821,SP2024 ,14750,600,5720,1270,22340,7300,5000,2300,NULL,7300,0,7300,8050,15040,15040,0
50221880,FA2021 ,12625,500,3740,2110,18975,0,0,0,2750,18698,12625,21448,-5573,277,-2473,-6888
50221880,FA2022 ,13005,515,3855,2220,19595,0,0,0,3250,17828,13005,21078,-4308,1767,-1483,-6888
50221880,FA2023 ,13500,550,4560,2325,20935,0,0,0,3250,18473,13500,21723,-4423,2462,-788,-6888
50221880,FA2024 ,14750,600,5030,1270,21650,0,0,0,2853,19948,14750,22801,-4598,1702,-1151,-6888
50221880,SP2021 ,12625,500,3740,2110,18975,0,0,0,5250,16197,12625,21447,-3072,2778,-2472,-6888
50221880,SP2022 ,13005,515,3855,2220,19595,0,0,0,2250,18827,13005,21077,-5307,768,-1482,-6888
50221880,SP2023 ,13500,550,5440,1200,20690,0,0,0,3250,18472,13500,21722,-4422,2218,-1032,-6888
50221880,SP2024 ,8140,600,5030,1270,15040,0,0,0,2852,10617,8140,13469,-1877,4423,1571,-6888
50221894,FA2021 ,12625,500,3740,2110,18975,0,0,0,2750,18698,12625,21448,-5573,277,-2473,0
50221894,FA2022 ,13005,515,3855,2220,19595,0,0,0,3250,17828,13005,21078,-4308,1767,-1483,0
50221894,SP2021 ,12625,500,3740,2110,18975,0,0,0,5250,16197,12625,21447,-3072,2778,-2472,0
50221894,SP2022 ,13005,515,3855,2220,19595,0,0,0,2250,18827,13005,21077,-5307,768,-1482,0
50221930,FA2021 ,12625,500,4580,2110,19815,6250,6250,0,2750,6750,0,9500,6375,13065,10315,-1009.51
50221930,FA2022 ,13005,515,4810,2220,20550,5750,5750,0,3250,5750,0,9000,7770,14800,11550,-1009.51
50221930,FA2023 ,13500,550,4000,1200,19250,5750,5750,0,3750,5750,0,9500,8300,13500,9750,-1009.51
50221930,FA2024 ,14750,600,5240,NULL,20590,5750,5750,0,3750,5750,0,9500,9600,14840,11090,-1009.51
50221930,SP2021 ,12625,500,4580,2110,19815,6250,6250,0,2750,6250,0,9000,6875,13565,10815,-1009.51
50221930,SP2022 ,13005,515,4810,2220,20550,5750,5750,0,3250,5750,0,9000,7770,14800,11550,-1009.51
50221930,SP2023 ,13500,550,4990,2325,21365,5750,5750,0,3750,5750,0,9500,8300,15615,11865,-1009.51
50221930,SP2024 ,8140,600,5240,NULL,13980,3173,3173,0,3750,3173,0,6923,5567,10807,7057,-1009.51
50222307,FA2021 ,12625,500,3740,2550,19415,5500,5500,0,3250,5500,0,8750,7625,13915,10665,0
50222307,FA2022 ,13005,515,4260,2220,20000,5000,5000,0,NULL,5000,0,5000,8520,15000,15000,0
50222307,FA2023 ,13500,550,5800,2535,22385,5000,5000,0,NULL,5000,0,5000,9050,17385,17385,0
50222307,SP2021 ,12625,500,3740,2110,18975,5500,5500,0,3250,5500,0,8750,7625,13475,10225,0
50222307,SP2022 ,13005,515,4260,2220,20000,5000,5000,0,NULL,5000,0,5000,8520,15000,15000,0
50222307,SP2023 ,13500,550,5800,2745,22595,5000,5000,0,NULL,5000,0,5000,9050,17595,17595,0
50225131,FA2022 ,13005,515,4260,2220,20000,6000,6000,0,2750,6764,0,9514,6756,13236,10486,5476.64
50225131,FA2023 ,13500,550,4560,2325,20935,6000,6000,0,3250,6000,0,9250,8050,14935,11685,5476.64
50225131,FA2024 ,14750,600,5720,NULL,21070,6000,6000,0,NULL,6000,0,6000,9350,15070,15070,5476.64
50225131,SP2022 ,13005,515,3855,2220,19595,6000,6000,0,2750,6764,0,9514,6756,12831,10081,5476.64
50225131,SP2023 ,13500,550,4560,2325,20935,6000,6000,0,3250,6000,0,9250,8050,14935,11685,5476.64
50225131,SP2024 ,14750,7250,7250,NULL,22000,6000,6000,0,NULL,6000,0,6000,16000,16000,16000,5476.64
50225133,FA2022 ,13005,515,3855,2220,19595,7750,7750,0,2750,10250,0,13000,3270,9345,6595,-89.17
50225133,FA2023 ,13500,550,5150,2325,21525,7750,7750,0,3250,7750,0,11000,6300,13775,10525,-89.17
50225133,FA2024 ,14750,600,5410,2450,23210,9250,7250,2000,3250,9250,0,12500,6100,13960,10710,-89.17
50225133,SP2022 ,13005,515,3855,2220,19595,7750,7750,0,2750,11250,0,14000,2270,8345,5595,-89.17
50225133,SP2023 ,13500,550,5150,2325,21525,7250,7250,0,3250,8250,0,11500,5800,13275,10025,-89.17
50225133,SP2024 ,14750,7250,7250,NULL,22000,3660,3660,0,3250,3660,0,6910,18340,18340,15090,-89.17
50225454,FA2022 ,13005,515,3855,2220,19595,6000,6000,0,2750,6000,0,8750,7520,13595,10845,5433.32
50225454,FA2023 ,13500,550,4000,2325,20375,6000,6000,0,3250,6000,0,9250,8050,14375,11125,5433.32
50225454,FA2024 ,14750,600,4200,2450,22000,6000,6000,0,3750,6000,0,9750,9350,16000,12250,5433.32
50225454,SP2022 ,13005,515,3855,2220,19595,6000,6000,0,2750,6000,0,8750,7520,13595,10845,5433.32
50225454,SP2023 ,13500,550,4000,2325,20375,6000,6000,0,3250,6000,0,9250,8050,14375,11125,5433.32
50225454,SP2024 ,14750,600,4200,2450,22000,6000,6000,0,3750,6000,0,9750,9350,16000,12250,5433.32
50226777,FA2022 ,13005,515,4810,2220,20550,6500,6500,0,15460,6500,0,21960,7020,14050,-1410,40
50226777,FA2023 ,13500,550,5150,2325,21525,6500,6500,0,16946,6500,0,23446,7550,15025,-1921,40
50226777,FA2024 ,14750,600,5410,2450,23210,6500,5500,1000,18570,6500,0,25070,8850,16710,-1860,40
50226777,SP2022 ,13005,515,4810,2220,20550,6500,6500,0,14190,6500,0,20690,7020,14050,-140,40
50226777,SP2023 ,13500,550,5150,2325,21525,6500,6500,0,13353,6500,0,19853,7550,15025,1672,40
50226777,SP2024 ,14750,600,5410,2450,23210,6500,5500,1000,11083,6500,0,17583,8850,16710,5627,40
50227711,FA2023 ,13500,550,4000,2325,20375,7000,7000,0,2750,7000,0,9750,7050,13375,10625,-4181
50227711,FA2024 ,14750,600,5410,2450,23210,7000,7000,0,3250,13010,0,16260,2340,10200,6950,-4181
50227711,SP2023 ,13500,550,4000,2325,20375,7000,7000,0,2750,7000,0,9750,7050,13375,10625,-4181
50227711,SP2024 ,14750,600,5410,2450,23210,7000,7000,0,3250,13010,0,16260,2340,10200,6950,-4181
50231567,FA2024 ,14750,600,4200,2900,22450,7800,7000,800,2750,11498,0,14248,3852,10952,8202,-4587.09
50231567,SP2024 ,14750,600,5410,2900,23660,7800,7000,800,2750,11497,0,14247,3853,12163,9413,-4587.09
50232133,FA2024 ,14750,600,5410,2450,23210,7000,7000,0,2750,7000,0,9750,8350,16210,13460,706
50232133,SP2024 ,14750,600,5410,2450,23210,7500,7500,0,2750,7500,0,10250,7850,15710,12960,706
50232160,FA2024 ,14750,600,4790,2450,22590,7500,7500,0,2750,7500,0,10250,7850,15090,12340,25
50232160,SP2024 ,14750,600,4790,2450,22590,7500,7500,0,2750,7500,0,10250,7850,15090,12340,25
50235045,FA2024 ,14750,600,4200,1270,20820,11923,11923,0,3750,13151,0,16901,2199,7669,3919,414.66
50235045,SP2024 ,14750,600,4200,1270,20820,11922,11922,0,8890,13149,0,22039,2201,7671,-1219,414.66
50228973,FA2023 ,13500,550,4550,2325,20925,14000,6000,8000,NULL,14000,0,14000,50,6925,6925,0
50228973,SP2022 ,13005,515,3855,2220,19595,14000,9000,5000,NULL,14000,0,14000,-480,5595,5595,0
50228973,SP2023 ,13500,550,4550,2325,20925,14000,6000,8000,NULL,14000,0,14000,50,6925,6925,0
50215278,FA2021 ,12625,500,3740,2110,18975,6425,6425,0,3250,7925,0,11175,5200,11050,7800,0
50215278,FA2022 ,13005,515,4610,1140,19270,6925,6925,0,11250,6925,0,18175,6595,12345,1095,0
50215278,FA2023 ,13500,550,5440,NULL,19490,6425,6425,0,3750,6425,0,10175,7625,13065,9315,0
50215278,SP2021 ,12625,500,3740,2110,18975,6425,6425,0,6750,6425,0,13175,6700,12550,5800,0
50215278,SP2022 ,13005,515,NULL,NULL,13520,6425,6425,0,3750,6425,0,10175,7095,7095,3345,0
50215278,SP2023 ,13500,550,5440,NULL,19490,6425,6425,0,9804,6425,0,16229,7625,13065,3261,0
50221036,FA2021 ,12625,500,4050,2550,19725,6750,6750,0,5000,7750,0,12750,5375,11975,6975,0
50221036,FA2022 ,13005,515,3855,2220,19595,6000,6000,0,3250,9855,0,13105,3665,9740,6490,0
50221036,FA2023 ,13500,550,4000,1200,19250,6000,6000,0,NULL,6000,0,6000,8050,13250,13250,0
50221036,SP2021 ,12625,500,4050,2550,19725,6750,6750,0,5000,6750,0,11750,6375,12975,7975,0
50221036,SP2022 ,13005,515,3855,2220,19595,6000,6000,0,3250,9855,0,13105,3665,9740,6490,0
50221036,SP2023 ,13500,550,4000,1200,19250,6000,6000,0,NULL,6000,0,6000,8050,13250,13250,0
50223045,FA2021 ,12625,500,4580,2110,19815,6500,6500,0,2750,7000,0,9750,6125,12815,10065,0
50218379,FA2021 ,12625,500,4580,2110,19815,5425,0,5425,NULL,6925,0,6925,6200,12890,12890,0
50218379,SP2021 ,13440,500,4580,2110,20630,7425,0,7425,NULL,7425,0,7425,6515,13205,13205,0
50234381,FA2024 ,15000,7500,7500,NULL,22500,0,0,0,NULL,0,0,0,22500,22500,22500,0
50202778,FA2021 ,12625,500,4830,NULL,17955,7000,6000,1000,NULL,8500,0,8500,4625,9455,9455,0
50202778,SP2021 ,1800,NULL,NULL,NULL,1800,2000,0,2000,NULL,2000,0,2000,-200,-200,-200,0
50233694,FA2024 ,14750,600,5410,2450,23210,7000,7000,0,19331,7000,0,26331,8350,16210,-3121,0
50233694,SP2024 ,14750,600,5410,2450,23210,7000,7000,0,16296,7000,0,23296,8350,16210,-86,0
50205569,FA2021 ,12625,6350,6350,NULL,18975,3088,1088,2000,21500,4088,0,25588,14887,14887,-6613,0
50205569,SP2021 ,12625,500,4830,1080,19035,2175,2175,0,13750,2175,0,15925,10950,16860,3110,0
50236523,SP2024 ,14750,600,0,1270,16620,4140,4140,0,4750,7838,0,12588,7512,8782,4032,0
50129056,FA2022 ,3580,515,4810,2220,11125,0,0,0,0,0,0,0,4095,11125,11125,0
50129056,FA2023 ,7450,550,5150,2325,15475,0,0,0,5250,0,0,5250,8000,15475,10225,0
50129056,SP2022 ,7170,515,4810,2220,14715,0,0,0,6250,0,0,6250,7685,14715,8465,0
50129056,SP2023 ,7450,550,5150,2325,15475,0,0,0,5250,0,0,5250,8000,15475,10225,0
50228752,FA2023 ,13500,550,0,NULL,14050,5115,5115,0,2750,6115,0,8865,7935,7935,5185,45
50228752,FA2024 ,14750,600,NULL,NULL,15350,7550,7000,550,3250,8550,0,11800,6800,6800,3550,45
50228752,SP2023 ,13500,550,NULL,NULL,14050,5114,5114,0,2750,5114,0,7864,8936,8936,6186,45
50228752,SP2024 ,14750,600,NULL,NULL,15350,7550,7000,550,3250,7550,0,10800,7800,7800,4550,45
50228616,FA2023 ,13500,550,4560,2325,20935,7000,7000,0,NULL,7000,0,7000,7050,13935,13935,0
50228616,FA2024 ,14750,600,4790,2450,22590,7000,7000,0,NULL,7000,0,7000,8350,15590,15590,0
50228616,SP2023 ,13500,550,4560,2325,20935,7000,7000,0,NULL,7000,0,7000,7050,13935,13935,0
50228616,SP2024 ,14750,600,4790,2450,22590,7000,7000,0,NULL,7000,0,7000,8350,15590,15590,0
50219049,FA2024 ,14750,600,5720,1270,22340,8500,8500,0,NULL,8500,0,8500,6850,13840,13840,0
50219049,SP2024 ,14750,600,5720,1270,22340,8500,8500,0,NULL,8500,0,8500,6850,13840,13840,0
50222503,FA2021 ,12625,500,4580,2110,19815,4850,4850,0,16150,9598,0,25748,3527,10217,-5933,0
50222503,FA2022 ,13005,515,4810,2220,20550,4850,4000,850,16667,8698,0,25365,4822,11852,-4815,0
50222503,FA2023 ,13500,550,5440,1200,20690,4000,4000,0,16165,8098,0,24263,5952,12592,-3573,0
50222503,FA2024 ,14750,600,5030,1270,21650,4000,4000,0,19000,7033,0,26033,8317,14617,-4383,0
50222503,SP2021 ,12625,500,4580,2110,19815,4850,4850,0,9345,9157,0,18502,3968,10658,1313,0
50222503,SP2022 ,13005,515,4810,2220,20550,4850,4000,850,10330,8697,0,19027,4823,11853,1523,0
50222503,SP2023 ,13500,6825,6825,NULL,20325,4000,4000,0,17250,8097,0,25347,12228,12228,-5022,0
50222503,SP2024 ,14750,600,5030,1270,21650,4000,4000,0,16592,7032,0,23624,8318,14618,-1974,0
50224670,FA2022 ,13005,515,3855,2220,19595,5200,5200,0,2750,8223,0,10973,5297,11372,8622,-855
50224670,FA2023 ,13500,550,5150,2325,21525,5200,4500,700,3250,7823,0,11073,6227,13702,10452,-855
50224670,FA2024 ,14750,600,5410,2450,23210,5200,4500,700,3750,6695,0,10445,8655,16515,12765,-855
50224670,SP2022 ,13005,515,3855,2220,19595,5200,5200,0,2750,8222,0,10972,5298,11373,8623,-855
50224670,SP2023 ,13500,550,5150,2325,21525,5200,4500,700,3250,7822,0,11072,6228,13703,10453,-855
50224670,SP2024 ,14750,600,5410,1270,22030,5200,4500,700,3750,6695,0,10445,8655,15335,11585,-855
50216291,FA2021 ,12625,500,4580,2110,19815,7175,7175,0,3250,14948,0,18198,-1823,4867,1617,0
50216291,FA2022 ,13005,515,4810,2220,20550,7175,7175,0,3750,12248,0,15998,1272,8302,4552,0
50216291,FA2023 ,13500,550,4790,NULL,18840,7175,7175,0,3750,13998,0,17748,52,4842,1092,0
50216291,SP2021 ,12625,500,4580,2110,19815,7175,7175,0,3250,12947,0,16197,178,6868,3618,0
50216291,SP2022 ,13005,515,4810,2220,20550,7175,7175,0,3750,12247,0,15997,1273,8303,4553,0
50216291,SP2023 ,13500,550,4790,NULL,18840,7175,7175,0,3750,13997,0,17747,53,4843,1093,0
50225230,FA2022 ,13005,515,4810,2220,20550,7200,7200,0,2750,11123,0,13873,2397,9427,6677,-956
50225230,FA2023 ,13500,550,4790,NULL,18840,7700,7700,0,3250,14123,0,17373,-73,4717,1467,-956
50225230,FA2024 ,14750,600,NULL,NULL,15350,6831,3881,2950,3750,12429,0,16179,2921,2921,-829,-956
50225230,SP2022 ,13005,515,4810,2220,20550,7200,7200,0,2750,11122,0,13872,2398,9428,6678,-956
50225230,SP2023 ,13500,550,4790,NULL,18840,7700,7700,0,3250,14122,0,17372,-72,4718,1468,-956
50225230,SP2024 ,14750,600,NULL,NULL,15350,6830,3880,2950,3750,12427,0,16177,2923,2923,-827,-956
50232454,FA2024 ,14750,600,NULL,NULL,15350,7500,7500,0,NULL,7500,0,7500,7850,7850,7850,0
50232454,SP2024 ,14750,600,NULL,NULL,15350,7500,7500,0,NULL,7500,0,7500,7850,7850,7850,0
50209601,FA2021 ,12625,6350,6350,NULL,18975,2000,2000,0,25750,3500,0,29250,15475,15475,-10275,0
50209601,FA2022 ,13005,515,5080,1140,19740,0,0,0,7750,13005,13005,20755,515,6735,-1015,0
50209601,SP2021 ,12625,500,4050,2110,19285,0,0,0,7850,12625,12625,20475,500,6660,-1190,0
50209601,SP2022 ,13005,515,5080,1140,19740,0,0,0,7950,13005,13005,20955,515,6735,-1215,0
50209181,FA2021 ,12625,6350,6350,NULL,18975,7025,5025,2000,12750,8525,0,21275,10450,10450,-2300,0
50209181,FA2022 ,13005,515,4610,1140,19270,7525,5525,2000,3750,7825,0,11575,5695,11445,7695,0
50209181,SP2021 ,12625,500,3740,2110,18975,5025,5025,0,12750,5025,0,17775,8100,13950,1200,0
50209181,SP2022 ,13005,515,4610,1140,19270,5525,5525,0,3750,5825,0,9575,7695,13445,9695,0
50203238,FA2021 ,12625,6350,6350,NULL,18975,2213,2213,0,3750,6086,0,9836,12889,12889,9139,4768
50203238,SP2021 ,12625,500,4830,1080,19035,7225,5225,2000,3750,9497,0,13247,3628,9538,5788,4768
50221557,FA2021 ,12625,500,3740,2550,19415,9500,0,9500,NULL,9500,0,9500,3625,9915,9915,-241.09
50221557,FA2022 ,13005,515,4810,2220,20550,9500,0,9500,NULL,9500,0,9500,4020,11050,11050,-241.09
50221557,FA2023 ,13500,6825,6825,NULL,20325,9500,6500,3000,NULL,9500,0,9500,10825,10825,10825,-241.09
50221557,FA2024 ,14750,600,5410,2450,23210,9800,0,9800,NULL,9800,0,9800,5550,13410,13410,-241.09
50221557,SP2021 ,12625,500,3740,2110,18975,9500,0,9500,NULL,9500,0,9500,3625,9475,9475,-241.09
50221557,SP2022 ,13005,515,4810,2220,20550,9500,0,9500,NULL,9500,0,9500,4020,11050,11050,-241.09
50221557,SP2023 ,13500,550,4000,2325,20375,9500,0,9500,NULL,9500,0,9500,4550,10875,10875,-241.09
50221557,SP2024 ,14750,600,5410,2450,23210,9800,0,9800,NULL,9800,0,9800,5550,13410,13410,-241.09
50230424,FA2024 ,14750,600,4200,2450,22000,9500,0,9500,NULL,9500,0,9500,5850,12500,12500,-588
50230424,SP2024 ,14750,600,4200,2450,22000,9500,0,9500,NULL,9500,0,9500,5850,12500,12500,-588
50225723,FA2022 ,13005,515,4810,2220,20550,5400,5400,0,19437,5400,0,24837,8120,15150,-4287,-716
50225723,FA2023 ,13500,550,5150,2325,21525,5400,4750,650,18182,5400,0,23582,8650,16125,-2057,-716
50225723,FA2024 ,14750,600,5410,2450,23210,5400,4750,650,18359,9295,0,27654,6055,13915,-4444,-716
50225723,SP2022 ,13005,515,4810,2220,20550,5400,5400,0,19437,5400,0,24837,8120,15150,-4287,-716
50225723,SP2023 ,13500,550,5150,2325,21525,5400,4750,650,18182,5400,0,23582,8650,16125,-2057,-716
50225723,SP2024 ,14750,600,5410,2450,23210,5400,4750,650,15737,9295,0,25032,6055,13915,-1822,-716
50119371,FA2021 ,12625,500,4580,2110,19815,6450,5950,500,0,7450,0,7450,5675,12365,12365,5550
50119371,FA2022 ,13005,515,4810,2220,20550,5950,5450,500,0,5950,0,5950,7570,14600,14600,5550
50119371,FA2023 ,13500,550,5150,2745,21945,5950,5000,950,3750,5950,0,9700,8100,15995,12245,5550
50119371,FA2024 ,14750,600,5030,1270,21650,5500,5000,500,3750,5500,0,9250,9850,16150,12400,5550
50119371,SP2021 ,12625,500,4580,2110,19815,6450,5950,500,0,6450,0,6450,6675,13365,13365,5550
50119371,SP2022 ,13005,515,4810,2690,21020,5950,5450,500,0,5950,0,5950,7570,15070,15070,5550
50119371,SP2023 ,13500,550,5150,2745,21945,5950,5950,0,3750,5950,0,9700,8100,15995,12245,5550
50119371,SP2024 ,14750,600,5030,1270,21650,5500,5000,500,3750,5500,0,9250,9850,16150,12400,5550
50215400,FA2021 ,12625,500,4580,2110,19815,9794,8294,1500,2750,15717,0,18467,-2592,4098,1348,0
50215400,FA2022 ,13005,515,4260,2220,20000,10425,8925,1500,3250,13598,0,16848,-78,6402,3152,0
50215400,FA2023 ,13500,550,4790,1200,20040,11425,8925,2500,3750,14298,0,18048,-248,5742,1992,0
50215400,SP2021 ,12625,500,4580,2110,19815,9565,8065,1500,2750,13487,0,16237,-362,6328,3578,0
50215400,SP2022 ,13005,515,4260,2220,20000,10425,8925,1500,3250,13597,0,16847,-77,6403,3153,0
50215400,SP2023 ,13500,550,4790,1200,20040,11425,8925,2500,3750,14297,0,18047,-247,5743,1993,0
50231872,FA2024 ,14750,600,5410,2450,23210,9450,9450,0,2750,11578,0,14328,3772,11632,8882,-930
50231872,SP2024 ,14750,600,5410,2450,23210,9450,9450,0,2750,12577,0,15327,2773,10633,7883,-930
50213329,FA2021 ,12625,500,4580,2110,19815,8425,8425,0,2250,10925,0,13175,2200,8890,6640,0
50213329,FA2022 ,13005,515,4610,NULL,18130,8425,0,8425,3750,9425,0,13175,4095,8705,4955,0
50213329,FA2023 ,13500,6825,6825,NULL,20325,9100,5600,3500,0,10100,0,10100,10225,10225,10225,0
50213329,SP2021 ,12625,500,4580,1080,18785,8425,8425,0,2250,8425,0,10675,4700,10360,8110,0
50213329,SP2022 ,13005,515,4610,NULL,18130,8425,0,8425,3750,9425,0,13175,4095,8705,4955,0
50213329,SP2023 ,13500,550,4790,NULL,18840,14574,1000,13574,0,15574,0,15574,-1524,3266,3266,0
50204778,FA2021 ,12625,6350,6350,NULL,18975,1175,925,250,3750,2675,0,6425,16300,16300,12550,0
50204778,SP2021 ,12625,500,4830,1080,19035,1175,925,250,3750,1175,0,4925,11950,17860,14110,0
50117791,FA2021 ,12625,6350,6350,NULL,18975,4013,4013,0,0,5513,0,5513,13462,13462,13462,0
50117791,SP2021 ,12625,500,4830,NULL,17955,0,0,0,0,12625,12625,12625,500,5330,5330,0
50228477,FA2023 ,13500,550,5150,2325,21525,9000,8000,1000,NULL,9000,0,9000,5050,12525,12525,-489.3
50228477,FA2024 ,14750,600,4200,2450,22000,9000,8000,1000,NULL,9000,0,9000,6350,13000,13000,-489.3
50228477,SP2023 ,13500,550,5150,2325,21525,9000,8000,1000,NULL,9000,0,9000,5050,12525,12525,-489.3
50228477,SP2024 ,14750,7250,7250,NULL,22000,3150,3150,0,NULL,3150,0,3150,18850,18850,18850,-489.3
50230298,FA2023 ,13500,550,4560,2325,20935,5500,5500,0,2750,5500,0,8250,8550,15435,12685,261.95
50230298,SP2023 ,13500,550,4560,2325,20935,5500,5500,0,2750,5500,0,8250,8550,15435,12685,261.95
50227631,FA2022 ,13005,515,4810,2220,20550,7700,7700,0,7750,7700,0,15450,5820,12850,5100,0
50227631,SP2022 ,13005,515,4810,2220,20550,7700,7700,0,7750,8700,0,16450,4820,11850,4100,0
50227631,SP2023 ,13500,550,5150,2325,21525,7700,7700,0,12834,7700,0,20534,6350,13825,991,0
50214621,FA2021 ,12625,500,4050,2550,19725,8425,8425,0,3250,9925,0,13175,3200,9800,6550,0
50214621,FA2022 ,13005,515,4810,2690,21020,8425,0,8425,3750,8425,0,12175,5095,12595,8845,0
50214621,FA2023 ,13500,550,5440,1200,20690,8425,0,8425,3750,8425,0,12175,5625,12265,8515,0
50214621,SP2021 ,12625,500,4050,2550,19725,8425,8425,0,3250,8425,0,11675,4700,11300,8050,0
50214621,SP2022 ,13005,515,4810,2690,21020,8425,0,8425,3750,8425,0,12175,5095,12595,8845,0
50214621,SP2023 ,13500,550,5440,1200,20690,8425,0,8425,3750,8425,0,12175,5625,12265,8515,0
50231650,FA2024 ,14750,600,5030,2450,22830,7000,7000,0,19310,7000,0,26310,8350,15830,-3480,-22
50231650,SP2024 ,14750,600,5030,2450,22830,7000,7000,0,15462,7000,0,22462,8350,15830,368,-22
50204502,FA2021 ,12625,500,4270,1080,18475,3925,0,3925,NULL,3925,0,3925,9200,14550,14550,0
50204502,SP2021 ,12625,500,4270,1080,18475,3925,0,3925,NULL,3925,0,3925,9200,14550,14550,0
50227187,FA2022 ,13005,515,3855,2220,19595,5800,4800,1000,6750,11898,0,18648,1622,7697,947,3074.96
50227187,FA2023 ,13500,550,4990,2325,21365,5800,4800,1000,7250,12648,0,19898,1402,8717,1467,3074.96
50227187,SP2022 ,13005,515,3855,2220,19595,5800,4800,1000,6750,11897,0,18647,1623,7698,948,3074.96
50227187,SP2023 ,13500,550,4990,2325,21365,5800,4800,1000,7250,12647,0,19897,1403,8718,1468,3074.96
50232895,FA2024 ,14750,600,4200,2680,22230,9000,0,9000,2750,9000,0,11750,6350,13230,10480,0
50232895,SP2024 ,14750,600,4200,2450,22000,9000,0,9000,2750,9000,0,11750,6350,13000,10250,0
50225737,FA2022 ,13005,515,4810,2220,20550,9500,0,9500,2750,12873,0,15623,647,7677,4927,0
50225737,SP2022 ,13005,515,4810,2220,20550,9500,0,9500,2750,12872,0,15622,648,7678,4928,0
50232162,FA2024 ,14750,600,4200,2450,22000,8800,6000,2800,0,12498,0,12498,2852,9502,9502,0
50216082,FA2021 ,12625,500,4050,2110,19285,1825,1825,0,2750,3325,0,6075,9800,15960,13210,0
50216082,FA2023 ,13500,550,4000,2325,20375,2074,787,1287,3750,6074,0,9824,7976,14301,10551,0
50216082,SP2021 ,12625,500,4580,2110,19815,1575,1575,0,2750,1575,0,4325,11550,18240,15490,0
50216082,SP2022 ,13005,515,4810,2220,20550,1575,1575,0,3250,1575,0,4825,11945,18975,15725,0
50216082,SP2023 ,13500,550,4000,2325,20375,2076,788,1288,3750,6076,0,9826,7974,14299,10549,0
50224687,FA2022 ,13005,515,4260,2220,20000,7250,7250,0,2750,7250,0,10000,6270,12750,10000,0
50224687,FA2023 ,13500,550,5150,2325,21525,7250,7250,0,3250,7250,0,10500,6800,14275,11025,0
50224687,FA2024 ,14750,600,5720,1270,22340,7250,7250,0,NULL,7250,0,7250,8100,15090,15090,0
50224687,SP2022 ,13005,515,4260,2220,20000,7250,7250,0,2750,7250,0,10000,6270,12750,10000,0
50224687,SP2023 ,13500,550,5150,2325,21525,7250,7250,0,3250,7250,0,10500,6800,14275,11025,0
50224687,SP2024 ,14750,600,5720,NULL,21070,7250,7250,0,NULL,7250,0,7250,8100,13820,13820,0
50225519,FA2022 ,13005,515,4810,2220,20550,8500,8500,0,15934,8800,0,24734,4720,11750,-4184,0
50225519,FA2023 ,13500,550,5440,NULL,19490,8500,8500,0,12789,8800,0,21589,5250,10690,-2099,0
50225519,FA2024 ,14750,600,5720,NULL,21070,8500,8500,0,8845,10305,0,19150,5045,10765,1920,0
50225519,SP2022 ,13005,515,4810,2220,20550,8500,8500,0,15934,8800,0,24734,4720,11750,-4184,0
50225519,SP2023 ,13500,550,5440,NULL,19490,8500,8500,0,12789,8800,0,21589,5250,10690,-2099,0
50225519,SP2024 ,14750,600,5720,NULL,21070,8500,8500,0,8845,10305,0,19150,5045,10765,1920,0
50213048,FA2021 ,12625,500,4580,2110,19815,2775,0,2775,3750,4275,0,8025,8850,15540,11790,0
50213048,SP2021 ,12625,500,4580,2110,19815,2775,0,2775,3750,2775,0,6525,10350,17040,13290,0
50233484,FA2024 ,14750,600,4200,2450,22000,7700,7150,550,5250,11398,0,16648,3952,10602,5352,3347.83
50233484,SP2024 ,14750,600,4200,2450,22000,7700,7150,550,5250,11397,0,16647,3953,10603,5353,3347.83
50229632,FA2023 ,13500,550,4000,2325,20375,8000,8000,0,10250,10623,0,20873,3427,9752,-498,0
50229632,FA2024 ,14750,600,4200,2450,22000,7700,6500,1200,9250,11698,0,20948,3652,10302,1052,0
50229632,SP2023 ,13500,550,4000,2325,20375,8000,8000,0,10250,10622,0,20872,3428,9753,-497,0
50229632,SP2024 ,14750,600,4200,2450,22000,7700,6500,1200,9250,11697,0,20947,3653,10303,1053,0
50214387,FA2021 ,12625,500,4580,2110,19815,12375,0,12375,3250,13875,0,17125,-750,5940,2690,0
50214387,FA2022 ,13005,515,4800,2220,20540,12875,12875,0,3750,12875,0,16625,645,7665,3915,0
50214387,FA2023 ,13500,550,4990,2325,21365,12375,0,12375,3750,12375,0,16125,1675,8990,5240,0
50214387,SP2021 ,12625,500,4580,2110,19815,12375,0,12375,3250,12375,0,15625,750,7440,4190,0
50214387,SP2022 ,13005,515,4800,2220,20540,12875,12875,0,3750,12875,0,16625,645,7665,3915,0
50214387,SP2023 ,13500,6825,6825,NULL,20325,12375,0,12375,3750,12375,0,16125,7950,7950,4200,0
50229473,FA2023 ,13500,550,4000,2325,20375,7000,7000,0,2750,7000,0,9750,7050,13375,10625,4418
50229473,FA2024 ,14750,600,4790,2450,22590,7000,7000,0,2750,7000,0,9750,8350,15590,12840,4418
50229473,SP2023 ,13500,550,4000,2325,20375,7000,7000,0,2750,7000,0,9750,7050,13375,10625,4418
50229473,SP2024 ,14750,600,4790,2450,22590,7000,7000,0,2750,7000,0,9750,8350,15590,12840,4418
50230524,FA2023 ,7450,550,5150,2325,15475,4829,4829,0,3250,5991,0,9241,2009,9484,6234,0
50230524,FA2024 ,14750,600,5410,2450,23210,8750,7000,1750,0,11663,0,11663,3687,11547,11547,0
50230524,SP2023 ,13500,550,5150,2325,21525,8750,8750,0,3250,11072,0,14322,2978,10453,7203,0
50215415,FA2021 ,12625,500,3740,2110,18975,6675,6675,0,3250,7675,0,10925,5450,11300,8050,0
50215415,FA2022 ,13005,515,5080,1140,19740,6675,6675,0,3750,6675,0,10425,6845,13065,9315,0
50215415,FA2023 ,13500,6825,6825,NULL,20325,1700,1700,0,3750,1700,0,5450,18625,18625,14875,0
50215415,SP2021 ,12625,500,3740,2110,18975,6675,6675,0,3250,6675,0,9925,6450,12300,9050,0
50215415,SP2022 ,13005,515,5080,1140,19740,6675,6675,0,3750,6675,0,10425,6845,13065,9315,0
50229157,FA2023 ,13500,550,4000,2325,20375,9500,0,9500,2750,9500,0,12250,4550,10875,8125,0
50229157,FA2024 ,14750,600,4780,1270,21400,9500,0,9500,NULL,9500,0,9500,5850,11900,11900,0
50229157,SP2023 ,13500,550,4000,2325,20375,9500,0,9500,2750,9500,0,12250,4550,10875,8125,0
50229157,SP2024 ,14750,600,4780,2450,22580,9500,0,9500,NULL,9500,0,9500,5850,13080,13080,0
50231973,SP2023 ,14500,7000,7000,NULL,21500,0,0,0,NULL,0,0,0,21500,21500,21500,0
50209915,FA2021 ,12625,500,4580,2110,19815,5625,5625,0,3750,6625,0,10375,6500,13190,9440,0
50209915,FA2022 ,13005,515,5080,1140,19740,5625,0,5625,3750,5625,0,9375,7895,14115,10365,0
50209915,FA2023 ,13500,550,5440,1200,20690,5625,0,5625,3750,5625,0,9375,8425,15065,11315,0
50209915,SP2021 ,12625,500,4580,2110,19815,5625,5625,0,3750,5625,0,9375,7500,14190,10440,0
50209915,SP2022 ,13005,515,5080,1140,19740,5625,0,5625,3750,5625,0,9375,7895,14115,10365,0
50229652,FA2024 ,14750,600,5240,2900,23490,5500,5500,0,19353,5500,0,24853,9850,17990,-1363,180
50229652,SP2024 ,14750,600,5240,2450,23040,5500,5500,0,17755,5500,0,23255,9850,17540,-215,180
50231518,FA2024 ,14750,600,5410,2450,23210,9000,9000,0,2750,9000,0,11750,6350,14210,11460,4784
50231518,SP2024 ,14750,600,5410,2450,23210,9000,9000,0,2750,9000,0,11750,6350,14210,11460,4784
50209917,FA2021 ,12625,500,4580,2110,19815,3675,3675,0,10038,5175,0,15213,7950,14640,4602,0
50209917,FA2022 ,13005,515,5420,NULL,18940,3675,3675,0,20323,3675,0,23998,9845,15265,-5058,0
50209917,FA2023 ,7450,275,NULL,NULL,7725,1200,1200,0,7406,1200,0,8606,6525,6525,-881,0
50209917,SP2021 ,12625,500,4580,2110,19815,3675,3675,0,6904,3675,0,10579,9450,16140,9236,0
50209917,SP2022 ,13005,515,5420,1140,20080,3675,3675,0,20144,3675,0,23819,9845,16405,-3739,0
50236705,SP2024 ,14750,600,NULL,NULL,15350,4243,3593,650,6250,6945,0,13195,8405,8405,2155,1377
50066267,FA2024 ,4070,NULL,NULL,NULL,4070,0,0,0,NULL,0,0,0,4070,4070,4070,3336.67
50066267,SP2024 ,4070,NULL,NULL,NULL,4070,0,0,0,NULL,0,0,0,4070,4070,4070,3336.67
50119118,FA2021 ,12625,500,4580,2110,19815,3675,3675,0,3250,4675,0,7925,8450,15140,11890,0
50119118,FA2022 ,13005,515,5080,1140,19740,3675,3675,0,NULL,3675,0,3675,9845,16065,16065,0
50119118,FA2023 ,13500,6825,6825,NULL,20325,3675,3675,0,NULL,3675,0,3675,16650,16650,16650,0
50119118,SP2021 ,12625,500,4580,2110,19815,3675,3675,0,3250,3675,0,6925,9450,16140,12890,0
50119118,SP2022 ,13005,515,5080,1140,19740,3675,3675,0,NULL,3675,0,3675,9845,16065,16065,0
50119118,SP2023 ,13500,550,5440,1200,20690,3675,3675,0,NULL,3675,0,3675,10375,17015,17015,0
50227714,FA2023 ,13500,550,4000,2325,20375,4500,0,4500,0,24030,0,24030,-9980,-3655,-3655,0
50227714,FA2024 ,14750,600,4780,2450,22580,9500,0,9500,3250,11000,0,14250,4350,11580,8330,0
50227714,SP2023 ,13500,550,4000,2325,20375,15500,0,15500,2750,15500,0,18250,-1450,4875,2125,0
50227714,SP2024 ,14750,600,4780,2450,22580,9500,0,9500,3250,9500,0,12750,5850,13080,9830,0
50205048,FA2021 ,12625,500,4830,1080,19035,1825,0,1825,15600,2325,0,17925,10800,16710,1110,0
50205048,SP2021 ,12625,500,4830,NULL,17955,1825,0,1825,15600,1825,0,17425,11300,16130,530,0
50232431,FA2024 ,14750,600,5410,2450,23210,7000,7000,0,18413,7000,0,25413,8350,16210,-2203,-1138
50232431,SP2024 ,14750,600,5410,2450,23210,7000,7000,0,18412,7000,0,25412,8350,16210,-2202,-1138
50227751,FA2023 ,13500,550,4000,2325,20375,7500,7500,0,0,7500,0,7500,6550,12875,12875,5010.66
50227751,FA2024 ,14750,600,4200,2450,22000,7500,7500,0,NULL,7500,0,7500,7850,14500,14500,5010.66
50227751,SP2023 ,13500,550,4000,2325,20375,7500,7500,0,0,7500,0,7500,6550,12875,12875,5010.66
50227751,SP2024 ,14750,600,4200,2450,22000,7500,7500,0,NULL,7500,0,7500,7850,14500,14500,5010.66
50203144,FA2021 ,12625,500,3740,NULL,16865,6275,0,6275,9750,7775,0,17525,5350,9090,-660,0
50221971,FA2021 ,12625,500,4580,2110,19815,6000,6000,0,2750,10923,0,13673,2202,8892,6142,0
50221971,FA2022 ,13005,515,4610,1140,19270,6000,6000,0,3750,6000,0,9750,7520,13270,9520,0
50221971,SP2021 ,12625,500,4580,2110,19815,6000,6000,0,2750,9422,0,12172,3703,10393,7643,0
50221971,SP2022 ,13005,515,4610,1140,19270,6000,6000,0,3750,6000,0,9750,7520,13270,9520,0
50221086,FA2021 ,12625,500,3740,2110,18975,7000,7000,0,2750,7000,0,9750,6125,11975,9225,0
50221086,FA2022 ,13005,515,3855,2220,19595,6500,6500,0,3250,6500,0,9750,7020,13095,9845,0
50221086,FA2023 ,13500,550,4000,1200,19250,6500,6000,500,3750,6500,0,10250,7550,12750,9000,0
50221086,FA2024 ,14750,600,5030,NULL,20380,6500,6000,500,3750,6500,0,10250,8850,13880,10130,0
50221086,SP2021 ,12625,500,3740,2110,18975,7000,7000,0,2750,7000,0,9750,6125,11975,9225,0
50221086,SP2022 ,13005,515,3855,2220,19595,6500,6500,0,3250,6500,0,9750,7020,13095,9845,0
50221086,SP2023 ,13500,6825,6825,NULL,20325,6500,6500,0,3750,6500,0,10250,13825,13825,10075,0
50221086,SP2024 ,14750,600,5030,NULL,20380,6500,6000,500,3750,6500,0,10250,8850,13880,10130,0
50205260,FA2021 ,6960,500,4830,0,12290,1420,0,1420,13043,2920,0,15963,4540,9370,-3673,0
50226068,FA2022 ,13005,515,3855,2220,19595,8000,8000,0,10103,9973,0,20076,3547,9622,-481,9231.33
50226068,FA2023 ,13500,550,4000,2325,20375,9500,8950,550,3250,9500,0,12750,4550,10875,7625,9231.33
50226068,FA2024 ,14750,600,4200,1270,20820,9000,6500,2500,11750,9000,0,20750,6350,11820,70,9231.33
50226068,SP2022 ,13005,515,3855,2220,19595,8000,8000,0,10102,9972,0,20074,3548,9623,-479,9231.33
50226068,SP2023 ,13500,550,4000,1200,19250,9500,8950,550,3250,9500,0,12750,4550,9750,6500,9231.33
50226068,SP2024 ,14750,600,4200,1270,20820,9000,6500,2500,3750,9000,0,12750,6350,11820,8070,9231.33
50230218,FA2024 ,14750,600,4200,2450,22000,9450,7000,2450,3250,11263,0,14513,4087,10737,7487,4024.99
50230218,SP2023 ,13500,550,4560,2325,20935,9450,9450,0,2750,9450,0,12200,4600,11485,8735,4024.99
50230218,SP2024 ,14750,600,4200,2450,22000,9450,7000,2450,7250,11262,0,18512,4088,10738,3488,4024.99
50211474,FA2021 ,6960,500,4270,NULL,11730,2936,741,2195,8750,8088,0,16838,-628,3642,-5108,0
50211474,SP2021 ,12625,500,4270,NULL,17395,5325,1345,3980,8750,9717,0,18467,3408,7678,-1072,0
50217199,FA2021 ,19340,860,4600,2110,26050,12250,12250,0,10246,13750,0,23996,6450,12300,2054,0
50217199,FA2022 ,19910,890,5270,2220,27400,12250,12250,0,11750,12250,0,24000,8550,15150,3400,0
50217199,FA2023 ,20670,950,4950,1200,26820,12250,12250,0,17639,12250,0,29889,9370,14570,-3069,0
50217199,SP2021 ,19340,860,4600,2110,26050,12250,12250,0,13691,12250,0,25941,7950,13800,109,0
50217199,SP2022 ,19910,890,5270,2220,27400,12250,12250,0,15750,12250,0,28000,8550,15150,-600,0
50217199,SP2023 ,20670,950,4950,2325,27945,12250,12250,0,14714,12250,0,26964,9370,15695,981,0
50229351,FA2023 ,13500,550,4000,2325,20375,8650,8650,0,14236,8650,0,22886,5400,11725,-2511,0
50229351,FA2024 ,14750,600,5410,2450,23210,8650,6500,2150,16250,8650,0,24900,6700,14560,-1690,0
50229351,SP2023 ,13500,550,4000,2325,20375,8650,8650,0,12147,8650,0,20797,5400,11725,-422,0
50229351,SP2024 ,14750,600,5410,2450,23210,8650,6500,2150,14750,8650,0,23400,6700,14560,-190,0
50213217,FA2021 ,12625,500,4270,NULL,17395,6925,2925,4000,6250,12298,0,18548,827,5097,-1153,0
50213217,SP2021 ,12625,500,4270,NULL,17395,6925,2925,4000,6250,10297,0,16547,2828,7098,848,0
50205447,FA2021 ,12625,500,4830,0,17955,3675,3675,0,NULL,3675,0,3675,9450,14280,14280,3486
50205447,SP2021 ,6960,500,4830,NULL,12290,2026,2026,0,NULL,2026,0,2026,5434,10264,10264,3486
50184763,FA2023 ,3720,NULL,NULL,NULL,3720,0,0,0,NULL,3720,3720,3720,0,0,0,407
50184763,FA2024 ,8140,300,NULL,NULL,8440,0,0,0,NULL,8140,8140,8140,300,300,300,407
50184763,SP2021 ,3470,NULL,NULL,NULL,3470,0,0,0,NULL,3470,3470,3470,0,0,0,407
50184763,SP2022 ,3580,NULL,NULL,NULL,3580,0,0,0,NULL,3580,3580,3580,0,0,0,407
50184763,SP2023 ,7450,275,NULL,NULL,7725,0,0,0,NULL,7450,7450,7450,275,275,275,407
50184763,SP2024 ,8140,300,NULL,NULL,8440,0,0,0,NULL,8140,8140,8140,300,300,300,407
50230823,FA2023 ,13500,550,4000,2325,20375,0,0,0,NULL,13500,13500,13500,550,6875,6875,0
50230823,SP2023 ,13500,550,4000,2325,20375,0,0,0,NULL,13500,13500,13500,550,6875,6875,0
50221511,FA2021 ,12625,500,4580,2110,19815,7500,5500,2000,2750,10000,0,12750,3125,9815,7065,0
50221511,FA2022 ,13005,515,4810,2220,20550,5000,5000,0,NULL,5000,0,5000,8520,15550,15550,0
50221511,FA2023 ,13500,550,5150,2325,21525,5000,5000,0,NULL,5000,0,5000,9050,16525,16525,0
50221511,FA2024 ,14750,600,6090,NULL,21440,5000,5000,0,NULL,5000,0,5000,10350,16440,16440,0
50221511,SP2021 ,12625,500,4580,2110,19815,5500,5500,0,2750,5500,0,8250,7625,14315,11565,0
50221511,SP2022 ,13005,515,4810,2220,20550,5000,5000,0,NULL,5000,0,5000,8520,15550,15550,0
50221511,SP2023 ,13500,550,5150,2325,21525,5000,5000,0,NULL,5000,0,5000,9050,16525,16525,0
50221511,SP2024 ,6090,600,6090,NULL,12780,2064,2064,0,NULL,2064,0,2064,4626,10716,10716,0
50225830,FA2022 ,13005,515,4810,2690,21020,6750,6750,0,2750,6750,0,9500,6770,14270,11520,0
50225830,SP2022 ,13005,515,4810,2690,21020,8750,6750,2000,2750,8750,0,11500,4770,12270,9520,0
50229179,FA2023 ,13500,550,5150,2745,21945,6500,6500,0,2750,6500,0,9250,7550,15445,12695,0
50229179,FA2024 ,14750,600,5410,2450,23210,6500,6500,0,3250,6500,0,9750,8850,16710,13460,0
50229179,SP2023 ,13500,550,5150,2745,21945,6500,6500,0,2750,6500,0,9250,7550,15445,12695,0
50229179,SP2024 ,14750,600,5410,1270,22030,6500,6500,0,3250,6500,0,9750,8850,15530,12280,0
50231290,FA2023 ,7450,550,4990,2325,15315,2759,2759,0,NULL,2759,0,2759,5241,12556,12556,-245
50231290,SP2023 ,13500,550,4000,2325,20375,5000,5000,0,NULL,5000,0,5000,9050,15375,15375,-245
50231299,FA2023 ,13500,550,4560,2325,20935,5000,5000,0,NULL,5000,0,5000,9050,15935,15935,45
50231299,FA2024 ,14750,600,5410,2450,23210,5000,5000,0,NULL,5000,0,5000,10350,18210,18210,45
50231299,SP2023 ,13500,550,4560,2325,20935,5000,5000,0,NULL,5000,0,5000,9050,15935,15935,45
50231299,SP2024 ,8140,600,5410,2450,16600,2759,2759,0,NULL,2759,0,2759,5981,13841,13841,45
50231242,FA2024 ,14750,600,5410,2450,23210,8000,8000,0,2750,8000,0,10750,7350,15210,12460,0
50231242,SP2024 ,14750,600,5410,2450,23210,8000,8000,0,2750,8000,0,10750,7350,15210,12460,0
50225667,FA2022 ,13005,515,3855,2220,19595,9250,9250,0,2750,9250,0,12000,4270,10345,7595,0
50225667,SP2022 ,13005,515,3855,2220,19595,9250,9250,0,2750,9250,0,12000,4270,10345,7595,0
50224766,FA2022 ,13005,515,3855,2690,20065,5500,5500,0,18412,5500,0,23912,8020,14565,-3847,2388.66
50224766,FA2023 ,13500,550,4000,2745,20795,5500,5500,0,13640,9500,0,23140,4550,11295,-2345,2388.66
50224766,FA2024 ,14750,600,4200,2680,22230,5500,5500,0,5750,9700,0,15450,5650,12530,6780,2388.66
50224766,SP2022 ,13005,515,3855,2690,20065,5500,5500,0,15949,5500,0,21449,8020,14565,-1384,2388.66
50224766,SP2023 ,13500,550,4000,2745,20795,5500,5500,0,5250,9500,0,14750,4550,11295,6045,2388.66
50224766,SP2024 ,14750,600,4200,1270,20820,5500,5500,0,5750,9700,0,15450,5650,11120,5370,2388.66
50233343,SP2023 ,13500,550,4000,2325,20375,6150,6150,0,10695,9573,0,20268,4477,10802,107,1521
50234392,FA2024 ,14750,600,4200,1270,20820,10000,8000,2000,NULL,10000,0,10000,5350,10820,10820,5839.99
50234392,SP2024 ,14750,600,4200,NULL,19550,8000,8000,0,NULL,8000,0,8000,7350,11550,11550,5839.99
50228130,FA2023 ,13500,550,5150,2535,21735,7000,7000,0,2750,7000,0,9750,7050,14735,11985,0
50228130,FA2024 ,14750,600,5410,2680,23440,7000,7000,0,NULL,7000,0,7000,8350,16440,16440,0
50228130,SP2023 ,13500,550,5150,2535,21735,7000,7000,0,2750,7000,0,9750,7050,14735,11985,0
50228130,SP2024 ,14750,600,5410,2680,23440,7000,7000,0,NULL,7000,0,7000,8350,16440,16440,0
50215320,FA2021 ,12625,500,3740,2110,18975,5925,5925,0,3250,6925,0,10175,6200,12050,8800,0
50215320,FA2022 ,13005,515,3855,1140,18515,5425,5425,0,3750,5425,0,9175,8095,13090,9340,0
50215320,FA2023 ,13500,550,4790,1200,20040,5925,1000,4925,0,5925,0,5925,8125,14115,14115,0
50215320,SP2021 ,12625,500,3740,2110,18975,5925,5925,0,3250,5925,0,9175,7200,13050,9800,0
50215320,SP2022 ,13005,515,3855,1140,18515,5425,5425,0,3750,5425,0,9175,8095,13090,9340,0
50215320,SP2023 ,13500,550,4790,1200,20040,5925,1000,4925,3750,5925,0,9675,8125,14115,10365,0
50204524,FA2021 ,12625,500,4830,1080,19035,3725,3725,0,15280,5225,0,20505,7900,13810,-1470,0
50204524,SP2021 ,12625,6350,6350,NULL,18975,2050,2050,0,2750,2050,0,4800,16925,16925,14175,0
50211556,FA2021 ,12625,500,NULL,1080,14205,0,0,0,NULL,500,0,500,12625,13705,13705,0
50211556,FA2022 ,13005,515,NULL,NULL,13520,0,0,0,NULL,0,0,0,13520,13520,13520,0
50211556,SP2021 ,12625,500,NULL,NULL,13125,0,0,0,NULL,0,0,0,13125,13125,13125,0
50211556,SP2022 ,13005,515,NULL,NULL,13520,0,0,0,NULL,0,0,0,13520,13520,13520,0
50213608,FA2021 ,12625,500,NULL,NULL,13125,2425,0,2425,6250,9172,0,15422,3953,3953,-2297,0
50213608,SP2021 ,12625,500,NULL,NULL,13125,2425,0,2425,6250,8233,0,14483,4892,4892,-1358,0
50216093,FA2021 ,12625,500,3740,2110,18975,4925,4925,0,3250,5925,0,9175,7200,13050,9800,-100
50216093,FA2022 ,13005,515,4260,2220,20000,4925,4925,0,3750,4925,0,8675,8595,15075,11325,-100
50216093,FA2023 ,13500,550,4560,2325,20935,4925,650,4275,3750,4925,0,8675,9125,16010,12260,-100
50216093,SP2021 ,12625,500,3740,2110,18975,4925,4925,0,3250,4925,0,8175,8200,14050,10800,-100
50216093,SP2022 ,13005,6590,7932,190,21127,4925,4925,0,3750,4925,0,8675,14670,16202,12452,-100
50216093,SP2023 ,13500,550,4560,2325,20935,4925,650,4275,3750,4925,0,8675,9125,16010,12260,-100
50217662,FA2021 ,12625,500,3740,2110,18975,7275,7275,0,3250,8775,0,12025,4350,10200,6950,0
50217662,FA2022 ,13005,515,4810,2220,20550,7275,7275,0,20261,7275,0,27536,6245,13275,-6986,0
50217662,FA2023 ,13500,550,4000,2325,20375,7275,7275,0,13928,7275,0,21203,6775,13100,-828,0
50217662,FA2024 ,14750,600,5240,2680,23270,8275,0,8275,17335,8275,0,25610,7075,14995,-2340,0
50217662,SP2021 ,12625,500,4580,2110,19815,7275,7275,0,3250,7275,0,10525,5850,12540,9290,0
50217662,SP2022 ,13005,515,4810,2220,20550,7275,7275,0,14239,7275,0,21514,6245,13275,-964,0
50217662,SP2023 ,13500,550,4990,2325,21365,7275,7275,0,13350,7275,0,20625,6775,14090,740,0
50217662,SP2024 ,14750,600,5240,2680,23270,8275,0,8275,17295,8275,0,25570,7075,14995,-2300,0
50212264,FA2021 ,12625,500,4580,2550,20255,3675,3675,0,3250,5175,0,8425,7950,15080,11830,0
50212264,FA2022 ,13005,515,3855,2220,19595,3675,3675,0,3750,3675,0,7425,9845,15920,12170,0
50212264,SP2021 ,12625,500,4580,2550,20255,3675,3675,0,3250,3675,0,6925,9450,16580,13330,0
50212264,SP2022 ,13005,515,3855,2220,19595,3675,3675,0,3750,3675,0,7425,9845,15920,12170,0
50206369,FA2021 ,12625,500,3740,2110,18975,925,925,0,NULL,2425,0,2425,10700,16550,16550,0
50206369,SP2021 ,12625,500,3740,2110,18975,925,925,0,NULL,925,0,925,12200,18050,18050,0
50208976,FA2021 ,12625,500,3740,2110,18975,7000,7000,0,NULL,8000,0,8000,5125,10975,10975,12968.95
50208976,FA2022 ,13005,515,3855,2220,19595,6500,6500,0,NULL,6500,0,6500,7020,13095,13095,12968.95
50208976,SP2021 ,12625,500,3740,2110,18975,7000,7000,0,NULL,7000,0,7000,6125,11975,11975,12968.95
50208976,SP2022 ,13005,515,3855,2220,19595,6500,6500,0,NULL,6500,0,6500,7020,13095,13095,12968.95
50218783,FA2021 ,12625,500,3740,2110,18975,6550,4500,2050,4750,11298,0,16048,1827,7677,2927,9465
50218783,SP2021 ,12625,500,3740,2110,18975,6550,4500,2050,4750,10857,0,15607,2268,8118,3368,9465
50226799,FA2022 ,13005,515,4810,2690,21020,6000,6000,0,3250,9448,0,12698,4072,11572,8322,-1988
50226799,FA2023 ,13500,550,5150,2325,21525,6000,6000,0,3750,10098,0,13848,3952,11427,7677,-1988
50226799,FA2024 ,14750,600,5410,2450,23210,6000,6000,0,14810,10098,0,24908,5252,13112,-1698,-1988
50226799,SP2022 ,13005,515,4810,2690,21020,6000,6000,0,3250,9447,0,12697,4073,11573,8323,-1988
50226799,SP2023 ,13500,550,5150,2325,21525,6000,6000,0,3750,10097,0,13847,3953,11428,7678,-1988
50226799,SP2024 ,14750,600,5410,2450,23210,6000,6000,0,14810,10097,0,24907,5253,13113,-1697,-1988
50221450,FA2021 ,12625,500,4580,2550,20255,6500,6500,0,NULL,6500,0,6500,6625,13755,13755,0
50221450,FA2022 ,13005,515,4810,2220,20550,6000,6000,0,NULL,6000,0,6000,7520,14550,14550,0
50221450,FA2023 ,13500,550,5150,2325,21525,6000,6000,0,NULL,6000,0,6000,8050,15525,15525,0
50221450,FA2024 ,14750,600,5410,2450,23210,6000,6000,0,NULL,6000,0,6000,9350,17210,17210,0
50221450,SP2021 ,12625,500,4580,2550,20255,6500,6500,0,NULL,6500,0,6500,6625,13755,13755,0
50221450,SP2022 ,13005,515,4810,2220,20550,6000,6000,0,NULL,6000,0,6000,7520,14550,14550,0
50221450,SP2023 ,13500,550,5150,2325,21525,6000,6000,0,NULL,6000,0,6000,8050,15525,15525,0
50232358,FA2024 ,14750,600,NULL,NULL,15350,9050,9050,0,2750,14563,0,17313,787,787,-1963,0
50232358,SP2024 ,14750,600,NULL,NULL,15350,9050,9050,0,2750,14562,0,17312,788,788,-1962,0
50209708,FA2021 ,12625,500,4050,2110,19285,2525,0,2525,6250,9273,0,15523,3852,10012,3762,0
50209708,FA2022 ,13005,515,3855,2220,19595,2525,0,2525,3434,17773,0,21207,-4253,1822,-1612,0
50209708,SP2021 ,12625,500,4050,2110,19285,2525,0,2525,6250,8332,0,14582,4793,10953,4703,0
50209708,SP2022 ,13005,515,3855,2220,19595,2525,0,2525,6250,7772,0,14022,5748,11823,5573,0
50224767,FA2022 ,13005,515,3855,2220,19595,0,0,0,2750,13378,13005,16128,142,6217,3467,1337
50224767,FA2023 ,13500,550,4000,2325,20375,0,0,0,3250,13500,13500,16750,550,6875,3625,1337
50224767,SP2022 ,13005,515,3855,2220,19595,0,0,0,2750,15377,13005,18127,-1857,4218,1468,1337
50225869,FA2024 ,14750,600,4200,2900,22450,7000,7000,0,3250,10698,0,13948,4652,11752,8502,1995.33
50225869,SP2024 ,14750,600,4200,2900,22450,7000,7000,0,3250,10697,0,13947,4653,11753,8503,1995.33
50231763,FA2024 ,14750,600,4790,2450,22590,8500,8500,0,2750,8500,0,11250,6850,14090,11340,0
50231763,SP2024 ,14750,600,4790,2450,22590,8500,8500,0,2750,8500,0,11250,6850,14090,11340,0
50222631,FA2021 ,12625,500,4580,2110,19815,8000,6500,1500,0,8000,0,8000,5125,11815,11815,0
50226518,FA2022 ,13005,515,3855,2220,19595,8150,8150,0,10381,11598,0,21979,1922,7997,-2384,-1323.75
50226518,FA2023 ,13500,550,4000,2325,20375,7650,6500,1150,11081,12247,0,23328,1803,8128,-2953,-1323.75
50226518,FA2024 ,14750,600,4200,2450,22000,9370,6500,2870,10250,13468,0,23718,1882,8532,-1718,-1323.75
50226518,SP2022 ,13005,515,3855,2220,19595,8150,8150,0,10382,11597,0,21979,1923,7998,-2384,-1323.75
50226518,SP2023 ,13500,550,4000,2325,20375,7650,6500,1150,11081,12248,0,23329,1802,8127,-2954,-1323.75
50226518,SP2024 ,14750,600,4200,2450,22000,8150,6500,1650,10250,12248,0,22498,3102,9752,-498,-1323.75
50209142,FA2021 ,12625,500,4270,1080,18475,8725,8725,0,3750,10225,0,13975,2900,8250,4500,0
50209142,SP2021 ,12625,500,4270,NULL,17395,8725,8725,0,3750,8725,0,12475,4400,8670,4920,0
50185286,FA2023 ,7450,275,NULL,NULL,7725,3008,3008,0,6250,3008,0,9258,4717,4717,-1533,-20
50185286,FA2024 ,8140,300,NULL,NULL,8440,0,0,0,6250,8140,8140,14390,300,300,-5950,-20
50185286,SP2023 ,7450,275,NULL,NULL,7725,3008,3008,0,6250,3008,0,9258,4717,4717,-1533,-20
50185286,SP2024 ,8140,300,NULL,NULL,8440,0,0,0,6250,8140,8140,14390,300,300,-5950,-20
50214494,FA2021 ,12625,500,3740,2110,18975,3425,3425,0,NULL,3425,0,3425,9700,15550,15550,0
50214494,FA2022 ,13005,6590,6590,NULL,19595,2925,2925,0,NULL,2925,0,2925,16670,16670,16670,0
50214494,FA2023 ,13500,550,5440,1200,20690,3175,3175,0,NULL,3175,0,3175,10875,17515,17515,0
50214494,SP2021 ,12625,500,3740,2110,18975,3425,3425,0,NULL,3425,0,3425,9700,15550,15550,0
50214494,SP2022 ,13005,515,3855,2220,19595,3425,3425,0,NULL,3425,0,3425,10095,16170,16170,0
50214494,SP2023 ,13500,550,5440,1200,20690,3175,3175,0,NULL,3175,0,3175,10875,17515,17515,0
50221350,FA2021 ,12625,500,4580,2110,19815,6500,6500,0,1568,7500,0,9068,5625,12315,10747,0
50221350,FA2022 ,13005,515,3855,1140,18515,6000,6000,0,1082,6000,0,7082,7520,12515,11433,0
50221350,FA2023 ,13500,550,4000,1200,19250,6000,6000,0,3750,6000,0,9750,8050,13250,9500,0
50221350,FA2024 ,14750,600,4200,1270,20820,6000,6000,0,13221,6000,0,19221,9350,14820,1599,0
50221350,SP2021 ,12625,500,3740,1080,17945,6500,6500,0,11932,6500,0,18432,6625,11445,-487,0
50221350,SP2022 ,13005,515,3855,1140,18515,6000,6000,0,3250,6000,0,9250,7520,12515,9265,0
50221350,SP2023 ,13500,550,4000,1200,19250,6000,6000,0,3750,6000,0,9750,8050,13250,9500,0
50228783,FA2023 ,13500,550,4000,2325,20375,9000,9000,0,2750,9600,0,12350,4450,10775,8025,-147
50228783,FA2024 ,14750,600,4200,2450,22000,9000,2000,7000,3250,12698,0,15948,2652,9302,6052,-147
50228783,SP2023 ,13500,550,4000,2325,20375,9000,9000,0,2750,9600,0,12350,4450,10775,8025,-147
50228783,SP2024 ,14750,600,4200,2450,22000,9000,2000,7000,3250,12697,0,15947,2653,9303,6053,-147
50204205,FA2021 ,12625,500,5160,0,18285,0,0,0,NULL,12625,12625,12625,500,5660,5660,0
50204205,SP2021 ,12625,500,5160,NULL,18285,0,0,0,NULL,12625,12625,12625,500,5660,5660,0
50232841,SP2024 ,14750,600,4790,2450,22590,10100,10100,0,2750,10100,0,12850,5250,12490,9740,30
50225639,FA2022 ,13005,515,3855,2220,19595,7050,7050,0,10822,7050,0,17872,6470,12545,1723,0
50225639,FA2023 ,13500,550,5150,2325,21525,7050,5500,1550,11603,7050,0,18653,7000,14475,2872,0
50225639,FA2024 ,14750,600,5410,2450,23210,7050,5500,1550,17261,7050,0,24311,8300,16160,-1101,0
50225639,SP2022 ,13005,515,3855,2220,19595,7050,7050,0,9636,7050,0,16686,6470,12545,2909,0
50225639,SP2023 ,13500,550,5150,2325,21525,7050,5500,1550,13250,7050,0,20300,7000,14475,1225,0
50225639,SP2024 ,14750,600,5410,2450,23210,7050,5500,1550,14702,7050,0,21752,8300,16160,1458,0
50203641,FA2021 ,6960,250,NULL,NULL,7210,0,0,0,0,1000,0,1000,6210,6210,6210,0
50203641,SP2021 ,1800,NULL,NULL,NULL,1800,0,0,0,0,0,0,0,1800,1800,1800,0
50119123,FA2021 ,12625,500,4580,2110,19815,5500,5500,0,2750,6500,0,9250,6625,13315,10565,0
50119123,FA2022 ,13005,515,4810,2220,20550,5000,5000,0,3250,5000,0,8250,8520,15550,12300,0
50119123,FA2023 ,13500,550,5150,2325,21525,5000,5000,0,3750,5000,0,8750,9050,16525,12775,0
50119123,SP2021 ,12625,500,4580,2110,19815,5500,5500,0,2750,6135,0,8885,6990,13680,10930,0
50119123,SP2022 ,13005,515,4810,2220,20550,5000,5000,0,3250,5000,0,8250,8520,15550,12300,0
50119123,SP2023 ,13500,550,5150,2325,21525,5000,5000,0,3750,5000,0,8750,9050,16525,12775,0
50120193,FA2024 ,14750,600,5410,2450,23210,6500,6500,0,2750,6500,0,9250,8850,16710,13960,3497
50120193,SP2024 ,14750,600,5410,2450,23210,6500,6500,0,2750,6500,0,9250,8850,16710,13960,3497
50233630,FA2024 ,14750,600,4200,2450,22000,11450,11450,0,12220,12450,0,24670,2900,9550,-2670,-697
50233630,SP2024 ,14750,600,4200,2450,22000,11450,11450,0,9930,12450,0,22380,2900,9550,-380,-697
50205800,FA2022 ,13005,515,5080,1140,19740,12925,5425,7500,NULL,12925,0,12925,595,6815,6815,0
50205800,SP2021 ,12625,500,4580,2110,19815,10425,5425,5000,NULL,10425,0,10425,2700,9390,9390,0
50205800,SP2022 ,13005,515,5080,1140,19740,7925,5425,2500,NULL,7925,0,7925,5595,11815,11815,0
50212347,FA2021 ,12625,500,4580,2110,19815,5756,5756,0,6250,15984,0,22234,-2859,3831,-2419,0
50212347,FA2022 ,13005,515,4810,2220,20550,8116,7366,750,5235,17249,0,22484,-3729,3301,-1934,0
50212347,SP2021 ,12625,500,4580,2110,19815,5682,5682,0,6250,14969,0,21219,-1844,4846,-1404,0
50212347,SP2022 ,13005,515,4810,2220,20550,8178,7428,750,5336,17310,0,22646,-3790,3240,-2096,0
50203399,FA2021 ,12625,500,5160,1080,19365,6425,5925,500,NULL,7425,0,7425,5700,11940,11940,0
50203399,SP2021 ,6960,500,5160,1080,13700,4332,4194,138,NULL,4332,0,4332,3128,9368,9368,0
50214795,FA2021 ,12625,500,4050,2110,19285,4175,4175,0,NULL,4675,0,4675,8450,14610,14610,0
50214795,FA2022 ,13005,515,5420,160.6,19100.6,4175,0,4175,NULL,6102,0,6102,7418,12998.6,12998.6,0
50214795,FA2023 ,13500,550,5800,NULL,19850,4175,0,4175,NULL,6175,0,6175,7875,13675,13675,0
50214795,SP2021 ,12625,500,4050,2110,19285,4175,4175,0,NULL,4175,0,4175,8950,15110,15110,0
50214795,SP2022 ,13005,515,5420,NULL,18940,4175,0,4175,NULL,6103,0,6103,7417,12837,12837,0
50214795,SP2023 ,7450,550,5800,NULL,13800,2304,0,2304,NULL,4304,0,4304,3696,9496,9496,0
50216292,FA2021 ,12625,500,4050,2110,19285,3925,3925,0,3250,4925,0,8175,8200,14360,11110,0
50216292,FA2022 ,13005,515,NULL,NULL,13520,2425,0,2425,3750,2425,0,6175,11095,11095,7345,0
50216292,FA2023 ,13500,550,NULL,NULL,14050,2425,0,2425,3750,2425,0,6175,11625,11625,7875,0
50216292,SP2021 ,12625,500,NULL,NULL,13125,2425,2425,0,3250,2425,0,5675,10700,10700,7450,0
50216292,SP2022 ,13005,515,NULL,NULL,13520,2425,0,2425,3750,2425,0,6175,11095,11095,7345,0
50216292,SP2023 ,13500,550,NULL,NULL,14050,2425,0,2425,3750,2425,0,6175,11625,11625,7875,0
50230591,FA2023 ,13500,550,4000,2325,20375,10050,8050,2000,2750,10050,0,12800,4000,10325,7575,0
50230591,SP2023 ,13500,550,4790,NULL,18840,8050,8050,0,12750,8050,0,20800,6000,10790,-1960,0
50203743,FA2021 ,12625,6350,6350,NULL,18975,8425,8425,0,3750,13448,0,17198,5527,5527,1777,0
50203743,SP2021 ,12625,500,5160,1080,19365,6625,6625,0,3750,11447,0,15197,1678,7918,4168,0
50229223,FA2023 ,13500,550,4000,2325,20375,5500,5000,500,NULL,5500,0,5500,8550,14875,14875,0
50229223,FA2024 ,14750,600,4200,NULL,19550,5500,4500,1000,NULL,5500,0,5500,9850,14050,14050,0
50229223,SP2022 ,13005,515,3855,2220,19595,5000,5000,0,NULL,5000,0,5000,8520,14595,14595,0
50229223,SP2023 ,13500,550,4000,2325,20375,5500,5000,500,NULL,5500,0,5500,8550,14875,14875,0
50228434,FA2023 ,13500,550,5150,2745,21945,6500,6500,0,2750,6500,0,9250,7550,15445,12695,0
50228434,FA2024 ,14750,600,4790,2450,22590,6500,6500,0,3250,6500,0,9750,8850,16090,12840,0
50228434,SP2023 ,13500,550,5150,2325,21525,6500,6500,0,2750,6500,0,9250,7550,15025,12275,0
50228434,SP2024 ,14750,600,4790,2450,22590,6500,6500,0,3250,6500,0,9750,8850,16090,12840,0
50202915,FA2021 ,12625,500,4830,0,17955,0,0,0,3750,1000,0,4750,12125,16955,13205,0
50202915,SP2021 ,12625,500,4830,NULL,17955,0,0,0,3750,0,0,3750,13125,17955,14205,0
50233731,FA2024 ,14750,600,4200,2450,22000,9400,9400,0,0,9900,0,9900,5450,12100,12100,4293.32
50233731,SP2024 ,14750,600,4200,2450,22000,9400,9400,0,2750,9400,0,12150,5950,12600,9850,4293.32
50234161,FA2024 ,14750,600,4200,2450,22000,7600,7600,0,2750,12798,0,15548,2552,9202,6452,0
50224963,FA2022 ,13005,515,4810,2220,20550,6500,6500,0,2750,6500,0,9250,7020,14050,11300,3465.83
50224963,FA2023 ,13500,550,5150,2325,21525,6500,6500,0,3250,6500,0,9750,7550,15025,11775,3465.83
50224963,FA2024 ,14750,600,5720,NULL,21070,6500,6500,0,3750,6500,0,10250,8850,14570,10820,3465.83
50224963,SP2022 ,13005,515,4810,2220,20550,6500,6500,0,2750,6500,0,9250,7020,14050,11300,3465.83
50224963,SP2023 ,13500,550,5150,2325,21525,6500,6500,0,3250,6500,0,9750,7550,15025,11775,3465.83
50224963,SP2024 ,14750,600,NULL,NULL,15350,4485,4485,0,3750,4485,0,8235,10865,10865,7115,3465.83
50203194,FA2021 ,12625,500,4050,2110,19285,4975,4975,0,3750,14148,0,17898,-1023,5137,1387,0
50203194,SP2021 ,6960,500,4050,1080,12590,2767,2767,0,3750,9330,0,13080,-1870,3260,-490,0
50203868,FA2021 ,12625,500,4270,1080,18475,6775,4775,2000,3750,12547,0,16297,578,5928,2178,0
50203868,SP2021 ,12625,500,4270,NULL,17395,4775,4775,0,3750,8548,0,12298,4577,8847,5097,0
50217018,FA2021 ,12625,500,3740,2110,18975,5925,5925,0,2750,7425,0,10175,5700,11550,8800,7422.66
50217018,FA2022 ,13005,515,4260,2220,20000,5925,5925,0,3250,5925,0,9175,7595,14075,10825,7422.66
50217018,FA2023 ,13500,550,5440,NULL,19490,5925,4360,1565,3750,5925,0,9675,8125,13565,9815,7422.66
50217018,FA2024 ,14750,600,NULL,NULL,15350,4088,0,4088,3750,4088,0,7838,11262,11262,7512,7422.66
50217018,SP2021 ,12625,500,3740,2110,18975,5925,5925,0,2750,5925,0,8675,7200,13050,10300,7422.66
50217018,SP2022 ,13005,515,4260,2220,20000,5925,5925,0,3250,5925,0,9175,7595,14075,10825,7422.66
50217018,SP2023 ,13500,550,5800,NULL,19850,5925,4360,1565,3750,5925,0,9675,8125,13925,10175,7422.66
50230910,FA2024 ,14750,600,5410,2450,23210,8000,8000,0,NULL,8000,0,8000,7350,15210,15210,7825.74
50230910,SP2023 ,13500,550,5150,2325,21525,8000,8000,0,NULL,8000,0,8000,6050,13525,13525,7825.74
50230910,SP2024 ,14750,600,5410,2450,23210,8000,8000,0,NULL,8000,0,8000,7350,15210,15210,7825.74
50235933,SP2024 ,15000,7500,7500,NULL,22500,0,0,0,NULL,0,0,0,22500,22500,22500,0
50220913,FA2021 ,12625,500,4650,2110,19885,7750,7750,0,12750,9050,0,21800,4075,10835,-1915,-1170
50220913,FA2022 ,13005,515,3855,2690,20065,7250,7250,0,3250,7250,0,10500,6270,12815,9565,-1170
50220913,FA2023 ,13500,550,NULL,NULL,14050,5003,5003,0,3750,5003,0,8753,9047,9047,5297,-1170
50220913,SP2021 ,12625,500,4650,2110,19885,7750,7750,0,12750,7750,0,20500,5375,12135,-615,-1170
50220913,SP2022 ,13005,515,3855,2690,20065,7250,7250,0,3250,7250,0,10500,6270,12815,9565,-1170
50220913,SP2023 ,13500,550,NULL,NULL,14050,5002,5002,0,3750,5002,0,8752,9048,9048,5298,-1170
50225606,FA2022 ,13005,515,4810,2690,21020,7000,7000,0,2750,7000,0,9750,6520,14020,11270,220
50225606,FA2023 ,13500,550,5150,2325,21525,7000,7000,0,3250,12150,0,15400,1900,9375,6125,220
50225606,FA2024 ,14750,600,5410,2450,23210,7500,7000,500,3750,12910,0,16660,2440,10300,6550,220
50225606,SP2022 ,13005,515,4810,2690,21020,7000,7000,0,2750,12291,0,15041,1229,8729,5979,220
50225606,SP2023 ,13500,550,5150,2325,21525,7000,7000,0,3250,12150,0,15400,1900,9375,6125,220
50225606,SP2024 ,14750,600,5410,2450,23210,7500,7000,500,3750,12910,0,16660,2440,10300,6550,220
50225616,FA2022 ,13005,515,3855,2220,19595,9000,9000,0,12182,9000,0,21182,4520,10595,-1587,0
50225616,FA2023 ,13500,550,5150,2325,21525,9000,9000,0,13250,9000,0,22250,5050,12525,-725,0
50225616,FA2024 ,14750,600,5720,NULL,21070,9000,9000,0,13850,9000,0,22850,6350,12070,-1780,0
50225616,SP2022 ,13005,515,3855,2220,19595,9000,9000,0,11139,9000,0,20139,4520,10595,-544,0
50225616,SP2023 ,13500,550,5150,1200,20400,9000,9000,0,13250,9000,0,22250,5050,11400,-1850,0
50225616,SP2024 ,14750,600,5720,NULL,21070,9000,9000,0,13850,9000,0,22850,6350,12070,-1780,0
50225456,FA2022 ,13005,515,3855,2220,19595,10000,9000,1000,2750,15673,0,18423,-2153,3922,1172,3749.69
50225456,FA2023 ,13500,550,4560,2325,20935,9000,9000,0,3250,14597,0,17847,-547,6338,3088,3749.69
50225456,FA2024 ,14750,600,5720,1270,22340,9000,9000,0,3750,14598,0,18348,752,7742,3992,3749.69
50225456,SP2022 ,13005,515,3855,2220,19595,9000,9000,0,2750,13672,0,16422,-152,5923,3173,3749.69
50225456,SP2023 ,13500,550,4560,2325,20935,9000,9000,0,3250,14598,0,17848,-548,6337,3087,3749.69
50225456,SP2024 ,14750,600,5720,1270,22340,9000,9000,0,3750,14597,0,18347,753,7743,3993,3749.69
50225900,FA2022 ,13005,515,3855,2220,19595,7750,6750,1000,2750,14623,0,17373,-1103,4972,2222,0
50225900,FA2023 ,13500,550,NULL,NULL,14050,6658,4658,2000,3250,13506,0,16756,544,544,-2706,0
50229527,FA2023 ,13500,550,NULL,NULL,14050,5865,5865,0,NULL,10115,0,10115,3935,3935,3935,2328.32
50229527,FA2024 ,14750,600,NULL,NULL,15350,7365,5240,2125,NULL,7365,0,7365,7985,7985,7985,2328.32
50229527,SP2023 ,13500,550,NULL,NULL,14050,5865,5865,0,NULL,8865,0,8865,5185,5185,5185,2328.32
50229527,SP2024 ,14750,600,NULL,NULL,15350,7365,5240,2125,NULL,7365,0,7365,7985,7985,7985,2328.32
50232620,SP2024 ,14750,600,5410,2450,23210,6500,6500,0,2750,6500,0,9250,8850,16710,13960,0
50210672,FA2021 ,12625,500,3740,1080,17945,7425,7425,0,3750,8425,0,12175,4700,9520,5770,0
50210672,FA2022 ,13005,515,3855,1140,18515,7425,7425,0,3750,7425,0,11175,6095,11090,7340,0
50210672,FA2023 ,13500,550,4000,1200,19250,0,0,0,NULL,0,0,0,14050,19250,19250,0
50210672,SP2021 ,12625,500,3740,1080,17945,7425,7425,0,3750,7425,0,11175,5700,10520,6770,0
50210672,SP2022 ,13005,515,3855,1140,18515,7425,7425,0,3750,7425,0,11175,6095,11090,7340,0
50216227,FA2021 ,12625,500,3740,2110,18975,7575,3825,3750,5250,14948,0,20198,-1823,4027,-1223,3301
50216227,FA2022 ,13005,515,4810,2220,20550,7075,3325,3750,3750,12698,0,16448,822,7852,4102,3301
50216227,FA2023 ,7450,275,NULL,NULL,7725,2599,0,2599,3750,4955,0,8705,2770,2770,-980,3301
50216227,SP2021 ,12625,500,3740,2110,18975,7575,3825,3750,5250,12947,0,18197,178,6028,778,3301
50216227,SP2022 ,13005,515,NULL,NULL,13520,5575,1825,3750,3750,11197,0,14947,2323,2323,-1427,3301
50216227,SP2023 ,13500,6825,6825,NULL,20325,8325,8325,0,5750,11748,0,17498,8577,8577,2827,3301
50226359,FA2022 ,13005,515,4260,2220,20000,7350,7350,0,0,9923,0,9923,3597,10077,10077,0
50225499,FA2022 ,13005,515,NULL,NULL,13520,3477,3477,0,2750,6450,0,9200,7070,7070,4320,0
50225499,FA2023 ,13500,550,5150,2325,21525,5600,5600,0,14750,9023,0,23773,5027,12502,-2248,0
50225499,FA2024 ,14750,600,5720,1270,22340,6850,5250,1600,18331,6850,0,25181,8500,15490,-2841,0
50225499,SP2022 ,13005,515,4810,2220,20550,5600,5600,0,15050,8572,0,23622,4948,11978,-3072,0
50225499,SP2023 ,13500,550,5150,2325,21525,5600,5600,0,15144,9022,0,24166,5028,12503,-2641,0
50225499,SP2024 ,14750,600,5720,NULL,21070,6850,5250,1600,13197,6850,0,20047,8500,14220,1023,0
50226498,FA2022 ,13005,515,4810,2690,21020,7250,7250,0,NULL,7250,0,7250,6270,13770,13770,0
50226498,SP2022 ,13005,515,4810,2220,20550,7250,7250,0,NULL,7250,0,7250,6270,13300,13300,0
50221087,FA2021 ,12625,500,4580,2110,19815,6250,6250,0,2750,6250,0,9000,6875,13565,10815,0
50221087,FA2022 ,13005,515,3855,2220,19595,5500,5500,0,0,19415,0,19415,-5895,180,180,0
50221087,SP2021 ,12625,500,4580,2110,19815,6250,6250,0,2750,6250,0,9000,6875,13565,10815,0
50221087,SP2022 ,13005,515,3855,2220,19595,5500,5500,0,0,19695,0,19695,-6175,-100,-100,0
50200099,FA2021 ,12625,500,4650,2110,19885,0,0,0,2000,1000,0,3000,12125,18885,16885,0
50200099,SP2021 ,12625,500,4650,2110,19885,0,0,0,2000,0,0,2000,13125,19885,17885,0
50203476,FA2021 ,12625,500,NULL,NULL,13125,425,0,425,3750,1925,0,5675,11200,11200,7450,0
50203476,SP2021 ,12625,500,NULL,NULL,13125,425,0,425,3750,425,0,4175,12700,12700,8950,0
50204074,FA2021 ,12625,500,4580,2550,20255,4425,4425,0,15950,5925,0,21875,7200,14330,-1620,0
50204074,SP2021 ,12625,500,4580,2110,19815,4425,4425,0,15950,4425,0,20375,8700,15390,-560,0
50224450,FA2022 ,13005,515,3855,2220,19595,10500,9000,1500,NULL,10500,0,10500,3020,9095,9095,0
50224450,FA2023 ,13500,550,4000,2325,20375,10500,6650,3850,NULL,10500,0,10500,3550,9875,9875,0
50224450,FA2024 ,14750,600,4200,2450,22000,10500,6650,3850,NULL,10500,0,10500,4850,11500,11500,0
50224450,SP2022 ,13005,515,3855,2220,19595,10500,9000,1500,NULL,10500,0,10500,3020,9095,9095,0
50224450,SP2023 ,13500,550,4000,2325,20375,10500,6650,3850,NULL,10500,0,10500,3550,9875,9875,0
50224450,SP2024 ,14750,600,4200,2450,22000,10500,6650,3850,NULL,10500,0,10500,4850,11500,11500,0
50222761,FA2021 ,12625,500,3740,2110,18975,7500,7500,0,2750,8500,0,11250,4625,10475,7725,0
50222761,FA2022 ,13005,515,5080,1140,19740,7000,7000,0,3250,8500,0,11750,5020,11240,7990,0
50222761,FA2023 ,13500,550,4790,NULL,18840,6000,6000,0,3750,8000,0,11750,6050,10840,7090,0
50222761,FA2024 ,14750,600,5030,NULL,20380,7000,0,7000,3750,10698,0,14448,4652,9682,5932,0
50222761,SP2021 ,12625,500,3740,2110,18975,6500,6500,0,2750,7500,0,10250,5625,11475,8725,0
50222761,SP2022 ,13005,6590,6590,NULL,19595,5400,5400,0,0,6900,0,6900,12695,12695,12695,0
50222761,SP2023 ,13500,550,4790,NULL,18840,6000,6000,0,3750,8000,0,11750,6050,10840,7090,0
50204640,SP2021 ,12625,500,4270,1080,18475,5375,5375,0,3750,6125,0,9875,7000,12350,8600,0
50203391,FA2021 ,6960,500,4270,NULL,11730,786,786,0,NULL,786,0,786,6674,10944,10944,0
50228582,FA2023 ,13500,550,5150,2325,21525,9000,9000,0,NULL,9000,0,9000,5050,12525,12525,255
50228582,FA2024 ,14750,600,5410,2450,23210,9000,9000,0,NULL,9000,0,9000,6350,14210,14210,255
50228582,SP2023 ,13500,550,5150,2325,21525,9000,9000,0,NULL,9000,0,9000,5050,12525,12525,255
50228582,SP2024 ,14750,600,5410,2450,23210,9000,9000,0,NULL,9000,0,9000,6350,14210,14210,255
50221351,FA2021 ,12625,500,4580,2110,19815,2925,2925,0,16936,4425,0,21361,8700,15390,-1546,0
50221351,FA2022 ,13005,515,5080,1140,19740,2925,0,2925,16880,2925,0,19805,10595,16815,-65,0
50221351,SP2021 ,12625,500,4580,2110,19815,2925,2925,0,16936,2925,0,19861,10200,16890,-46,0
50221351,SP2022 ,13005,515,5080,1140,19740,2925,0,2925,16880,2925,0,19805,10595,16815,-65,0
50211003,FA2021 ,12625,500,NULL,NULL,13125,925,150,775,13750,2425,0,16175,10700,10700,-3050,0
50211003,FA2022 ,13005,515,3855,1140,18515,2425,2425,0,16801,2425,0,19226,11095,16090,-711,0
50211003,SP2021 ,12625,500,NULL,1080,14205,925,150,775,13750,925,0,14675,12200,13280,-470,0
50211003,SP2022 ,13005,515,3855,2220,19595,2425,2425,0,16802,2425,0,19227,11095,17170,368,0
50211457,FA2021 ,12625,500,NULL,NULL,13125,7925,5425,2500,NULL,9425,0,9425,3700,3700,3700,0
50211457,FA2022 ,13005,515,0,1140,14660,5425,5425,0,NULL,6425,0,6425,7095,8235,8235,0
50211457,FA2023 ,3720,NULL,NULL,NULL,3720,1495,1495,0,NULL,1495,0,1495,2225,2225,2225,0
50211457,SP2021 ,12625,500,3740,NULL,16865,7925,5425,2500,NULL,7925,0,7925,5200,8940,8940,0
50211457,SP2022 ,3580,NULL,NULL,1140,4720,0,0,0,NULL,0,0,0,3580,4720,4720,0
50211457,SP2023 ,3720,NULL,NULL,1200,4920,2495,1495,1000,NULL,3495,0,3495,225,1425,1425,0
50221339,FA2021 ,12625,500,3740,2550,19415,8000,8000,0,NULL,9000,0,9000,4125,10415,10415,3471.66
50221339,FA2022 ,13005,515,4810,2690,21020,7500,7500,0,NULL,7500,0,7500,6020,13520,13520,3471.66
50221339,FA2023 ,13500,550,5150,2745,21945,7500,7500,0,NULL,7500,0,7500,6550,14445,14445,3471.66
50221339,FA2024 ,14750,600,NULL,NULL,15350,4675,4675,0,NULL,4675,0,4675,10675,10675,10675,3471.66
50221339,SP2021 ,12625,500,3740,2550,19415,8000,8000,0,NULL,8000,0,8000,5125,11415,11415,3471.66
50221339,SP2022 ,13005,515,4810,2690,21020,7500,7500,0,NULL,7500,0,7500,6020,13520,13520,3471.66
50221339,SP2023 ,13500,550,5150,2745,21945,7500,7500,0,NULL,7500,0,7500,6550,14445,14445,3471.66
50221339,SP2024 ,14750,600,NULL,NULL,15350,5175,5175,0,NULL,5175,0,5175,10175,10175,10175,3471.66
50232000,FA2024 ,2950,120,840,0,3910,1800,1800,0,0,2037,0,2037,1033,1873,1873,0
50232000,SP2023 ,13500,550,4000,2325,20375,6000,6000,0,5600,9698,0,15298,4352,10677,5077,0
50233771,FA2024 ,14750,600,5410,2450,23210,7500,7500,0,0,11448,0,11448,3902,11762,11762,-2846.11
50233771,SP2024 ,14750,600,5410,2450,23210,7500,7500,0,0,11447,0,11447,3903,11763,11763,-2846.11
50225135,FA2022 ,13005,515,4810,2220,20550,7700,7700,0,12750,9250,0,22000,4270,11300,-1450,250
50225135,FA2023 ,13500,550,5150,2325,21525,7700,7250,450,3250,10100,0,13350,3950,11425,8175,250
50225135,FA2024 ,14750,600,NULL,NULL,15350,5463,3513,1950,3750,14736,0,18486,614,614,-3136,250
50225135,SP2022 ,13005,515,4810,2220,20550,7700,7700,0,12750,9250,0,22000,4270,11300,-1450,250
50225135,SP2023 ,13500,550,NULL,NULL,14050,5331,4881,450,9250,5331,0,14581,8719,8719,-531,250
50225135,SP2024 ,14750,600,NULL,NULL,15350,5463,3513,1950,3750,9735,0,13485,5615,5615,1865,250
50210101,FA2021 ,12625,500,4050,2550,19725,1425,1278,147,NULL,1425,0,1425,11700,18300,18300,0
50210101,FA2022 ,13005,515,5080,2220,20820,1425,1425,0,NULL,1425,0,1425,12095,19395,19395,0
50210101,SP2021 ,12625,500,4050,2550,19725,1425,1278,147,NULL,1425,0,1425,11700,18300,18300,0
50210101,SP2022 ,7170,515,5080,2220,14985,786,786,0,NULL,786,0,786,6899,14199,14199,0
50237393,SP2024 ,4070,NULL,NULL,NULL,4070,0,0,0,NULL,0,0,0,4070,4070,4070,0
50225288,FA2022 ,13005,515,4810,2220,20550,9950,7950,2000,5600,9950,0,15550,3570,10600,5000,0
50225288,FA2023 ,13500,550,5150,2325,21525,9950,6500,3450,7750,9950,0,17700,4100,11575,3825,0
50225288,FA2024 ,14750,600,5720,1270,22340,10950,6500,4450,3750,10950,0,14700,4400,11390,7640,0
50225288,SP2022 ,13005,515,4810,2220,20550,7950,7950,0,5600,7950,0,13550,5570,12600,7000,0
50225288,SP2023 ,13500,550,5150,2325,21525,7950,6500,1450,7750,7950,0,15700,6100,13575,5825,0
50225288,SP2024 ,14750,600,5720,1270,22340,8950,6500,2450,10450,8950,0,19400,6400,13390,2940,0
50232290,FA2024 ,14750,600,4200,2450,22000,8500,8500,0,0,8500,0,8500,6850,13500,13500,0
50232290,SP2024 ,14750,600,4200,2450,22000,8500,8500,0,0,8500,0,8500,6850,13500,13500,0
50225023,FA2022 ,13005,515,4810,2220,20550,5050,5050,0,13633,8498,0,22131,5022,12052,-1581,0
50225023,FA2023 ,13500,550,5150,2325,21525,5050,5000,50,14495,9148,0,23643,4902,12377,-2118,0
50225023,SP2022 ,13005,515,4810,2220,20550,5050,5050,0,13632,8497,0,22129,5023,12053,-1579,0
50225023,SP2023 ,13500,550,5150,2325,21525,5050,5000,50,14495,9147,0,23642,4903,12378,-2117,0
50228670,FA2023 ,13500,550,4000,2325,20375,6750,6750,0,2750,6750,0,9500,7300,13625,10875,0
50228670,FA2024 ,14750,600,4790,2450,22590,6750,6500,250,3250,10448,0,13698,4902,12142,8892,0
50228670,SP2023 ,13500,550,4000,2325,20375,6750,6750,0,2750,6750,0,9500,7300,13625,10875,0
50228670,SP2024 ,14750,600,4790,2450,22590,6750,6500,250,3250,10447,0,13697,4903,12143,8893,0
50205690,FA2021 ,12625,500,4830,1080,19035,925,0,925,NULL,925,0,925,12200,18110,18110,0
50205690,SP2021 ,12625,6350,6350,NULL,18975,0,0,0,NULL,0,0,0,18975,18975,18975,0
50224911,FA2022 ,13005,515,4260,2220,20000,7250,7250,0,2750,7250,0,10000,6270,12750,10000,-450
50224911,FA2023 ,13500,550,5150,2325,21525,7800,7800,0,3250,7800,0,11050,6250,13725,10475,-450
50224911,FA2024 ,14750,600,4200,2450,22000,7650,7650,0,3750,9558,0,13308,5792,12442,8692,-450
50224911,SP2022 ,13005,515,4260,2220,20000,7250,7250,0,2750,7250,0,10000,6270,12750,10000,-450
50224911,SP2023 ,13500,550,5150,2325,21525,7600,7600,0,3250,7600,0,10850,6450,13925,10675,-450
50224911,SP2024 ,14750,600,4200,2450,22000,7700,7700,0,3750,9607,0,13357,5743,12393,8643,-450
50196746,FA2021 ,3470,NULL,NULL,NULL,3470,0,0,0,NULL,0,0,0,3470,3470,3470,0
50223274,FA2021 ,12625,500,3740,2110,18975,5800,5800,0,11059,11448,0,22507,1677,7527,-3532,-50
50223274,FA2022 ,13005,515,3855,2220,19595,6950,6950,0,6905,10798,0,17703,2722,8797,1892,-50
50223274,SP2021 ,12625,500,3740,2110,18975,5800,5800,0,11058,11007,0,22065,2118,7968,-3090,-50
50223274,SP2022 ,13005,515,3855,2220,19595,6950,6950,0,0,10423,0,10423,3097,9172,9172,-50
50209211,FA2021 ,12625,500,4580,2110,19815,9675,6625,3050,3750,11175,0,14925,1950,8640,4890,0
50209211,FA2022 ,13005,515,5080,1140,19740,9675,9675,0,3750,9675,0,13425,3845,10065,6315,0
50209211,SP2021 ,12625,500,4580,2110,19815,9675,6625,3050,3750,9675,0,13425,3450,10140,6390,0
50209211,SP2022 ,13005,515,5080,NULL,18600,9675,9675,0,3750,9675,0,13425,3845,8925,5175,0
50216236,FA2021 ,12625,500,4580,2110,19815,6525,6525,0,2750,14448,0,17198,-1323,5367,2617,0
50216236,FA2022 ,13005,515,4810,2220,20550,6525,6525,0,3750,13023,0,16773,497,7527,3777,0
50216236,FA2023 ,13500,550,NULL,NULL,14050,4115,0,4115,3750,10838,0,14588,3212,3212,-538,0
50216236,SP2021 ,12625,500,4580,2110,19815,6525,6525,0,2750,12447,0,15197,678,7368,4618,0
50216236,SP2022 ,13005,515,NULL,NULL,13520,5025,5025,0,3750,11522,0,15272,1998,1998,-1752,0
50216236,SP2023 ,13500,550,NULL,NULL,14050,4114,0,4114,3750,10836,0,14586,3214,3214,-536,0
50213520,FA2021 ,12625,500,4050,2110,19285,11325,6825,4500,2750,16648,0,19398,-3523,2637,-113,2327.85
50213520,FA2022 ,13005,515,4260,2220,20000,7725,7725,0,3750,10748,0,14498,2772,9252,5502,2327.85
50213520,SP2021 ,12625,500,4050,2110,19285,6825,6825,0,9747,10147,0,19894,2978,9138,-609,2327.85
50230567,FA2024 ,14750,600,4200,2450,22000,9500,0,9500,9682,15198,0,24880,152,6802,-2880,-7594
50230567,SP2024 ,14750,600,4200,2450,22000,9500,0,9500,10333,13197,0,23530,2153,8803,-1530,-7594
50222099,FA2021 ,12625,500,4580,2110,19815,5500,5500,0,NULL,5500,0,5500,7625,14315,14315,0
50222352,FA2021 ,12625,500,NULL,NULL,13125,6210,6210,0,5360,10958,0,16318,2167,2167,-3193,780
50222352,FA2022 ,13005,515,NULL,NULL,13520,5865,5865,0,6250,9713,0,15963,3807,3807,-2443,780
50222352,FA2023 ,13500,550,NULL,NULL,14050,6633,6633,0,6250,10730,0,16980,3320,3320,-2930,780
50222352,SP2021 ,12625,500,NULL,NULL,13125,6210,6210,0,4900,10517,0,15417,2608,2608,-2292,780
50222352,SP2022 ,13005,515,NULL,NULL,13520,5865,5865,0,6250,9712,0,15962,3808,3808,-2442,780
50222352,SP2023 ,13500,550,NULL,NULL,14050,6632,6632,0,6250,10730,0,16980,3320,3320,-2930,780
50231315,FA2024 ,14750,600,4200,2450,22000,2213,2213,0,3250,14750,12537,18000,600,7250,4000,1391.67
50231315,SP2023 ,13500,550,4000,2325,20375,2025,2025,0,3250,13500,11475,16750,550,6875,3625,1391.67
50231315,SP2024 ,14750,600,4200,2450,22000,2213,2213,0,3250,14750,12537,18000,600,7250,4000,1391.67
50202916,FA2021 ,12625,500,4270,NULL,17395,8175,500,7675,4125,11545,0,15670,1580,5850,1725,0
50202916,SP2021 ,12625,500,4270,NULL,17395,7675,0,7675,3750,9545,0,13295,3580,7850,4100,0
50236449,SP2024 ,14750,600,5410,2450,23210,24658,24658,0,NULL,24658,0,24658,-9308,-1448,-1448,0
50210268,FA2021 ,12625,500,4580,2110,19815,7675,5400,2275,0,17748,0,17748,-4623,2067,2067,0
50210268,FA2022 ,13005,515,4610,NULL,18130,8175,5900,2275,0,17525,0,17525,-4005,605,605,0
50210268,FA2023 ,13500,550,4790,NULL,18840,8175,5400,2775,3750,17997,0,21747,-3947,843,-2907,0
50210268,SP2021 ,12625,500,4580,2110,19815,7675,5400,2275,0,18247,0,18247,-5122,1568,1568,0
50210268,SP2022 ,13005,515,4610,NULL,18130,7675,5400,2275,0,17025,0,17025,-3505,1105,1105,0
50210268,SP2023 ,13500,550,4790,NULL,18840,8175,5400,2775,3750,17998,0,21748,-3948,842,-2908,0
40001120,FA2021 ,12625,500,4050,2110,19285,7425,7425,0,NULL,7425,0,7425,5700,11860,11860,0
40001120,FA2022 ,13005,515,4810,2220,20550,7425,7425,0,NULL,7425,0,7425,6095,13125,13125,0
40001120,FA2023 ,13500,550,4000,1200,19250,7425,7425,0,NULL,7425,0,7425,6625,11825,11825,0
40001120,SP2021 ,12625,500,4050,2110,19285,7425,7425,0,NULL,7425,0,7425,5700,11860,11860,0
40001120,SP2022 ,13005,515,4810,2220,20550,7425,7425,0,NULL,7425,0,7425,6095,13125,13125,0
40001120,SP2023 ,13500,550,4000,1200,19250,7425,7425,0,NULL,7425,0,7425,6625,11825,11825,0
50221088,FA2021 ,12625,500,3740,2110,18975,9500,0,9500,1750,15348,0,17098,-2223,3627,1877,1185.67
50221088,FA2022 ,13005,515,4810,2220,20550,13500,0,13500,2250,23157,0,25407,-9637,-2607,-4857,1185.67
50221088,FA2023 ,13500,550,4790,1200,20040,9500,0,9500,3750,14698,0,18448,-648,5342,1592,1185.67
50221088,FA2024 ,14750,600,5030,1270,21650,9500,0,9500,3750,14698,0,18448,652,6952,3202,1185.67
50221088,SP2021 ,12625,500,3740,2110,18975,9500,0,9500,1750,14907,0,16657,-1782,4068,2318,1185.67
50221088,SP2022 ,13005,515,4810,2220,20550,9500,0,9500,3250,14348,0,17598,-828,6202,2952,1185.67
50221088,SP2023 ,13500,6825,6825,NULL,20325,9500,6500,3000,3750,14697,0,18447,5628,5628,1878,1185.67
50221088,SP2024 ,14750,600,5030,1270,21650,9500,0,9500,3750,14697,0,18447,653,6953,3203,1185.67
50233735,FA2024 ,14750,600,5410,2450,23210,7600,7600,0,2750,22263,0,25013,-6913,947,-1803,0
50233735,SP2024 ,14750,600,5410,2450,23210,7600,7600,0,2750,17532,0,20282,-2182,5678,2928,0
50229925,FA2023 ,13500,550,5150,2325,21525,8000,7000,1000,2750,8000,0,10750,6050,13525,10775,2166.34
50229925,FA2024 ,14750,600,NULL,NULL,15350,5520,0,5520,5250,9218,0,14468,6132,6132,882,2166.34
50229925,SP2023 ,13500,550,5150,2325,21525,8000,7000,1000,2750,8000,0,10750,6050,13525,10775,2166.34
50229925,SP2024 ,14750,600,5720,1270,22340,5520,0,5520,5250,9217,0,14467,6133,13123,7873,2166.34
50221620,FA2021 ,12625,500,3740,2550,19415,7500,7500,0,2750,8000,0,10750,5125,11415,8665,293
50221620,FA2022 ,13005,515,NULL,1140,14660,5080,5080,0,5250,8753,0,14003,4767,5907,657,293
50221620,FA2023 ,13500,550,NULL,1200,15250,4830,4830,0,6250,10803,0,17053,3247,4447,-1803,293
50221620,FA2024 ,14750,600,NULL,NULL,15350,4830,4830,0,6250,8928,0,15178,6422,6422,172,293
50221620,SP2021 ,12625,500,3740,2110,18975,7500,7500,0,5650,7500,0,13150,5625,11475,5825,293
50221620,SP2022 ,13005,515,NULL,1140,14660,5080,5080,0,5250,8752,0,14002,4768,5908,658,293
50221620,SP2023 ,13500,550,NULL,1200,15250,4830,4830,0,6250,10802,0,17052,3248,4448,-1802,293
50221620,SP2024 ,14750,600,NULL,NULL,15350,4830,4830,0,6250,8927,0,15177,6423,6423,173,293
50222042,FA2021 ,12625,500,3740,2110,18975,9500,9500,0,2750,11000,0,13750,2125,7975,5225,0
50222042,FA2022 ,13005,515,NULL,1140,14660,6210,6210,0,8140,10383,0,18523,3137,4277,-3863,0
50222042,FA2023 ,13500,550,NULL,NULL,14050,5710,5710,0,8140,13433,0,21573,617,617,-7523,0
50222042,SP2021 ,12625,500,3740,2110,18975,9500,9500,0,2750,13000,0,15750,125,5975,3225,0
50222042,SP2022 ,13005,515,NULL,1140,14660,6210,6210,0,8140,10382,0,18522,3138,4278,-3862,0
50222042,SP2023 ,13500,550,NULL,NULL,14050,5710,5710,0,8140,13432,0,21572,618,618,-7522,0
50226870,FA2024 ,14750,600,4200,2450,22000,7000,7000,0,NULL,7000,0,7000,8350,15000,15000,0
50226870,SP2024 ,14750,600,4200,2450,22000,7000,7000,0,NULL,7000,0,7000,8350,15000,15000,0
50232897,FA2024 ,14750,600,4200,2450,22000,9300,9300,0,13640,11850,0,25490,3500,10150,-3490,1125.45
50210411,FA2021 ,19340,860,5440,2110,26890,12850,7750,5100,15757,14350,0,30107,5850,12540,-3217,0
50210411,FA2022 ,19910,890,5970,1140,27020,12850,7750,5100,18469,12850,0,31319,7950,14170,-4299,0
50210411,SP2021 ,19340,860,5440,2110,26890,11350,7750,3600,15758,11350,0,27108,8850,15540,-218,0
50210411,SP2022 ,10970,890,6310,1140,18420,6258,4273,1985,12601,6258,0,18859,5602,12162,-439,0
50231764,FA2024 ,14750,600,5410,2450,23210,8760,7150,1610,13975,12458,0,26433,2892,10752,-3223,-1741
50231764,SP2024 ,14750,600,5410,2450,23210,7650,7650,0,14176,11347,0,25523,4003,11863,-2313,-1741
50225990,FA2022 ,13005,515,4260,2220,20000,5000,5000,0,2750,5000,0,7750,8520,15000,12250,0
50225990,FA2023 ,13500,550,4000,2325,20375,5000,5000,0,3250,5000,0,8250,9050,15375,12125,0
50225990,FA2024 ,14750,600,4200,2450,22000,5500,5500,0,3750,12820,0,16570,2530,9180,5430,0
50225990,SP2022 ,13005,515,4260,2220,20000,5000,5000,0,2750,5000,0,7750,8520,15000,12250,0
50225990,SP2023 ,13500,550,4000,2325,20375,5000,5000,0,3250,5000,0,8250,9050,15375,12125,0
50225990,SP2024 ,14750,600,4200,2450,22000,5500,5500,0,3750,7820,0,11570,7530,14180,10430,0
50229672,FA2023 ,13500,550,5150,2325,21525,6000,6000,0,2750,6000,0,8750,8050,15525,12775,0
50226672,FA2022 ,3580,NULL,NULL,NULL,3580,0,0,0,NULL,0,0,0,3580,3580,3580,0
50203741,FA2021 ,12625,500,4830,1080,19035,8425,6775,1650,NULL,8925,0,8925,4200,10110,10110,0
50203741,SP2021 ,12625,500,4830,1080,19035,8425,6775,1650,NULL,8425,0,8425,4700,10610,10610,0
50203823,FA2021 ,12625,6350,6350,NULL,18975,8425,8425,0,NULL,8425,0,8425,10550,10550,10550,0
50203823,SP2021 ,12625,500,4830,1080,19035,8425,8425,0,NULL,8425,0,8425,4700,10610,10610,0
50209406,FA2021 ,12625,500,4270,NULL,17395,8425,8425,0,3750,11811,0,15561,1314,5584,1834,0
50209406,FA2022 ,7170,257,NULL,NULL,7427,4094,276,3818,3750,4094,0,7844,3333,3333,-417,0
50209406,SP2021 ,12625,500,4270,NULL,17395,8425,8425,0,3750,10311,0,14061,2814,7084,3334,0
40001297,FA2024 ,14750,600,NULL,NULL,15350,0,0,0,NULL,14750,14750,14750,600,600,600,0
40001297,SP2023 ,13500,550,NULL,NULL,14050,0,0,0,NULL,13500,13500,13500,550,550,550,0
40001297,SP2024 ,14750,600,NULL,NULL,15350,0,0,0,NULL,14750,14750,14750,600,600,600,0
50221972,FA2021 ,12625,500,3740,2110,18975,0,0,0,3250,14125,12625,17375,-1000,4850,1600,0
50221972,FA2022 ,13005,515,4800,2220,20540,0,0,0,3750,13005,13005,16755,515,7535,3785,0
50221972,FA2023 ,13500,550,5440,1200,20690,0,0,0,NULL,13500,13500,13500,550,7190,7190,0
50221972,SP2021 ,12625,500,3740,2110,18975,0,0,0,3250,12625,12625,15875,500,6350,3100,0
50221972,SP2022 ,13005,515,4800,2220,20540,0,0,0,3750,13005,13005,16755,515,7535,3785,0
50221972,SP2023 ,13500,550,NULL,1200,15250,0,0,0,NULL,15720,15720,15720,-1670,-470,-470,0
50233998,FA2024 ,14750,600,4790,2450,22590,6000,6000,0,NULL,6500,0,6500,8850,16090,16090,5907
50233998,SP2024 ,14750,600,4790,2450,22590,6000,6000,0,NULL,6000,0,6000,9350,16590,16590,5907
50203118,FA2021 ,12625,500,4050,2110,19285,3175,1400,1775,0,4175,0,4175,8950,15110,15110,0
50205580,FA2021 ,12625,500,4830,1080,19035,6675,0,6675,6250,11923,0,18173,1202,7112,862,0
50205580,SP2021 ,12625,500,4830,1080,19035,6675,0,6675,6250,10982,0,17232,2143,8053,1803,0
50216276,FA2021 ,12625,500,3740,2110,18975,11925,0,11925,3250,15998,0,19248,-2873,2977,-273,0
50216276,FA2022 ,13005,6590,6590,NULL,19595,7100,7100,0,3750,10948,0,14698,8647,8647,4897,0
50216276,FA2023 ,13500,550,5440,1200,20690,11925,500,11425,0,16023,0,16023,-1973,4667,4667,0
50216276,SP2021 ,12625,500,3740,2110,18975,11925,0,11925,3250,14497,0,17747,-1372,4478,1228,0
50216276,SP2022 ,13005,515,4610,1140,19270,11425,11425,0,3750,15272,0,19022,-1752,3998,248,0
50216276,SP2023 ,13500,550,5440,1200,20690,11925,500,11425,0,16022,0,16022,-1972,4668,4668,0
50198485,FA2021 ,12625,500,3740,2110,18975,2425,2425,0,3750,3425,0,7175,9700,15550,11800,0
50198485,SP2021 ,12625,500,3740,2110,18975,2425,2425,0,3750,2425,0,6175,10700,16550,12800,0
50225565,FA2022 ,13005,515,4810,2220,20550,6500,5500,1000,3250,6500,0,9750,7020,14050,10800,1305.5
50225565,FA2023 ,13500,550,5150,2325,21525,7000,5500,1500,3750,7000,0,10750,7050,14525,10775,1305.5
50225565,FA2024 ,14750,600,5720,1270,22340,7500,5500,2000,3750,7500,0,11250,7850,14840,11090,1305.5
50225565,SP2022 ,13005,515,4810,2690,21020,6500,5500,1000,3250,6500,0,9750,7020,14520,11270,1305.5
50225565,SP2023 ,13500,550,5150,2325,21525,6250,5500,750,3750,6250,0,10000,7800,15275,11525,1305.5
50229761,FA2023 ,13500,550,5150,2325,21525,5500,5000,500,2750,5500,0,8250,8550,16025,13275,4954.99
50229761,FA2024 ,14750,600,5410,2450,23210,6000,5000,1000,3250,6000,0,9250,9350,17210,13960,4954.99
50229761,SP2023 ,13500,550,5150,2325,21525,5500,5000,500,2750,5500,0,8250,8550,16025,13275,4954.99
50229761,SP2024 ,14750,600,5410,2450,23210,6000,5000,1000,3250,6000,0,9250,9350,17210,13960,4954.99
50216704,FA2021 ,12625,500,3740,2110,18975,8775,8775,0,0,14423,0,14423,-1298,4552,4552,0
50216704,SP2021 ,12625,500,3740,2110,18975,8775,8775,0,0,13482,0,13482,-357,5493,5493,0
50191152,FA2021 ,3470,NULL,4580,NULL,8050,0,0,0,NULL,0,0,0,3470,8050,8050,7770.01
50228282,SP2022 ,13005,515,3855,2220,19595,13520,13520,0,NULL,13520,0,13520,0,6075,6075,0
50232403,FA2024 ,14750,600,5410,2900,23660,7000,7000,0,2750,7000,0,9750,8350,16660,13910,0
50232403,SP2024 ,14750,600,5410,2900,23660,7000,7000,0,2750,7000,0,9750,8350,16660,13910,0
50228356,SP2022 ,14269,7231,7231,NULL,21500,0,0,0,NULL,0,0,0,21500,21500,21500,0
50119374,FA2021 ,12625,500,4580,2110,19815,8650,8650,0,2750,9650,0,12400,3475,10165,7415,0
50119374,FA2022 ,13005,515,3855,2220,19595,8150,7000,1150,3250,8150,0,11400,5370,11445,8195,0
50119374,SP2021 ,12625,500,4580,2110,19815,8900,8900,0,2750,8900,0,11650,4225,10915,8165,0
50119374,SP2022 ,13005,515,3855,2220,19595,8450,7300,1150,3250,8450,0,11700,5070,11145,7895,0
50229810,FA2024 ,14750,600,NULL,NULL,15350,9552,9552,0,0,14750,0,14750,600,600,600,0
50225860,FA2022 ,13005,515,4810,2220,20550,7000,7000,0,2750,7000,0,9750,6520,13550,10800,0
50225860,SP2022 ,13005,515,4810,2220,20550,7000,7000,0,2750,7000,0,9750,6520,13550,10800,0
50225334,FA2022 ,13005,515,4810,2220,20550,6500,6500,0,14050,6500,0,20550,7020,14050,0,35
50225334,FA2023 ,13500,550,5150,2325,21525,6500,6500,0,15250,6500,0,21750,7550,15025,-225,35
50225334,FA2024 ,14750,600,5720,NULL,21070,6500,6500,0,14750,6500,0,21250,8850,14570,-180,35
50225334,SP2022 ,13005,515,4810,2220,20550,6500,6500,0,14050,6500,0,20550,7020,14050,0,35
50225334,SP2023 ,13500,550,5150,2325,21525,6500,6500,0,15250,6500,0,21750,7550,15025,-225,35
50225334,SP2024 ,14750,600,5720,NULL,21070,6500,6500,0,3750,6500,0,10250,8850,14570,10820,35
50230381,FA2023 ,13500,550,5150,2325,21525,7000,7000,0,3750,7000,0,10750,7050,14525,10775,9982.5
50230381,FA2024 ,14750,600,5030,1270,21650,7000,5500,1500,3750,7000,0,10750,8350,14650,10900,9982.5
50230381,SP2023 ,13500,550,5150,2325,21525,7000,7000,0,3750,7000,0,10750,7050,14525,10775,9982.5
50230381,SP2024 ,14750,600,5030,1270,21650,7000,5500,1500,3750,7000,0,10750,8350,14650,10900,9982.5
50231652,FA2024 ,14750,600,4200,2450,22000,8500,6500,2000,2750,13800,0,16550,1550,8200,5450,5110
50231652,SP2024 ,14750,600,4200,2450,22000,6500,6500,0,2750,6500,0,9250,8850,15500,12750,5110
50216264,FA2021 ,12625,500,4050,2110,19285,6675,6675,0,NULL,6675,0,6675,6450,12610,12610,0
50216264,FA2022 ,13005,515,3855,1140,18515,6175,6175,0,NULL,6175,0,6175,7345,12340,12340,0
50216264,FA2023 ,13500,550,4790,1200,20040,6175,6175,0,NULL,6175,0,6175,7875,13865,13865,0
50216264,SP2021 ,12625,500,4050,2110,19285,6675,6675,0,NULL,6675,0,6675,6450,12610,12610,0
50216264,SP2022 ,13005,515,4610,1140,19270,6175,6175,0,NULL,6175,0,6175,7345,13095,13095,0
50216264,SP2023 ,13500,550,4790,1200,20040,6175,6175,0,NULL,6175,0,6175,7875,13865,13865,0
50216175,FA2021 ,12625,500,4580,2110,19815,22675,14075,8600,NULL,24175,0,24175,-11050,-4360,-4360,4543.23
50216175,SP2021 ,12625,500,4580,2110,19815,20475,14075,6400,NULL,20475,0,20475,-7350,-660,-660,4543.23
50228870,FA2023 ,13500,550,4000,2325,20375,9000,9000,0,2750,9000,0,11750,5050,11375,8625,2664.68
50228870,FA2024 ,14750,600,4790,2450,22590,9000,9000,0,NULL,9000,0,9000,6350,13590,13590,2664.68
50228870,SP2023 ,13500,550,4000,2325,20375,9000,9000,0,2750,9000,0,11750,5050,11375,8625,2664.68
50228870,SP2024 ,14750,600,5720,NULL,21070,9000,9000,0,NULL,9000,0,9000,6350,12070,12070,2664.68
50204754,FA2021 ,6960,250,NULL,NULL,7210,2577,0,2577,3750,4077,0,7827,3133,3133,-617,0
50224939,SP2021 ,13867,6974,6974,NULL,20841,0,0,0,NULL,0,0,0,20841,20841,20841,0
50205258,FA2021 ,12625,500,4270,NULL,17395,3425,0,3425,3750,9598,0,13348,3527,7797,4047,0
50205258,SP2021 ,12625,500,4270,NULL,17395,3425,0,3425,3750,7597,0,11347,5528,9798,6048,0
50218168,FA2021 ,12625,500,4580,2110,19815,8925,8925,0,3250,15048,0,18298,-1923,4767,1517,0
50218168,FA2022 ,13005,515,3855,2220,19595,8925,8925,0,3750,14948,0,18698,-1428,4647,897,0
50218168,FA2023 ,13500,550,4000,2325,20375,8925,8925,0,3750,15498,0,19248,-1448,4877,1127,0
50218168,SP2021 ,12625,500,4580,2110,19815,8925,8925,0,3250,13047,0,16297,78,6768,3518,0
50218168,SP2022 ,13005,6590,6590,NULL,19595,8925,8925,0,3750,14947,0,18697,4648,4648,898,0
50218168,SP2023 ,13500,550,4000,2325,20375,8925,8925,0,3750,15497,0,19247,-1447,4878,1128,0
50217343,FA2021 ,12625,500,4580,2110,19815,2425,2425,0,0,3425,0,3425,9700,16390,16390,0
50217343,FA2022 ,13005,515,3855,2220,19595,1175,1175,0,3750,4248,0,7998,9272,15347,11597,0
50217343,FA2023 ,13500,550,4000,2325,20375,3425,3425,0,3750,3425,0,7175,10625,16950,13200,0
50217343,SP2021 ,12625,500,4580,2110,19815,2425,2425,0,3250,2425,0,5675,10700,17390,14140,0
50217343,SP2022 ,13005,515,3855,2220,19595,1175,1175,0,3750,4247,0,7997,9273,15348,11598,0
50217343,SP2023 ,13500,550,4000,2325,20375,3425,3425,0,3750,3425,0,7175,10625,16950,13200,0
50215386,FA2021 ,12625,500,3740,2110,18975,7925,7925,0,10800,9425,0,20225,3700,9550,-1250,0
50215386,FA2022 ,13005,515,3855,2220,19595,7425,7425,0,12750,7425,0,20175,6095,12170,-580,0
50215386,FA2023 ,13500,550,5440,1200,20690,7425,5100,2325,13137,7425,0,20562,6625,13265,128,0
50215386,SP2021 ,12625,500,3740,2110,18975,7925,7925,0,10800,7925,0,18725,5200,11050,250,0
50215386,SP2022 ,13005,515,3855,2220,19595,7425,7425,0,12750,7425,0,20175,6095,12170,-580,0
50215386,SP2023 ,13500,550,5440,2745,22235,7425,5100,2325,13138,7425,0,20563,6625,14810,1672,0
50218686,SP2021 ,12625,500,4050,2110,19285,8525,8525,0,0,8525,0,8525,4600,10760,10760,0
50232843,FA2024 ,14750,600,4200,2450,22000,6500,6500,0,18180,6500,0,24680,8850,15500,-2680,0
50232843,SP2024 ,14750,600,4200,2450,22000,6500,6500,0,14338,6500,0,20838,8850,15500,1162,0
50204848,FA2021 ,12625,500,4050,2550,19725,1425,1425,0,NULL,1425,0,1425,11700,18300,18300,0
50204848,FA2022 ,13005,515,5420,2220,21160,1425,0,1425,0,1425,0,1425,12095,19735,19735,0
50204848,SP2021 ,12625,500,4050,2550,19725,1425,1425,0,NULL,1425,0,1425,11700,18300,18300,0
50204848,SP2022 ,13005,515,5420,2220,21160,1425,0,1425,0,1425,0,1425,12095,19735,19735,0
50118863,FA2021 ,12625,500,4050,2110,19285,7425,5425,2000,0,10925,0,10925,2200,8360,8360,0
50118863,FA2022 ,13005,515,4610,1140,19270,7425,5425,2000,3750,8425,0,12175,5095,10845,7095,0
50118863,SP2021 ,12625,500,4050,2110,19285,5425,5425,0,0,5925,0,5925,7200,13360,13360,0
50118863,SP2022 ,13005,515,4610,1140,19270,5425,5425,0,3750,6425,0,10175,7095,12845,9095,0
50192347,FA2021 ,3470,NULL,NULL,NULL,3470,0,0,0,NULL,0,0,0,3470,3470,3470,0
50228031,FA2023 ,13500,550,5150,2325,21525,8500,8500,0,2750,8500,0,11250,5550,13025,10275,5159
50228031,FA2024 ,14750,600,5410,2450,23210,8500,8500,0,3250,8500,0,11750,6850,14710,11460,5159
50228031,SP2023 ,13500,550,5150,2325,21525,8500,8500,0,2750,8500,0,11250,5550,13025,10275,5159
50228031,SP2024 ,14750,600,5410,2450,23210,8500,8500,0,3250,8500,0,11750,6850,14710,11460,5159
50226689,FA2022 ,14269,7231,7231,NULL,21500,0,0,0,NULL,0,0,0,21500,21500,21500,0
50232795,FA2024 ,14750,600,4200,2450,22000,9000,9000,0,2750,9000,0,11750,6350,13000,10250,50
50232795,SP2024 ,14750,600,4200,2450,22000,9000,9000,0,2750,9000,0,11750,6350,13000,10250,50
50226750,FA2022 ,13005,515,4810,2220,20550,6500,6500,0,2750,6500,0,9250,7020,14050,11300,6281.49
50226750,FA2023 ,13500,550,4560,2325,20935,6500,6500,0,3250,6500,0,9750,7550,14435,11185,6281.49
50226750,FA2024 ,14750,600,5410,2450,23210,6500,6500,0,3750,7120,0,10870,8230,16090,12340,6281.49
50226750,SP2022 ,13005,515,4810,2220,20550,6500,6500,0,2750,6500,0,9250,7020,14050,11300,6281.49
50226750,SP2023 ,13500,550,4560,2325,20935,6500,6500,0,3250,6500,0,9750,7550,14435,11185,6281.49
50226750,SP2024 ,14750,600,5410,2450,23210,6500,6500,0,3750,7120,0,10870,8230,16090,12340,6281.49
50205804,FA2021 ,12625,500,4270,NULL,17395,0,0,0,3750,15548,12625,19298,-2423,1847,-1903,0
50205804,SP2021 ,12625,500,4270,NULL,17395,0,0,0,3750,13547,12625,17297,-422,3848,98,0
50221352,FA2021 ,12625,500,3740,2110,18975,0,0,0,2750,15698,12625,18448,-2573,3277,527,0
50221352,FA2022 ,13005,515,3855,2220,19595,0,0,0,3250,13005,13005,16255,515,6590,3340,0
50221352,FA2023 ,13500,550,4000,2325,20375,0,0,0,3750,13500,13500,17250,550,6875,3125,0
50221352,FA2024 ,14750,600,5030,1270,21650,0,0,0,500,14750,14750,15250,600,6900,6400,0
50221352,SP2021 ,12625,500,3740,2110,18975,0,0,0,2750,14197,12625,16947,-1072,4778,2028,0
50221352,SP2022 ,13005,515,3855,2220,19595,0,0,0,3250,13005,13005,16255,515,6590,3340,0
50221352,SP2023 ,13500,550,4000,2325,20375,0,0,0,3750,13500,13500,17250,550,6875,3125,0
50204759,FA2021 ,12625,500,4830,1080,19035,0,0,0,NULL,500,0,500,12625,18535,18535,0
50204759,SP2021 ,12625,500,4830,1080,19035,0,0,0,NULL,0,0,0,13125,19035,19035,0
50217499,FA2021 ,12625,500,3740,2110,18975,4925,3925,1000,3250,5925,0,9175,7200,13050,9800,0
50217499,FA2022 ,13005,515,5080,1140,19740,3925,3925,0,3750,3925,0,7675,9595,15815,12065,0
50217499,FA2023 ,13500,550,4790,1200,20040,3925,3925,0,3750,3925,0,7675,10125,16115,12365,0
50217499,SP2021 ,12625,500,3740,2110,18975,3925,3925,0,3250,3925,0,7175,9200,15050,11800,0
50217499,SP2022 ,13005,6590,8230,790,22025,3925,3925,0,3750,3925,0,7675,15670,18100,14350,0
50217499,SP2023 ,13500,550,4790,1200,20040,3925,3925,0,3750,3925,0,7675,10125,16115,12365,0
50225390,FA2022 ,2600,103,3855,444,7002,0,0,0,NULL,2600,2600,2600,103,4402,4402,0
50108470,FA2022 ,3580,NULL,NULL,NULL,3580,0,0,0,NULL,3580,3580,3580,0,0,0,600
50108470,FA2023 ,3720,NULL,NULL,NULL,3720,0,0,0,NULL,3720,3720,3720,0,0,0,600
50108470,FA2024 ,8140,300,NULL,NULL,8440,0,0,0,NULL,8140,8140,8140,300,300,300,600
50108470,SP2022 ,3580,NULL,NULL,NULL,3580,0,0,0,NULL,3580,3580,3580,0,0,0,600
50108470,SP2023 ,3720,NULL,NULL,NULL,3720,0,0,0,NULL,3720,3720,3720,0,0,0,600
50108470,SP2024 ,8140,300,NULL,NULL,8440,0,0,0,NULL,8140,8140,8140,300,300,300,600
50204374,FA2021 ,12625,500,4580,2110,19815,925,925,0,NULL,925,0,925,12200,18890,18890,0
50204374,SP2021 ,12625,500,4580,2110,19815,925,925,0,NULL,925,0,925,12200,18890,18890,0
50226577,FA2022 ,13005,515,3855,2220,19595,9500,9500,0,NULL,9500,0,9500,4020,10095,10095,0
50226577,FA2023 ,13500,550,4000,2325,20375,9500,9500,0,NULL,13500,0,13500,550,6875,6875,0
50226577,FA2024 ,14750,600,4200,2450,22000,11500,9500,2000,NULL,11500,0,11500,3850,10500,10500,0
50226577,SP2022 ,13005,515,3855,2220,19595,11500,9500,2000,NULL,11500,0,11500,2020,8095,8095,0
50226577,SP2023 ,13500,550,4000,2325,20375,11500,9500,2000,NULL,15500,0,15500,-1450,4875,4875,0
50229528,FA2023 ,13500,550,5150,2325,21525,7000,7000,0,2750,7000,0,9750,7050,14525,11775,4168
50229528,FA2024 ,14750,600,4790,2450,22590,7000,6000,1000,3250,7000,0,10250,8350,15590,12340,4168
50229528,SP2023 ,13500,550,5150,2325,21525,7000,7000,0,2750,7000,0,9750,7050,14525,11775,4168
50229528,SP2024 ,14750,600,4790,2450,22590,7000,6000,1000,3250,7000,0,10250,8350,15590,12340,4168
50221485,FA2021 ,12625,500,4050,2110,19285,7000,7000,0,2750,12000,0,14750,1125,7285,4535,917.83
50221485,FA2022 ,13005,515,4260,2220,20000,6500,6500,0,3250,9000,0,12250,4520,11000,7750,917.83
50221485,FA2023 ,13500,550,5440,NULL,19490,6500,6500,0,3750,11500,0,15250,2550,7990,4240,917.83
50221485,FA2024 ,14750,600,6090,NULL,21440,7500,6500,1000,3750,12500,0,16250,2850,8940,5190,917.83
50221485,SP2021 ,12625,500,4050,2110,19285,7000,7000,0,2750,7000,0,9750,6125,12285,9535,917.83
50221485,SP2022 ,13005,515,4260,2220,20000,6500,6500,0,3250,9000,0,12250,4520,11000,7750,917.83
50221485,SP2023 ,13500,550,5440,NULL,19490,6500,6500,0,3750,6500,0,10250,7550,12990,9240,917.83
50221485,SP2024 ,14750,600,6090,NULL,21440,7500,6500,1000,3750,7500,0,11250,7850,13940,10190,917.83
50228671,FA2023 ,13500,550,4560,2325,20935,6000,6000,0,2750,6000,0,8750,8050,14935,12185,4458
50228671,FA2024 ,14750,600,4790,2450,22590,6000,6000,0,3250,6000,0,9250,9350,16590,13340,4458
50228671,SP2023 ,13500,550,4560,2325,20935,6000,6000,0,2750,6000,0,8750,8050,14935,12185,4458
50228671,SP2024 ,14750,600,4790,2450,22590,6000,6000,0,3250,6000,0,9250,9350,16590,13340,4458
50224945,FA2022 ,13005,515,3855,2690,20065,11250,9250,2000,2750,15000,0,17750,-1480,5065,2315,0
50224945,FA2023 ,13500,550,4000,2325,20375,11250,750,10500,3250,17773,0,21023,-3723,2602,-648,0
50224945,FA2024 ,14750,600,4200,2450,22000,11550,7050,4500,3750,17148,0,20898,-1798,4852,1102,0
50224945,SP2022 ,13005,515,3855,2220,19595,9250,9250,0,2750,11750,0,14500,1770,7845,5095,0
50224945,SP2023 ,13500,550,4000,2325,20375,9500,1000,8500,3250,15022,0,18272,-972,5353,2103,0
50224945,SP2024 ,14750,600,4200,2450,22000,9250,6750,2500,3750,14847,0,18597,503,7153,3403,0
50216832,FA2021 ,12625,500,NULL,NULL,13125,500,500,0,NULL,2000,0,2000,11125,11125,11125,0
50216832,FA2022 ,13005,515,NULL,NULL,13520,11100,11100,0,0,11100,0,11100,2420,2420,2420,0
50216832,SP2021 ,12625,500,NULL,NULL,13125,500,500,0,NULL,500,0,500,12625,12625,12625,0
50216832,SP2022 ,13005,515,NULL,NULL,13520,11100,11100,0,0,11100,0,11100,2420,2420,2420,0
50203963,FA2021 ,12625,500,4830,NULL,17955,1425,1425,0,3750,2425,0,6175,10700,15530,11780,0
50203963,SP2021 ,12625,500,4830,NULL,17955,1425,1425,0,3750,1425,0,5175,11700,16530,12780,0
50204641,FA2021 ,12625,500,3740,2110,18975,2975,2975,0,16250,4475,0,20725,8650,14500,-1750,0
50204641,SP2021 ,12625,500,3740,2110,18975,2975,2975,0,17100,2975,0,20075,10150,16000,-1100,0
50216498,FA2021 ,12625,500,4580,2110,19815,7731,7006,725,2250,19634,0,21884,-6509,181,-2069,0
50216498,FA2022 ,13005,515,4260,2220,20000,8425,8425,0,3263,18333,0,21596,-4813,1667,-1596,0
50216498,FA2023 ,13500,550,5440,NULL,19490,8425,8425,0,0,16947,0,16947,-2897,2543,2543,0
50216498,SP2021 ,12625,500,4580,2110,19815,7447,6722,725,2250,17349,0,19599,-4224,2466,216,0
50216498,SP2022 ,13005,515,4260,2220,20000,8425,8425,0,3262,18332,0,21594,-4812,1668,-1594,0
50216498,SP2023 ,13500,550,4560,2325,20935,8425,8425,0,0,35108,0,35108,-21058,-14173,-14173,0
50229475,FA2023 ,13500,550,4000,2325,20375,9000,9000,0,2750,13423,0,16173,627,6952,4202,2219.2
50229475,FA2024 ,14750,600,4780,2450,22580,9000,0,9000,5250,14598,0,19848,752,7982,2732,2219.2
50229475,SP2023 ,13500,550,4000,2325,20375,9000,9000,0,2750,13422,0,16172,628,6953,4203,2219.2
50229475,SP2024 ,14750,600,4780,2450,22580,9000,0,9000,5250,14597,0,19847,753,7983,2733,2219.2
50232585,FA2024 ,14750,600,5410,2900,23660,9000,9000,0,2750,10500,0,13250,4850,13160,10410,-3073.75
50232585,SP2024 ,14750,600,5410,2680,23440,9000,9000,0,2750,9000,0,11750,6350,14440,11690,-3073.75
50216295,FA2021 ,12625,500,4580,2110,19815,3925,3925,0,0,4925,0,4925,8200,14890,14890,0
50216295,FA2022 ,13005,515,4810,2220,20550,3925,3925,0,0,3925,0,3925,9595,16625,16625,0
50216295,FA2023 ,13500,550,5800,1200,21050,3925,3925,0,3750,3925,0,7675,10125,17125,13375,0
50216295,SP2021 ,12625,500,4580,2110,19815,3925,3925,0,0,3925,0,3925,9200,15890,15890,0
50216295,SP2022 ,13005,6590,6590,NULL,19595,3925,3925,0,0,3925,0,3925,15670,15670,15670,0
50216295,SP2023 ,13500,550,5800,1200,21050,4175,4175,0,3750,4175,0,7925,9875,16875,13125,0
50119986,FA2022 ,13005,515,3855,2220,19595,7750,7750,0,15060,7750,0,22810,5770,11845,-3215,0
50119986,FA2023 ,13500,550,5150,2325,21525,7750,7750,0,12752,7750,0,20502,6300,13775,1023,0
50119986,FA2024 ,14750,600,5410,2450,23210,7750,7750,0,15460,7750,0,23210,7600,15460,0,0
50119986,SP2022 ,13005,515,3855,2220,19595,7750,7750,0,10361,7750,0,18111,5770,11845,1484,0
50119986,SP2023 ,13500,550,5150,2325,21525,7750,7750,0,14597,7750,0,22347,6300,13775,-822,0
50119986,SP2024 ,14750,600,5410,2450,23210,7750,7750,0,16127,7750,0,23877,7600,15460,-667,0
50122495,FA2024 ,14750,600,4790,2450,22590,9500,9500,0,14952,9500,0,24452,5850,13090,-1862,-1345
50122495,SP2024 ,14750,600,4790,2450,22590,9500,9500,0,14570,9500,0,24070,5850,13090,-1480,-1345
50224501,FA2021 ,12625,500,4580,2110,19815,5500,5500,0,12750,8500,0,21250,4625,11315,-1435,0
50224501,FA2022 ,13005,515,4810,2220,20550,9500,5500,4000,13250,9500,0,22750,4020,11050,-2200,0
50224501,FA2023 ,13500,550,5150,2325,21525,8500,5500,3000,13750,8500,0,22250,5550,13025,-725,0
50224501,FA2024 ,6090,300,NULL,NULL,6390,1567,1567,0,NULL,1567,0,1567,4823,4823,4823,0
50224501,SP2021 ,12625,500,4580,2110,19815,5500,5500,0,12750,5500,0,18250,7625,14315,1565,0
50224501,SP2022 ,13005,515,4810,2220,20550,5500,5500,0,13250,5500,0,18750,8020,15050,1800,0
50224501,SP2023 ,7450,550,4990,2325,15315,3035,3035,0,13750,3035,0,16785,4965,12280,-1470,0
50227831,FA2023 ,13500,550,5150,2325,21525,9500,6500,3000,12750,9500,0,22250,4550,12025,-725,-350
50227831,FA2024 ,14750,600,5410,2450,23210,6800,6800,0,13250,6800,0,20050,8550,16410,3160,-350
50227831,SP2023 ,13500,550,5150,2325,21525,6750,6750,0,12750,6750,0,19500,7300,14775,2025,-350
50227831,SP2024 ,14750,600,5410,2450,23210,6850,6850,0,13250,6850,0,20100,8500,16360,3110,-350
50222310,FA2021 ,12625,500,4580,2110,19815,0,0,0,0,14548,12625,14548,-1423,5267,5267,394
50235015,FA2024 ,14750,600,4200,2450,22000,5000,5000,0,17089,8170,0,25259,7180,13830,-3259,0
50235015,SP2024 ,14750,600,4200,2450,22000,5000,5000,0,11750,8170,0,19920,7180,13830,2080,0
50225139,FA2022 ,13005,515,3855,2220,19595,6750,6750,0,2750,12098,0,14848,1422,7497,4747,1502.67
50225139,FA2023 ,13500,550,4000,1200,19250,8750,8250,500,3250,8750,0,12000,5300,10500,7250,1502.67
50225139,FA2024 ,14750,600,5410,2450,23210,7500,750,6750,5750,12698,0,18448,2652,10512,4762,1502.67
50225139,SP2022 ,13005,515,3855,2220,19595,6750,6750,0,2750,12097,0,14847,1423,7498,4748,1502.67
50225139,SP2023 ,13500,550,4000,2325,20375,8750,8250,500,3250,8750,0,12000,5300,11625,8375,1502.67
50225139,SP2024 ,14750,600,5410,2450,23210,7500,750,6750,5750,12697,0,18447,2653,10513,4763,1502.67
50231605,FA2024 ,14750,600,5410,2450,23210,7600,7600,0,4750,15684,0,20434,-334,7526,2776,-225
50231605,SP2024 ,14750,600,5410,2450,23210,7600,7600,0,4750,14683,0,19433,667,8527,3777,-225
50225195,FA2023 ,13500,550,NULL,NULL,14050,1075,1075,0,2750,13018,11943,15768,1032,1032,-1718,55
50225195,FA2024 ,14750,600,NULL,NULL,15350,1527,1527,0,NULL,14064,12537,14064,1286,1286,1286,55
50225195,SP2023 ,13500,550,NULL,NULL,14050,1074,1074,0,2750,13016,11942,15766,1034,1034,-1716,55
50225195,SP2024 ,14750,600,NULL,NULL,15350,1526,1526,0,NULL,14064,12538,14064,1286,1286,1286,55
50206384,FA2021 ,12625,500,NULL,NULL,13125,925,0,925,NULL,925,0,925,12200,12200,12200,0
50206384,SP2021 ,12625,500,NULL,NULL,13125,925,0,925,NULL,925,0,925,12200,12200,12200,0
50209266,FA2021 ,12625,500,4050,2110,19285,5425,5425,0,3750,7925,0,11675,5200,11360,7610,0
50209266,FA2022 ,13005,515,4610,1140,19270,5425,5425,0,3750,5425,0,9175,8095,13845,10095,0
50209266,SP2021 ,12625,500,4050,2110,19285,5425,5425,0,3750,5425,0,9175,7700,13860,10110,0
50209266,SP2022 ,13005,515,4610,1140,19270,5425,5425,0,3750,5425,0,9175,8095,13845,10095,0
50209490,FA2021 ,12625,500,4270,1080,18475,2675,2675,0,3750,4175,0,7925,8950,14300,10550,0
50209490,FA2022 ,13005,515,4610,NULL,18130,3675,2675,1000,NULL,3675,0,3675,9845,14455,14455,0
50209490,SP2021 ,12625,500,4270,1080,18475,2675,2675,0,3750,2675,0,6425,10450,15800,12050,0
50209490,SP2022 ,13005,515,NULL,NULL,13520,2175,1175,1000,NULL,2175,0,2175,11345,11345,11345,0
50117905,FA2021 ,12625,500,3740,2110,18975,6425,6425,0,3250,11665,0,14915,1460,7310,4060,0
50117905,FA2022 ,13005,515,3855,2220,19595,7175,6425,750,3750,11030,0,14780,2490,8565,4815,0
50117905,SP2021 ,12625,500,3740,2110,18975,8425,6425,2000,3250,12165,0,15415,960,6810,3560,0
50117905,SP2022 ,13005,515,3855,2220,19595,9175,6425,2750,3750,13030,0,16780,490,6565,2815,0
50226923,FA2023 ,13500,550,5150,2325,21525,8500,8500,0,15750,8500,0,24250,5550,13025,-2725,0
50226923,FA2024 ,14750,600,5410,2450,23210,8000,8000,0,15250,8000,0,23250,7350,15210,-40,0
50226923,SP2023 ,13500,550,5150,2325,21525,8500,8500,0,12750,8500,0,21250,5550,13025,275,0
50226923,SP2024 ,14750,600,5410,2450,23210,8000,8000,0,15250,8000,0,23250,7350,15210,-40,0
50232004,SP2023 ,13500,550,4560,2325,20935,7000,7000,0,2750,7000,0,9750,7050,13935,11185,-200
50205430,FA2021 ,6960,250,NULL,NULL,7210,1613,0,1613,0,12043,0,12043,-4833,-4833,-4833,0
50203440,FA2021 ,12625,500,4830,1080,19035,5800,0,5800,6250,14317,0,20567,-1192,4718,-1532,0
50203440,SP2021 ,12625,500,4830,NULL,17955,5800,0,5800,6250,13378,0,19628,-253,4577,-1673,0
50225261,FA2022 ,13005,515,NULL,NULL,13520,5295,5295,0,2750,5295,0,8045,8225,8225,5475,0
50225261,FA2023 ,13500,550,NULL,NULL,14050,5295,5295,0,NULL,12371,0,12371,1679,1679,1679,0
50225261,FA2024 ,14750,600,NULL,NULL,15350,5295,4295,1000,NULL,5295,0,5295,10055,10055,10055,0
50225261,SP2022 ,13005,515,NULL,NULL,13520,5295,5295,0,2750,5295,0,8045,8225,8225,5475,0
50225261,SP2023 ,13500,550,NULL,NULL,14050,5295,5295,0,NULL,5295,0,5295,8755,8755,8755,0
50225261,SP2024 ,14750,600,NULL,NULL,15350,5295,4295,1000,NULL,5295,0,5295,10055,10055,10055,0
50211157,FA2021 ,12625,500,4050,2110,19285,4025,4025,0,3750,14198,0,17948,-1073,5087,1337,0
50211157,FA2022 ,13005,515,3855,2220,19595,5425,5425,0,3750,13602,0,17352,-82,5993,2243,0
50211157,SP2021 ,12625,500,4050,2110,19285,4025,4025,0,8968,12197,0,21165,928,7088,-1880,0
50211157,SP2022 ,13005,515,3855,2220,19595,4925,4925,0,3750,13103,0,16853,417,6492,2742,0
50204673,FA2021 ,12625,500,5160,1080,19365,1925,0,1925,3750,3425,0,7175,9700,15940,12190,0
50204673,SP2021 ,12625,500,5160,1080,19365,1925,0,1925,3750,1925,0,5675,11200,17440,13690,0
50213776,FA2021 ,3787,150,4650,633,9220,278,278,0,3250,1278,0,4528,2659,7942,4692,0
50224947,FA2022 ,13005,515,3855,2220,19595,6750,6750,0,2750,6750,0,9500,6770,12845,10095,0
50224947,FA2023 ,13500,550,4000,2325,20375,6750,6750,0,3250,6750,0,10000,7300,13625,10375,0
50224947,SP2022 ,13005,515,3855,2220,19595,6750,6750,0,2750,6750,0,9500,6770,12845,10095,0
50224947,SP2023 ,13500,550,4000,2325,20375,6750,6750,0,3250,6750,0,10000,7300,13625,10375,0
50224551,FA2022 ,13005,515,3855,2220,19595,6000,6000,0,2750,6000,0,8750,7520,13595,10845,0
50224551,FA2023 ,13500,550,4560,1200,19810,6000,6000,0,2750,6000,0,8750,8050,13810,11060,0
50224551,SP2022 ,13005,515,3855,2220,19595,6000,6000,0,2750,6000,0,8750,7520,13595,10845,0
50224551,SP2023 ,13500,550,4560,NULL,18610,6000,6000,0,2750,6000,0,8750,8050,12610,9860,0
50234393,FA2024 ,14750,600,4200,2450,22000,9000,9000,0,2750,12698,0,15448,2652,9302,6552,3097.5
50234393,SP2024 ,14750,600,4200,2450,22000,9000,9000,0,2750,12697,0,15447,2653,9303,6553,3097.5
50228263,FA2023 ,13500,550,4000,2325,20375,8000,8000,0,14801,8000,0,22801,6050,12375,-2426,0
50228263,SP2023 ,13500,550,4000,2325,20375,8000,8000,0,4699,8000,0,12699,6050,12375,7676,0
50232037,FA2024 ,14750,600,5410,2450,23210,9900,9900,0,2750,14165,0,16915,1185,9045,6295,0
50232037,SP2024 ,14750,600,5410,2450,23210,9900,9900,0,2750,13165,0,15915,2185,10045,7295,0
50232586,FA2024 ,14750,600,4790,2450,22590,7000,7000,0,2750,7500,0,10250,7850,15090,12340,5202.66
50232586,SP2024 ,14750,600,4790,2450,22590,7000,7000,0,2750,7000,0,9750,8350,15590,12840,5202.66
50234262,FA2024 ,14750,7250,7250,NULL,22000,7000,7000,0,0,7000,0,7000,15000,15000,15000,0
50225196,FA2022 ,13005,515,4810,2220,20550,5750,5750,0,2750,5750,0,8500,7770,14800,12050,0
50225196,FA2023 ,13500,550,4560,2325,20935,5750,5750,0,3250,5750,0,9000,8300,15185,11935,0
50225196,FA2024 ,14750,600,NULL,NULL,15350,3967,3967,0,3750,3967,0,7717,11383,11383,7633,0
50225196,SP2022 ,13005,515,4810,2220,20550,5750,5750,0,2750,5750,0,8500,7770,14800,12050,0
50225196,SP2023 ,13500,550,4560,2325,20935,5750,5750,0,3250,5750,0,9000,8300,15185,11935,0
50225196,SP2024 ,14750,600,NULL,NULL,15350,3968,3968,0,3750,3968,0,7718,11382,11382,7632,0
50225863,FA2022 ,13005,515,4260,2220,20000,7000,7000,0,2750,7000,0,9750,6520,13000,10250,0
50225863,FA2023 ,13500,550,4560,2325,20935,7000,6500,500,3250,7000,0,10250,7050,13935,10685,0
50225863,FA2024 ,14750,600,4790,2450,22590,7000,6500,500,3750,7000,0,10750,8350,15590,11840,0
50225863,SP2022 ,13005,515,4260,2220,20000,7000,7000,0,2750,7000,0,9750,6520,13000,10250,0
50225863,SP2023 ,13500,550,4560,2325,20935,7000,6500,500,3250,7000,0,10250,7050,13935,10685,0
50225863,SP2024 ,14750,600,4790,2450,22590,7000,6500,500,3750,7000,0,10750,8350,15590,11840,0
50211414,FA2021 ,12625,500,4580,2110,19815,2425,2425,0,3750,3425,0,7175,9700,16390,12640,0
50211414,FA2022 ,13005,6590,6590,NULL,19595,975,975,0,3750,975,0,4725,18620,18620,14870,0
50211414,SP2021 ,12625,500,4580,2110,19815,2425,2425,0,3750,2425,0,6175,10700,17390,13640,0
50211414,SP2022 ,15325,7500,7500,NULL,22825,0,0,0,3750,0,0,3750,22825,22825,19075,0
50217535,FA2021 ,19340,860,4600,2110,26050,9500,9500,0,NULL,10000,0,10000,10200,16050,16050,0
50217535,FA2022 ,19910,890,5500,1140,26550,9500,9500,0,NULL,9500,0,9500,11300,17050,17050,0
50217535,FA2023 ,20670,950,6390,1200,28260,10000,9500,500,NULL,10000,0,10000,11620,18260,18260,0
50217535,SP2021 ,19340,860,4600,2110,26050,9500,9500,0,NULL,9500,0,9500,10700,16550,16550,0
50217535,SP2022 ,19910,890,5500,1140,26550,9500,9500,0,NULL,9500,0,9500,11300,17050,17050,0
50217535,SP2023 ,20670,950,6390,1200,28260,10000,9500,500,NULL,10000,0,10000,11620,18260,18260,0
50223277,SP2024 ,14750,600,NULL,1270,16620,4830,4830,0,NULL,4830,0,4830,10520,11790,11790,0
50230317,FA2023 ,13500,550,5150,2745,21945,6350,5500,850,2750,9373,0,12123,4677,12572,9822,2543
50230317,SP2023 ,2700,110,1030,549,4389,1270,1100,170,0,1684,0,1684,1126,2705,2705,2543
50222762,FA2021 ,6960,250,NULL,NULL,7210,3062,3062,0,4750,4562,0,9312,2648,2648,-2102,0
50222762,FA2022 ,7170,257,NULL,NULL,7427,7080,2633,4447,0,7080,0,7080,347,347,347,0
50222762,FA2023 ,5570,275,NULL,NULL,5845,0,0,0,6250,0,0,6250,5845,5845,-405,0
50222762,SP2021 ,6960,250,NULL,NULL,7210,3062,3062,0,4750,3062,0,7812,4148,4148,-602,0
50222762,SP2022 ,7170,257,NULL,NULL,7427,7080,2633,4447,0,7080,0,7080,347,347,347,0
50222762,SP2023 ,7450,275,NULL,NULL,7725,7210,0,7210,6250,7210,0,13460,515,515,-5735,0
50230223,FA2024 ,14750,600,NULL,NULL,15350,8365,5865,2500,NULL,9115,0,9115,6235,6235,6235,0
50230223,SP2024 ,14750,600,NULL,NULL,15350,5865,5865,0,NULL,5865,0,5865,9485,9485,9485,0
50225217,FA2022 ,13005,515,4810,2220,20550,7550,7550,0,2750,7550,0,10300,5970,13000,10250,0
50225217,FA2023 ,13500,550,4560,2325,20935,7550,6800,750,3250,7550,0,10800,6500,13385,10135,0
50225217,FA2024 ,14750,600,NULL,1270,16620,5209,3659,1550,3750,5209,0,8959,10141,11411,7661,0
50225217,SP2022 ,13005,515,4810,2220,20550,7550,7550,0,2750,7550,0,10300,5970,13000,10250,0
50225217,SP2023 ,13500,550,4560,2325,20935,7550,6800,750,3250,7550,0,10800,6500,13385,10135,0
50225217,SP2024 ,14750,600,NULL,1270,16620,5210,3660,1550,3750,5210,0,8960,10140,11410,7660,0
50227575,FA2024 ,14750,600,5410,2450,23210,9000,9000,0,2750,9000,0,11750,6350,14210,11460,-5250
50227575,SP2024 ,14750,600,5410,2450,23210,9000,9000,0,2750,9000,0,11750,6350,14210,11460,-5250
50229393,FA2023 ,13500,550,5150,2325,21525,9000,9000,0,NULL,9000,0,9000,5050,12525,12525,-5250
50229393,FA2024 ,14750,600,5410,2450,23210,9000,9000,0,NULL,9000,0,9000,6350,14210,14210,-5250
50229393,SP2023 ,13500,550,5150,2325,21525,9000,9000,0,NULL,9000,0,9000,5050,12525,12525,-5250
50229393,SP2024 ,14750,600,5410,2450,23210,9000,9000,0,NULL,9000,0,9000,6350,14210,14210,-5250
50218531,FA2021 ,12625,500,4580,2110,19815,8575,8575,0,3250,14223,0,17473,-1098,5592,2342,1145.5
50210724,FA2021 ,12625,500,3740,2110,18975,0,0,0,3750,1500,0,5250,11625,17475,13725,0
50210724,SP2021 ,12625,500,3740,2110,18975,0,0,0,3750,0,0,3750,13125,18975,15225,0
50224354,FA2022 ,13005,515,NULL,NULL,13520,4985,4985,0,2750,4985,0,7735,8535,8535,5785,0
50224354,FA2024 ,8140,300,NULL,NULL,8440,2475,2475,0,NULL,2475,0,2475,5965,5965,5965,0
50224354,SP2024 ,8140,300,NULL,NULL,8440,2475,2475,0,NULL,2475,0,2475,5965,5965,5965,0
50235352,FA2024 ,14750,600,NULL,NULL,15350,4830,4830,0,NULL,4830,0,4830,10520,10520,10520,-200
50220893,FA2021 ,12625,500,4580,2110,19815,7500,7500,0,2750,7500,0,10250,5625,12315,9565,0
50220893,SP2021 ,12625,500,4580,2110,19815,7500,7500,0,2750,7500,0,10250,5625,12315,9565,0
50228668,FA2023 ,13500,550,5150,2325,21525,8500,8500,0,NULL,19750,0,19750,-5700,1775,1775,0
50228668,FA2024 ,14750,600,5410,2450,23210,8500,8500,0,NULL,17250,0,17250,-1900,5960,5960,0
50228668,SP2023 ,13500,550,5150,2325,21525,8500,8500,0,NULL,11250,0,11250,2800,10275,10275,0
50228668,SP2024 ,14750,600,5410,2450,23210,8500,8500,0,NULL,11250,0,11250,4100,11960,11960,0
50202870,FA2021 ,12625,500,5160,1080,19365,4175,4175,0,3750,5175,0,8925,7950,14190,10440,0
50202870,FA2022 ,7170,257,NULL,NULL,7427,1000,1000,0,15000,1000,0,16000,6427,6427,-8573,0
50202870,SP2021 ,12625,500,5160,1080,19365,4175,4175,0,3750,4175,0,7925,8950,15190,11440,0
50202870,SP2022 ,7170,257,NULL,NULL,7427,1000,1000,0,0,1000,0,1000,6427,6427,6427,0
50224400,FA2022 ,13005,515,4810,2220,20550,7500,7500,0,2750,7500,0,10250,6020,13050,10300,0
50224400,FA2023 ,13500,550,4560,2535,21145,7500,7500,0,3250,7500,0,10750,6550,13645,10395,0
50224400,FA2024 ,14750,600,6090,1270,22710,7500,7500,0,3750,7500,0,11250,7850,15210,11460,0
50224400,SP2022 ,13005,515,4810,2220,20550,7500,7500,0,2750,7500,0,10250,6020,13050,10300,0
50224400,SP2023 ,13500,550,4560,2535,21145,7500,7500,0,3250,7500,0,10750,6550,13645,10395,0
50224400,SP2024 ,14750,600,6090,1270,22710,7500,7500,0,3750,7500,0,11250,7850,15210,11460,0
50206842,FA2021 ,12625,500,4580,2110,19815,0,0,0,NULL,1500,0,1500,11625,18315,18315,0
50206842,FA2022 ,13005,515,4810,2220,20550,0,0,0,NULL,0,0,0,13520,20550,20550,0
50206842,SP2021 ,12625,500,4580,2110,19815,0,0,0,NULL,0,0,0,13125,19815,19815,0
50206842,SP2022 ,7170,515,4810,2220,14715,0,0,0,NULL,0,0,0,7685,14715,14715,0
50210773,FA2021 ,12625,500,3740,2110,18975,7000,7000,0,NULL,8000,0,8000,5125,10975,10975,0
50210773,FA2022 ,13005,515,4810,2220,20550,7000,7000,0,NULL,7000,0,7000,6520,13550,13550,0
50210773,FA2023 ,13500,550,4790,1200,20040,7000,7000,0,NULL,7000,0,7000,7050,13040,13040,0
50210773,FA2024 ,14750,600,NULL,NULL,15350,4830,4830,0,NULL,4830,0,4830,10520,10520,10520,0
50210773,SP2021 ,12625,500,3740,2110,18975,7000,7000,0,NULL,7000,0,7000,6125,11975,11975,0
50210773,SP2022 ,13005,515,4810,2220,20550,7000,7000,0,NULL,7000,0,7000,6520,13550,13550,0
50210773,SP2023 ,13500,550,4790,1200,20040,7000,7000,0,NULL,7000,0,7000,7050,13040,13040,0
50218237,FA2021 ,12625,500,4580,2110,19815,7250,7250,0,NULL,8250,0,8250,4875,11565,11565,15
50218237,FA2022 ,13005,515,4810,2220,20550,6750,6750,0,NULL,6750,0,6750,6770,13800,13800,15
50218237,FA2023 ,13500,550,5150,2325,21525,6750,6750,0,NULL,6750,0,6750,7300,14775,14775,15
50218237,FA2024 ,14750,600,5720,1270,22340,6750,6000,750,NULL,6750,0,6750,8600,15590,15590,15
50218237,SP2021 ,12625,500,4580,2110,19815,7250,7250,0,NULL,7250,0,7250,5875,12565,12565,15
50218237,SP2022 ,13005,515,4810,2220,20550,6750,6750,0,NULL,6750,0,6750,6770,13800,13800,15
50218237,SP2023 ,13500,550,5150,2325,21525,6750,6750,0,NULL,6750,0,6750,7300,14775,14775,15
50218237,SP2024 ,14750,600,5720,NULL,21070,6750,6000,750,NULL,6750,0,6750,8600,14320,14320,15
50221486,FA2021 ,6960,250,NULL,NULL,7210,1957,854,1103,NULL,2957,0,2957,4253,4253,4253,-130
50221486,FA2022 ,13005,515,3855,2220,19595,8000,6000,2000,NULL,8000,0,8000,5520,11595,11595,-130
50221486,FA2023 ,13500,550,4000,NULL,18050,9000,6000,3000,NULL,9000,0,9000,5050,9050,9050,-130
50221486,FA2024 ,14750,600,4200,NULL,19550,9000,6000,3000,NULL,9000,0,9000,6350,10550,10550,-130
50221486,SP2021 ,12625,500,3740,2110,18975,7094,3094,4000,NULL,7094,0,7094,6031,11881,11881,-130
50221486,SP2022 ,13005,515,3855,2220,19595,8000,6000,2000,NULL,8000,0,8000,5520,11595,11595,-130
50221486,SP2023 ,13500,550,4000,NULL,18050,9000,6000,3000,NULL,9000,0,9000,5050,9050,9050,-130
50221486,SP2024 ,4070,NULL,4200,NULL,8270,0,0,0,NULL,0,0,0,4070,8270,8270,-130
50221851,FA2021 ,12625,500,NULL,NULL,13125,4830,4830,0,NULL,5830,0,5830,7295,7295,7295,0
50221851,FA2022 ,13005,515,3855,2220,19595,6500,6500,0,NULL,6500,0,6500,7020,13095,13095,0
50221851,FA2023 ,13500,550,4000,2325,20375,6500,6500,0,NULL,6500,0,6500,7550,13875,13875,0
50221851,FA2024 ,14750,600,5720,NULL,21070,6500,5500,1000,NULL,6500,0,6500,8850,14570,14570,0
50221851,SP2021 ,12625,500,NULL,NULL,13125,4830,4830,0,NULL,4830,0,4830,8295,8295,8295,0
50221851,SP2022 ,13005,515,3855,2220,19595,6500,6500,0,NULL,6500,0,6500,7020,13095,13095,0
50221851,SP2023 ,13500,550,4000,2325,20375,6500,6500,0,NULL,6500,0,6500,7550,13875,13875,0
50222206,FA2021 ,12625,500,3740,2110,18975,4500,4500,0,NULL,5500,0,5500,7625,13475,13475,0
50228994,FA2023 ,13500,550,4000,2325,20375,5000,5000,0,2750,8373,0,11123,5677,12002,9252,0
50228994,FA2024 ,14750,600,4200,2450,22000,6000,5000,1000,3250,9698,0,12948,5652,12302,9052,0
50228994,SP2023 ,13500,550,4000,2325,20375,5000,5000,0,2750,8372,0,11122,5678,12003,9253,0
50228994,SP2024 ,14750,600,4200,2450,22000,6000,5000,1000,3250,9697,0,12947,5653,12303,9053,0
50232169,FA2024 ,14750,600,5410,2450,23210,7750,7750,0,2750,7750,0,10500,7600,15460,12710,0
50232169,SP2024 ,14750,600,5410,2450,23210,7500,7500,0,2750,7500,0,10250,7850,15710,12960,0
50230960,FA2024 ,14750,600,4790,2450,22590,7250,7250,0,NULL,7250,0,7250,8100,15340,15340,3867.5
50230960,SP2023 ,13500,550,5150,2325,21525,7250,7250,0,NULL,7250,0,7250,6800,14275,14275,3867.5
50230960,SP2024 ,14750,600,4790,2450,22590,7250,7250,0,NULL,7250,0,7250,8100,15340,15340,3867.5
50196932,FA2021 ,12625,500,NULL,NULL,13125,0,0,0,0,14125,12625,14125,-1000,-1000,-1000,0
50209901,FA2021 ,12625,500,NULL,NULL,13125,0,0,0,0,15548,12625,15548,-2423,-2423,-2423,0
50209901,FA2022 ,13005,515,NULL,NULL,13520,0,0,0,3297,13005,13005,16302,515,515,-2782,0
50209901,SP2021 ,12625,500,NULL,NULL,13125,0,0,0,0,13547,12625,13547,-422,-422,-422,0
50209901,SP2022 ,13005,515,NULL,NULL,13520,0,0,0,3297,13005,13005,16302,515,515,-2782,0
50234789,FA2024 ,14750,600,NULL,NULL,15350,0,0,0,NULL,14750,14750,14750,600,600,600,638.33
50234789,SP2024 ,14750,600,NULL,NULL,15350,0,0,0,NULL,14750,14750,14750,600,600,600,638.33
50224837,FA2022 ,13005,515,4260,2220,20000,7250,7250,0,NULL,7250,0,7250,6270,12750,12750,0
50224837,FA2023 ,13500,550,4000,2325,20375,7250,7250,0,NULL,7250,0,7250,6800,13125,13125,0
50224837,FA2024 ,14750,600,5030,NULL,20380,7750,1250,6500,NULL,7750,0,7750,7600,12630,12630,0
50224837,SP2022 ,13005,515,4260,2220,20000,7250,7250,0,NULL,7250,0,7250,6270,12750,12750,0
50224837,SP2023 ,13500,550,4000,2325,20375,7250,7250,0,NULL,7250,0,7250,6800,13125,13125,0
50224837,SP2024 ,14750,600,5030,NULL,20380,7750,1250,6500,NULL,7750,0,7750,7600,12630,12630,0
50206165,FA2021 ,12625,500,4830,0,17955,2375,0,2375,3750,8023,0,11773,5102,9932,6182,0
50206165,SP2021 ,6960,500,4830,NULL,12290,1309,0,1309,7850,4804,0,12654,2656,7486,-364,0
50226705,FA2022 ,13005,515,4810,2220,20550,9950,7950,2000,13422,13398,0,26820,122,7152,-6270,-4012
50226705,FA2023 ,13500,550,4560,2325,20935,9950,6500,3450,9685,13023,0,22708,1027,7912,-1773,-4012
50226705,FA2024 ,14750,600,5410,2450,23210,7950,6500,1450,15484,12048,0,27532,3302,11162,-4322,-4012
50226705,SP2022 ,13005,515,4810,2220,20550,7950,7950,0,10373,11397,0,21770,2123,9153,-1220,-4012
50226705,SP2023 ,13500,550,4560,2325,20935,7950,6500,1450,11685,11022,0,22707,3028,9913,-1772,-4012
50226705,SP2024 ,14750,600,5410,2450,23210,7950,6500,1450,12993,12047,0,25040,3303,11163,-1830,-4012
50203450,FA2021 ,19340,860,5130,1080,25550,7500,7500,0,21935,9000,0,30935,11200,16550,-5385,0
50225894,FA2022 ,13005,515,4810,2220,20550,7650,7650,0,16105,7650,0,23755,5870,12900,-3205,220
50225894,FA2023 ,13500,550,5150,2325,21525,7650,7650,0,12000,7650,0,19650,6400,13875,1875,220
50225894,FA2024 ,14750,600,5720,NULL,21070,7650,6500,1150,12500,7650,0,20150,7700,13420,920,220
50225894,SP2022 ,13005,515,4810,2220,20550,7650,7650,0,12771,9650,0,22421,3870,10900,-1871,220
50225894,SP2023 ,13500,550,5150,2325,21525,7650,7650,0,12000,7650,0,19650,6400,13875,1875,220
50225894,SP2024 ,14750,600,5720,NULL,21070,7650,6500,1150,12500,7650,0,20150,7700,13420,920,220
50133182,FA2021 ,12625,500,3740,2110,18975,4925,1050,3875,3750,10165,0,13915,2960,8810,5060,0
50133182,FA2022 ,13005,515,NULL,NULL,13520,3425,0,3425,3750,3425,0,7175,10095,10095,6345,0
50133182,SP2021 ,12625,500,3740,2110,18975,2925,1050,1875,3750,6665,0,10415,6460,12310,8560,0
50133182,SP2022 ,7170,257,NULL,NULL,7427,786,0,786,3750,786,0,4536,6641,6641,2891,0
50215136,FA2021 ,12625,500,3740,NULL,16865,12475,10725,1750,3750,16348,0,20098,-3223,517,-3233,0
50215136,SP2021 ,12625,500,3740,1080,17945,11475,10725,750,3750,12347,0,16097,778,5598,1848,0
50235339,SP2024 ,14750,600,4790,2450,22590,8000,8000,0,2250,16697,0,18947,-1347,5893,3643,0
50228165,FA2023 ,13500,550,4000,2325,20375,6500,6500,0,2750,7500,0,10250,6550,12875,10125,0
50228165,FA2024 ,14750,600,5410,2450,23210,6500,6500,0,3250,6500,0,9750,8850,16710,13460,0
50228165,SP2023 ,13500,550,4000,2325,20375,6500,6500,0,2750,6500,0,9250,7550,13875,11125,0
50228165,SP2024 ,14750,600,5410,2450,23210,6500,6500,0,3250,6500,0,9750,8850,16710,13460,0
50232447,FA2024 ,14750,600,4200,2450,22000,9550,9550,0,2750,12590,0,15340,2760,9410,6660,0
50212831,FA2021 ,12625,500,3740,2110,18975,2425,2425,0,3750,7165,0,10915,5960,11810,8060,0
50212831,FA2022 ,13005,515,3855,2220,19595,2425,2425,0,NULL,6280,0,6280,7240,13315,13315,0
50212831,FA2023 ,13500,550,5800,NULL,19850,2425,2425,0,NULL,2425,0,2425,11625,17425,17425,0
50212831,SP2021 ,12625,500,3740,2110,18975,2425,2425,0,3750,6165,0,9915,6960,12810,9060,0
50212831,SP2022 ,13005,515,3855,2220,19595,2425,2425,0,NULL,6280,0,6280,7240,13315,13315,0
50212831,SP2023 ,13500,550,5800,NULL,19850,2425,2425,0,NULL,2425,0,2425,11625,17425,17425,0
50209156,FA2021 ,12625,500,3740,2110,18975,6625,6625,0,10750,8125,0,18875,5000,10850,100,0
50209156,FA2022 ,13005,515,4610,1140,19270,6625,6625,0,12989,6625,0,19614,6895,12645,-344,0
50209156,SP2021 ,12625,500,3740,2110,18975,6625,6625,0,10750,6625,0,17375,6500,12350,1600,0
50209156,SP2022 ,13005,515,4610,1140,19270,6625,6625,0,12989,6625,0,19614,6895,12645,-344,0
50233557,FA2024 ,14750,600,5410,2680,23440,6000,6000,0,14750,11198,0,25948,4152,12242,-2508,-1456.44
50233557,SP2024 ,14750,600,5410,2680,23440,6000,6000,0,14750,11197,0,25947,4153,12243,-2507,-1456.44
50228489,FA2023 ,13500,550,5150,2325,21525,6000,6000,0,18350,6000,0,24350,8050,15525,-2825,0
50228489,SP2023 ,13500,550,5150,2325,21525,6000,6000,0,17150,6000,0,23150,8050,15525,-1625,0
50216888,FA2021 ,12625,500,4580,2110,19815,1500,0,1500,NULL,3000,0,3000,10125,16815,16815,0
50216888,FA2022 ,13005,515,4810,2220,20550,1500,0,1500,NULL,1500,0,1500,12020,19050,19050,0
50216888,FA2023 ,13500,550,5150,2325,21525,5000,0,5000,NULL,5000,0,5000,9050,16525,16525,0
50216888,SP2021 ,12625,500,4580,2110,19815,1500,0,1500,NULL,1500,0,1500,11625,18315,18315,0
50216888,SP2022 ,13005,515,4810,2220,20550,1500,0,1500,NULL,1500,0,1500,12020,19050,19050,0
50216888,SP2023 ,13500,550,5150,2325,21525,5000,0,5000,NULL,5000,0,5000,9050,16525,16525,0
50229407,FA2023 ,13500,550,5150,2325,21525,6500,6500,0,3250,6500,0,9750,7550,15025,11775,0
50229407,FA2024 ,14750,600,5410,2450,23210,6500,6500,0,3750,6500,0,10250,8850,16710,12960,0
50229407,SP2023 ,13500,550,5150,2325,21525,6500,6500,0,13250,6500,0,19750,7550,15025,1775,0
50229407,SP2024 ,14750,600,5410,2450,23210,6500,6500,0,16894,6500,0,23394,8850,16710,-184,0
50221355,FA2021 ,12625,500,3740,2110,18975,10250,10250,0,2750,10250,0,13000,2875,8725,5975,-11828.82
50221355,FA2022 ,13005,515,3855,2220,19595,9750,9750,0,NULL,9750,0,9750,3770,9845,9845,-11828.82
50221355,FA2023 ,13500,550,4790,NULL,18840,10250,10250,0,NULL,10250,0,10250,3800,8590,8590,-11828.82
50221355,FA2024 ,14750,600,5030,NULL,20380,10500,9750,750,NULL,10500,0,10500,4850,9880,9880,-11828.82
50221355,SP2021 ,12625,500,3740,2110,18975,10250,10250,0,2750,10250,0,13000,2875,8725,5975,-11828.82
50221355,SP2022 ,13005,515,3855,2220,19595,9750,9750,0,NULL,9750,0,9750,3770,9845,9845,-11828.82
50221355,SP2023 ,13500,550,4790,NULL,18840,10250,10250,0,NULL,10250,0,10250,3800,8590,8590,-11828.82
50221355,SP2024 ,14750,600,5030,NULL,20380,10500,9750,750,NULL,10500,0,10500,4850,9880,9880,-11828.82
50209724,FA2021 ,12625,500,4050,2110,19285,925,925,0,NULL,925,0,925,12200,18360,18360,0
50209724,FA2022 ,13005,515,4610,1140,19270,925,925,0,NULL,925,0,925,12595,18345,18345,0
50209724,SP2021 ,12625,500,4050,1080,18255,925,925,0,NULL,925,0,925,12200,17330,17330,0
50209724,SP2022 ,13005,515,4610,NULL,18130,925,925,0,NULL,925,0,925,12595,17205,17205,0
50224423,FA2021 ,12625,500,4580,2110,19815,6500,6500,0,3750,6500,0,10250,6625,13315,9565,0
50224423,FA2022 ,13005,515,4260,2220,20000,6000,6000,0,NULL,6000,0,6000,7520,14000,14000,0
50224423,SP2021 ,12625,500,4580,2110,19815,6500,6500,0,3750,6500,0,10250,6625,13315,9565,0
50224423,SP2022 ,13005,515,5080,1140,19740,6000,6000,0,NULL,6000,0,6000,7520,13740,13740,0
50224482,FA2022 ,13005,515,3855,2220,19595,7750,7750,0,2750,10250,0,13000,3270,9345,6595,3519.67
50224482,FA2023 ,13500,550,4000,2325,20375,7750,7750,0,3250,7750,0,11000,6300,12625,9375,3519.67
50224482,FA2024 ,14750,7250,7250,NULL,22000,7750,7750,0,3250,7750,0,11000,14250,14250,11000,3519.67
50224482,SP2022 ,13005,515,3855,2220,19595,7750,7750,0,2750,7750,0,10500,5770,11845,9095,3519.67
50224482,SP2023 ,13500,550,4000,2325,20375,7750,7750,0,3250,7750,0,11000,6300,12625,9375,3519.67
50224482,SP2024 ,14750,600,5720,NULL,21070,7750,7750,0,3250,7750,0,11000,7600,13320,10070,3519.67
50232699,FA2024 ,14750,600,5410,2450,23210,9000,9000,0,11750,12000,0,23750,3350,11210,-540,0
50232699,SP2024 ,14750,600,5410,2450,23210,9000,9000,0,9750,9000,0,18750,6350,14210,4460,0
40000993,FA2021 ,12625,500,NULL,NULL,13125,0,0,0,3750,10969,9469,14719,2156,2156,-1594,0
40000993,SP2021 ,12625,500,NULL,NULL,13125,0,0,0,3750,9469,9469,13219,3656,3656,-94,0
50214086,FA2022 ,13005,515,3855,2690,20065,250,250,0,NULL,13255,13005,13255,265,6810,6810,0
50214086,FA2023 ,13500,550,4000,2745,20795,0,0,0,NULL,13500,13500,13500,550,7295,7295,0
50214086,FA2024 ,14750,600,4200,2900,22450,0,0,0,NULL,18950,14750,18950,-3600,3500,3500,0
50214086,SP2022 ,13005,515,3855,2690,20065,0,0,0,NULL,13005,13005,13005,515,7060,7060,0
50214086,SP2023 ,13500,550,4000,2745,20795,0,0,0,NULL,13500,13500,13500,550,7295,7295,0
50214086,SP2024 ,14750,600,4200,2900,22450,0,0,0,NULL,18950,14750,18950,-3600,3500,3500,0
50221804,FA2022 ,7170,515,3855,2220,13760,0,0,0,NULL,7170,7170,7170,515,6590,6590,0
50221804,FA2023 ,13500,550,4000,2745,20795,0,0,0,NULL,13500,13500,13500,550,7295,7295,0
50221804,FA2024 ,8140,600,2390,1450,12580,0,0,0,NULL,8140,8140,8140,600,4440,4440,0
50221804,SP2022 ,13005,515,3855,2220,19595,0,0,0,NULL,13005,13005,13005,515,6590,6590,0
50221804,SP2023 ,13500,550,4000,2745,20795,0,0,0,NULL,13500,13500,13500,550,7295,7295,0
50221905,FA2021 ,12625,500,4580,2110,19815,6000,6000,0,2750,7000,0,9750,6125,12815,10065,1741.12
50221905,FA2022 ,13005,515,3855,1140,18515,5500,5500,0,3250,5500,0,8750,8020,13015,9765,1741.12
50221905,FA2023 ,13500,550,4560,1200,19810,5500,5500,0,3750,5500,0,9250,8550,14310,10560,1741.12
50221905,FA2024 ,14750,600,5030,1270,21650,5500,5500,0,8750,5500,0,14250,9850,16150,7400,1741.12
50221905,SP2021 ,12625,500,4580,2110,19815,6000,6000,0,2750,6000,0,8750,7125,13815,11065,1741.12
50221905,SP2022 ,13005,515,3855,1140,18515,5500,5500,0,7250,5500,0,12750,8020,13015,5765,1741.12
50221905,SP2023 ,13500,6825,6825,NULL,20325,5500,5500,0,11750,5500,0,17250,14825,14825,3075,1741.12
50221905,SP2024 ,14750,600,5030,1270,21650,5500,5500,0,8750,5500,0,14250,9850,16150,7400,1741.12
50228727,FA2023 ,13500,550,4000,2325,20375,8000,8000,0,5250,10500,0,15750,3550,9875,4625,620.91
50228727,FA2024 ,14750,600,4200,2450,22000,9000,1000,8000,3250,11500,0,14750,3850,10500,7250,620.91
50228727,SP2023 ,13500,550,4000,2325,20375,8000,8000,0,2750,8000,0,10750,6050,12375,9625,620.91
50228727,SP2024 ,14750,600,4200,2450,22000,9000,1000,8000,6978,9000,0,15978,6350,13000,6022,620.91
50234247,FA2024 ,14750,600,4200,2450,22000,5000,5000,0,7750,5000,0,12750,10350,17000,9250,1671.32
50234247,SP2024 ,14750,600,4200,2450,22000,5000,5000,0,7750,5000,0,12750,10350,17000,9250,1671.32
50216077,FA2021 ,12625,500,4050,2110,19285,9175,5175,4000,3250,10175,0,13425,2950,9110,5860,0
50216077,FA2022 ,13005,515,3855,2220,19595,9175,5175,4000,3750,9175,0,12925,4345,10420,6670,0
50216077,FA2023 ,13500,550,4790,1200,20040,5175,5175,0,15000,5175,0,20175,8875,14865,-135,0
50216077,SP2021 ,12625,500,4050,2110,19285,5175,5175,0,3250,5175,0,8425,7950,14110,10860,0
50216077,SP2022 ,13005,515,3855,2220,19595,5175,5175,0,3750,5175,0,8925,8345,14420,10670,0
50216077,SP2023 ,13500,550,4790,1200,20040,5175,5175,0,15000,5175,0,20175,8875,14865,-135,0
50216852,FA2021 ,12625,500,3740,2110,18975,2925,2925,0,3250,3925,0,7175,9200,15050,11800,0
50216852,FA2022 ,13005,515,5080,1140,19740,2925,2925,0,3750,2925,0,6675,10595,16815,13065,0
50216852,FA2023 ,13500,550,5440,1200,20690,2925,2925,0,6250,2925,0,9175,11125,17765,11515,0
50216852,SP2021 ,12625,500,3740,2110,18975,2925,2925,0,8250,2925,0,11175,10200,16050,7800,0
50216852,SP2022 ,13005,515,5080,1140,19740,2925,2925,0,13750,2925,0,16675,10595,16815,3065,0
50216852,SP2023 ,13500,550,5440,1200,20690,2925,2925,0,6250,2925,0,9175,11125,17765,11515,0
50234995,FA2024 ,14750,600,4790,2450,22590,9453,9453,0,3750,9453,0,13203,5897,13137,9387,0
50234995,SP2024 ,14750,600,4790,1270,21410,9453,9453,0,3750,9453,0,13203,5897,11957,8207,0
50211375,FA2021 ,12625,500,3740,1080,17945,2425,2425,0,3750,3925,0,7675,9200,14020,10270,0
50211375,FA2022 ,13005,515,5080,NULL,18600,2425,2425,0,3750,2425,0,6175,11095,16175,12425,0
50211375,SP2021 ,12625,500,3740,NULL,16865,2425,2425,0,3750,2425,0,6175,10700,14440,10690,0
50203208,FA2021 ,12625,500,4270,NULL,17395,3925,3925,0,6250,9572,0,15822,3553,7823,1573,0
50203208,SP2021 ,12625,500,4270,NULL,17395,3925,3925,0,6250,8633,0,14883,4492,8762,2512,0
50222134,FA2021 ,12625,500,4580,2110,19815,5000,5000,0,NULL,5000,0,5000,8125,14815,14815,0
50222134,FA2022 ,13005,515,4810,2220,20550,4500,4500,0,NULL,4500,0,4500,9020,16050,16050,0
50222134,FA2023 ,13500,550,5150,2325,21525,4500,4500,0,NULL,4500,0,4500,9550,17025,17025,0
50222134,SP2021 ,12625,500,4580,2110,19815,5000,5000,0,NULL,5000,0,5000,8125,14815,14815,0
50222134,SP2022 ,13005,515,4810,2220,20550,4500,4500,0,NULL,4500,0,4500,9020,16050,16050,0
50224401,FA2022 ,13005,515,3855,2220,19595,5750,5750,0,2750,5750,0,8500,7770,13845,11095,0
50227924,FA2023 ,13500,550,NULL,NULL,14050,5175,5175,0,2750,7275,0,10025,6775,6775,4025,693
50227924,FA2024 ,14750,600,NULL,NULL,15350,5175,5175,0,3250,5175,0,8425,10175,10175,6925,693
50227924,SP2023 ,13500,550,NULL,NULL,14050,5175,5175,0,2750,10175,0,12925,3875,3875,1125,693
50227924,SP2024 ,14750,600,NULL,NULL,15350,5175,5175,0,3250,10175,0,13425,5175,5175,1925,693
50197383,FA2021 ,12625,500,NULL,NULL,13125,3175,3175,0,3750,4675,0,8425,8450,8450,4700,0
50149080,FA2021 ,12625,500,4050,2550,19725,0,0,0,750,14125,12625,14875,-1000,5600,4850,0
50149080,FA2022 ,13005,515,4260,2220,20000,0,0,0,3750,13005,13005,16755,515,6995,3245,0
50149080,FA2023 ,13500,550,5440,1200,20690,250,0,250,3750,13750,13500,17500,300,6940,3190,0
50149080,SP2021 ,12625,500,4050,2550,19725,0,0,0,3250,12625,12625,15875,500,7100,3850,0
50149080,SP2022 ,13005,515,4260,2690,20470,0,0,0,3750,13005,13005,16755,515,7465,3715,0
50149080,SP2023 ,7450,550,5440,1200,14640,0,0,0,3750,7450,7450,11200,550,7190,3440,0
50212164,FA2021 ,12625,500,3740,2110,18975,12290,0,12290,3250,13790,0,17040,-665,5185,1935,0
50212164,FA2022 ,13005,515,4810,2220,20550,11575,11575,0,3750,15325,0,19075,-1805,5225,1475,0
50212164,FA2023 ,13500,550,5150,2325,21525,11575,0,11575,3750,11575,0,15325,2475,9950,6200,0
50212164,SP2021 ,12625,500,3740,2110,18975,11575,0,11575,3250,11575,0,14825,1550,7400,4150,0
50212164,SP2022 ,13005,515,4810,2220,20550,11575,11575,0,3750,15325,0,19075,-1805,5225,1475,0
50212164,SP2023 ,13500,550,4790,1200,20040,11575,0,11575,3750,11825,0,15575,2225,8215,4465,0
50226207,FA2022 ,13005,515,4260,2220,20000,7500,7500,0,2750,10948,0,13698,2572,9052,6302,0
50226207,FA2023 ,13500,550,4000,2325,20375,9500,5500,4000,3250,13598,0,16848,452,6777,3527,0
50226207,FA2024 ,14750,600,4200,2450,22000,7500,5500,2000,3250,11598,0,14848,3752,10402,7152,0
50226207,SP2022 ,13005,515,4810,2220,20550,7500,7500,0,2750,10947,0,13697,2573,9603,6853,0
50226207,SP2023 ,13500,550,4000,2325,20375,7500,5500,2000,3250,11597,0,14847,2453,8778,5528,0
50226207,SP2024 ,14750,600,4200,2450,22000,7500,5500,2000,3250,11597,0,14847,3753,10403,7153,0
50212230,FA2021 ,12625,500,4270,1080,18475,4675,3625,1050,0,6175,0,6175,6950,12300,12300,0
50212230,FA2022 ,13005,515,4610,1140,19270,6675,3625,3050,3750,8602,0,12352,4918,10668,6918,0
50212230,SP2021 ,12625,500,4270,1080,18475,6675,3625,3050,0,6675,0,6675,6450,11800,11800,0
50212230,SP2022 ,13005,515,4610,1140,19270,4675,3625,1050,3750,6603,0,10353,6917,12667,8917,0
50221512,FA2021 ,12625,500,3740,2110,18975,9500,0,9500,2750,10500,0,13250,2625,8475,5725,220
50221512,FA2022 ,13005,515,3855,2220,19595,11500,0,11500,3250,11500,0,14750,2020,8095,4845,220
50221512,FA2023 ,13500,550,5150,2325,21525,11550,0,11550,NULL,11550,0,11550,2500,9975,9975,220
50221512,FA2024 ,14750,600,5030,NULL,20380,11500,0,11500,NULL,11500,0,11500,3850,8880,8880,220
50221512,SP2021 ,12625,500,3740,2110,18975,11500,0,11500,2750,11500,0,14250,1625,7475,4725,220
50221512,SP2022 ,13005,515,3855,2220,19595,9500,0,9500,3250,9500,0,12750,4020,10095,6845,220
50221512,SP2023 ,13500,550,5150,2325,21525,9500,0,9500,NULL,9500,0,9500,4550,12025,12025,220
50221512,SP2024 ,14750,600,5030,NULL,20380,9500,0,9500,NULL,9500,0,9500,5850,10880,10880,220
50228388,SP2022 ,14269,7231,7231,NULL,21500,0,0,0,NULL,0,0,0,21500,21500,21500,0
50231632,FA2024 ,14750,600,4200,2900,22450,8500,8500,0,0,8500,0,8500,6850,13950,13950,0
50231632,SP2024 ,14750,600,4200,2900,22450,8500,8500,0,0,8500,0,8500,6850,13950,13950,0
50232565,FA2024 ,14750,600,4200,2450,22000,8000,8000,0,16063,8000,0,24063,7350,14000,-2063,-1142
50232565,SP2024 ,14750,600,4200,2450,22000,8000,8000,0,16063,8000,0,24063,7350,14000,-2063,-1142
50118856,FA2021 ,12625,500,4240,2110,19475,2675,2675,0,3750,4175,0,7925,8950,15300,11550,0
50118856,FA2022 ,13005,515,3855,2220,19595,2675,2675,0,27975,2675,0,30650,10845,16920,-11055,0
50118856,FA2023 ,13500,550,4000,1200,19250,2675,2675,0,19650,2675,0,22325,11375,16575,-3075,0
50118856,SP2021 ,12625,500,4240,2110,19475,2675,2675,0,3750,2675,0,6425,10450,16800,13050,0
50118856,SP2022 ,13005,515,3855,2220,19595,2675,2675,0,8707,2675,0,11382,10845,16920,8213,0
50206272,FA2021 ,3470,NULL,NULL,NULL,3470,0,0,0,NULL,3470,3470,3470,0,0,0,0
50206272,FA2022 ,13005,515,3855,2220,19595,0,0,0,2750,13005,13005,15755,515,6590,3840,0
50206272,FA2023 ,13500,550,4000,2325,20375,0,0,0,2750,14723,13500,17473,-673,5652,2902,0
50206272,FA2024 ,14750,600,4200,2450,22000,0,0,0,3750,14750,14750,18500,600,7250,3500,0
50206272,SP2021 ,3470,NULL,NULL,NULL,3470,0,0,0,NULL,3470,3470,3470,0,0,0,0
50206272,SP2022 ,13005,515,3855,2220,19595,0,0,0,2750,13005,13005,15755,515,6590,3840,0
50206272,SP2023 ,13500,550,4000,2325,20375,0,0,0,2750,14722,13500,17472,-672,5653,2903,0
50206272,SP2024 ,14750,600,4200,2450,22000,0,0,0,3750,14750,14750,18500,600,7250,3500,0
50225360,FA2022 ,13005,515,4610,1140,19270,6000,6000,0,NULL,6000,0,6000,7520,13270,13270,0
50225360,FA2023 ,13500,550,4790,NULL,18840,6000,6000,0,NULL,6000,0,6000,8050,12840,12840,0
50225360,SP2021 ,12625,500,4580,2110,19815,6500,6500,0,NULL,6500,0,6500,6625,13315,13315,0
50225360,SP2022 ,13005,515,4610,NULL,18130,6000,6000,0,NULL,6000,0,6000,7520,12130,12130,0
50222190,FA2021 ,12625,500,3740,2110,18975,4500,4500,0,2750,4500,0,7250,8625,14475,11725,25
50222190,FA2022 ,13005,515,3855,2220,19595,4000,4000,0,3250,4000,0,7250,9520,15595,12345,25
50222190,FA2023 ,13500,550,5440,1200,20690,4000,4000,0,3750,4000,0,7750,10050,16690,12940,25
50222190,FA2024 ,14750,600,5030,1270,21650,4000,4000,0,3750,4000,0,7750,11350,17650,13900,25
50222190,SP2021 ,12625,500,3740,2110,18975,4500,4500,0,2750,4500,0,7250,8625,14475,11725,25
50222190,SP2022 ,13005,515,3855,2220,19595,4000,4000,0,3250,4000,0,7250,9520,15595,12345,25
50222190,SP2023 ,13500,550,5440,NULL,19490,4000,4000,0,3750,4000,0,7750,10050,15490,11740,25
50222190,SP2024 ,14750,600,5030,1270,21650,4000,4000,0,3750,4000,0,7750,11350,17650,13900,25
50224233,FA2021 ,12625,500,4580,2110,19815,4000,4000,0,2750,4000,0,6750,9125,15815,13065,0
50224233,SP2021 ,12625,500,4580,2110,19815,4000,4000,0,2750,4000,0,6750,9125,15815,13065,0
50222979,FA2021 ,13866,6974,6974,NULL,20840,0,0,0,NULL,0,0,0,20840,20840,20840,0
50142548,FA2021 ,12625,500,4050,2110,19285,5250,5250,0,NULL,5250,0,5250,7875,14035,14035,-748.05
50142548,FA2022 ,13005,515,4260,2220,20000,4500,4500,0,NULL,4500,0,4500,9020,15500,15500,-748.05
50142548,FA2023 ,13500,550,4000,1200,19250,4500,4500,0,NULL,4500,0,4500,9550,14750,14750,-748.05
50142548,FA2024 ,14750,600,5720,1270,22340,4500,4500,0,NULL,4500,0,4500,10850,17840,17840,-748.05
50142548,SP2021 ,12625,500,4050,2110,19285,5551,5551,0,NULL,5551,0,5551,7574,13734,13734,-748.05
50142548,SP2022 ,13005,515,4260,2220,20000,4500,4500,0,NULL,4500,0,4500,9020,15500,15500,-748.05
50142548,SP2023 ,13500,550,4790,1200,20040,4500,4500,0,NULL,4500,0,4500,9550,15540,15540,-748.05
50142548,SP2024 ,14750,600,5720,0,21070,4500,4500,0,NULL,4500,0,4500,10850,16570,16570,-748.05
50142549,FA2022 ,13005,515,4260,2220,20000,7250,7250,0,NULL,7250,0,7250,6270,12750,12750,0
50142549,SP2022 ,13005,515,4260,2220,20000,7250,7250,0,NULL,7250,0,7250,6270,12750,12750,0
50142550,FA2024 ,14750,600,5410,2450,23210,6000,6000,0,2750,6000,0,8750,9350,17210,14460,80
50142550,SP2024 ,14750,600,5410,2450,23210,6000,6000,0,2750,6000,0,8750,9350,17210,14460,80
50221732,FA2021 ,12625,500,3740,2110,18975,7750,7750,0,2750,10250,0,13000,2875,8725,5975,0
50221732,FA2022 ,13005,515,3855,2220,19595,7250,7250,0,NULL,12105,0,12105,1415,7490,7490,0
50221732,FA2023 ,13500,550,4790,1200,20040,7750,7250,500,NULL,7750,0,7750,6300,12290,12290,0
50221732,SP2021 ,12625,500,3740,2110,18975,7750,7750,0,2750,7750,0,10500,5375,11225,8475,0
50221732,SP2022 ,13005,515,3855,2220,19595,7250,7250,0,NULL,11876,0,11876,1644,7719,7719,0
50221732,SP2023 ,13500,550,4790,NULL,18840,7750,7250,500,NULL,7750,0,7750,6300,11090,11090,0
50225672,FA2022 ,13005,515,4260,2220,20000,5100,5100,0,20390,5600,0,25990,7920,14400,-5990,0
50225672,FA2023 ,13500,550,4560,2325,20935,5100,5100,0,20677,5100,0,25777,8950,15835,-4842,0
50225672,SP2022 ,13005,515,4260,2220,20000,5100,5100,0,16052,5100,0,21152,8420,14900,-1152,0
50225672,SP2023 ,13500,550,4560,2325,20935,5100,5100,0,17880,5100,0,22980,8950,15835,-2045,0
50216716,FA2021 ,12625,500,3740,2110,18975,5325,0,5325,3250,11825,0,15075,1300,7150,3900,0
50216716,FA2022 ,13005,515,4810,2220,20550,6325,1000,5325,3250,11325,0,14575,2195,9225,5975,0
50216716,FA2023 ,13500,550,4790,1200,20040,5325,0,5325,3750,10325,0,14075,3725,9715,5965,0
50216716,SP2021 ,12625,500,3740,2110,18975,5325,0,5325,3250,5325,0,8575,7800,13650,10400,0
50216716,SP2022 ,13005,515,4810,2220,20550,6325,1000,5325,3250,6325,0,9575,7195,14225,10975,0
50216716,SP2023 ,13500,550,4790,1200,20040,4825,0,4825,3750,4825,0,8575,9225,15215,11465,0
50229720,FA2023 ,13500,550,4000,2325,20375,8900,8900,0,2750,8900,0,11650,5150,11475,8725,0
50229720,SP2023 ,13500,550,4000,2325,20375,10900,8900,2000,2750,10900,0,13650,3150,9475,6725,0
50207308,FA2021 ,12625,500,NULL,NULL,13125,1275,1275,0,6250,7848,0,14098,5277,5277,-973,0
50207308,FA2022 ,13005,515,NULL,NULL,13520,3425,3425,0,6250,3425,0,9675,10095,10095,3845,0
50207308,FA2023 ,3720,NULL,NULL,NULL,3720,0,0,0,NULL,0,0,0,3720,3720,3720,0
50207308,SP2021 ,12625,500,NULL,NULL,13125,1275,1275,0,6250,5847,0,12097,7278,7278,1028,0
50207308,SP2022 ,13005,515,NULL,NULL,13520,3425,3425,0,6250,3425,0,9675,10095,10095,3845,0
50209115,FA2021 ,12625,500,4270,NULL,17395,16000,1000,15000,3750,17500,0,21250,-4375,-105,-3855,0
50209115,SP2021 ,12625,500,4050,1080,18255,15000,0,15000,3750,15000,0,18750,-1875,3255,-495,0
50217741,FA2021 ,12625,500,4580,2110,19815,9475,6975,2500,3250,15123,0,18373,-1998,4692,1442,0
50217741,FA2022 ,13005,515,4810,2220,20550,9475,6975,2500,3750,15823,0,19573,-2303,4727,977,0
50217741,FA2023 ,13500,550,5440,1200,20690,6975,6975,0,3750,11073,0,14823,2977,9617,5867,0
50217741,SP2021 ,12625,500,4580,2110,19815,7475,6975,500,3250,12182,0,15432,943,7633,4383,0
50217741,SP2022 ,13005,515,4810,2220,20550,6975,6975,0,3750,10822,0,14572,2698,9728,5978,0
50217741,SP2023 ,13500,550,5440,1200,20690,6975,6975,0,3750,11072,0,14822,2978,9618,5868,0
50221711,FA2022 ,13005,515,4810,2220,20550,5500,5500,0,3250,5500,0,8750,8020,15050,11800,4214.66
50221711,FA2023 ,13500,550,4560,2325,20935,5250,5250,0,NULL,5250,0,5250,8800,15685,15685,4214.66
50221711,FA2024 ,14750,300,NULL,NULL,15050,3623,3623,0,NULL,3623,0,3623,11427,11427,11427,4214.66
50221711,SP2021 ,12625,500,4580,2110,19815,5500,5500,0,0,5500,0,5500,7625,14315,14315,4214.66
50221711,SP2022 ,13005,515,4260,2220,20000,5000,5000,0,3250,5000,0,8250,8520,15000,11750,4214.66
50221711,SP2023 ,13500,550,4560,2325,20935,5250,5250,0,NULL,5250,0,5250,8800,15685,15685,4214.66
50221711,SP2024 ,14750,600,NULL,NULL,15350,3622,3622,0,NULL,3622,0,3622,11728,11728,11728,4214.66
50221895,FA2021 ,12625,500,4050,2110,19285,4000,4000,0,2750,10000,0,12750,3125,9285,6535,30
50221895,FA2022 ,13005,515,4810,2220,20550,4200,4200,0,3250,9200,0,12450,4320,11350,8100,30
50221895,FA2023 ,13500,550,5150,2325,21525,4000,4000,0,15042,9000,0,24042,5050,12525,-2517,30
50221895,FA2024 ,14750,600,5410,2450,23210,4000,4000,0,16165,9000,0,25165,6350,14210,-1955,30
50221895,SP2021 ,12625,500,4050,2110,19285,4000,4000,0,2750,4000,0,6750,9125,15285,12535,30
50221895,SP2023 ,13500,550,5150,2325,21525,4000,4000,0,18336,4000,0,22336,10050,17525,-811,30
50221895,SP2024 ,14750,600,5410,2450,23210,4000,4000,0,20696,4000,0,24696,11350,19210,-1486,30
50225538,FA2022 ,13005,515,3855,2690,20065,4500,4500,0,17848,4500,0,22348,9020,15565,-2283,0
50225538,FA2023 ,13500,550,5150,2745,21945,4500,4500,0,20139,4500,0,24639,9550,17445,-2694,0
50225538,FA2024 ,14750,600,5410,2450,23210,4500,4500,0,21027,4500,0,25527,10850,18710,-2317,0
50225538,SP2022 ,13005,515,3855,2690,20065,4500,4500,0,16354,4500,0,20854,9020,15565,-789,0
50225538,SP2023 ,13500,550,5150,2745,21945,4500,4500,0,19963,4500,0,24463,9550,17445,-2518,0
50225538,SP2024 ,14750,600,5410,2450,23210,4500,4500,0,21027,4500,0,25527,10850,18710,-2317,0
50228371,FA2023 ,13500,550,5150,2325,21525,6500,6500,0,2750,6500,0,9250,7550,15025,12275,0
50228371,FA2024 ,14750,600,5410,2900,23660,6500,6500,0,8250,6500,0,14750,8850,17160,8910,0
50228371,SP2023 ,13500,550,5150,2325,21525,6500,6500,0,2750,6500,0,9250,7550,15025,12275,0
50228371,SP2024 ,14750,600,5410,2450,23210,6500,6500,0,8250,6500,0,14750,8850,16710,8460,0
50229721,FA2023 ,13500,550,4000,2325,20375,6000,6000,0,2750,6000,0,8750,8050,14375,11625,0
50229721,SP2023 ,13500,550,4000,2325,20375,6000,6000,0,2750,6000,0,8750,8050,14375,11625,0
50229721,SP2024 ,14750,600,5410,2450,23210,6000,6000,0,NULL,6000,0,6000,9350,17210,17210,0
50233634,FA2024 ,14750,600,5410,2450,23210,10500,1500,9000,4750,10500,0,15250,4850,12710,7960,2332.66
50233634,SP2024 ,14750,600,6090,2450,23890,10500,1500,9000,4750,10500,0,15250,4850,13390,8640,2332.66
50235844,SP2024 ,14750,600,5410,2450,23210,9000,7000,2000,4750,12698,0,17448,2652,10512,5762,55
50204950,FA2021 ,12625,500,4650,2110,19885,0,0,0,NULL,0,0,0,13125,19885,19885,0
50204950,SP2021 ,12625,500,4650,2110,19885,0,0,0,NULL,0,0,0,13125,19885,19885,0
50231263,FA2023 ,13500,550,5150,2325,21525,6000,6000,0,NULL,6000,0,6000,8050,15525,15525,5308
50231263,FA2024 ,14750,600,5410,2680,23440,6000,6000,0,1500,6000,0,7500,9350,17440,15940,5308
50231263,SP2023 ,13500,550,5150,2325,21525,6000,6000,0,NULL,6000,0,6000,8050,15525,15525,5308
50231263,SP2024 ,14750,600,5410,2450,23210,6000,6000,0,1500,6000,0,7500,9350,17210,15710,5308
50171923,FA2023 ,13500,550,NULL,NULL,14050,6725,0,6725,6250,11797,0,18047,2253,2253,-3997,0
50171923,SP2022 ,7170,257,NULL,NULL,7427,951,951,0,0,4375,0,4375,3052,3052,3052,0
50171923,SP2023 ,7450,275,NULL,NULL,7725,4951,0,4951,6250,8288,0,14538,-563,-563,-6813,0
50232171,FA2024 ,14750,600,4200,2450,22000,8500,8500,0,NULL,8500,0,8500,6850,13500,13500,0
50232171,SP2024 ,14750,600,4200,2450,22000,8500,8500,0,NULL,8500,0,8500,6850,13500,13500,0
50232490,FA2024 ,14750,600,5410,2450,23210,7500,7500,0,2750,7500,0,10250,7850,15710,12960,0
50232490,SP2024 ,14750,600,5410,2450,23210,7500,7500,0,2750,7500,0,10250,7850,15710,12960,0
50234528,FA2024 ,14750,600,NULL,NULL,15350,4140,4140,0,13669,4140,0,17809,11210,11210,-2459,-578
50234528,SP2024 ,14750,600,NULL,NULL,15350,4140,4140,0,11582,4140,0,15722,11210,11210,-372,-578
50204243,FA2021 ,12625,500,NULL,NULL,13125,6000,0,6000,0,10073,0,10073,3052,3052,3052,0
50204243,FA2022 ,13005,515,4260,2220,20000,0,0,0,3750,773,0,4523,12747,19227,15477,0
50204243,FA2024 ,14750,600,NULL,NULL,15350,4500,4500,0,6250,8598,0,14848,6752,6752,502,0
50204243,SP2021 ,1800,NULL,NULL,NULL,1800,0,0,0,0,418,0,418,1382,1382,1382,0
50210991,FA2021 ,12625,500,4830,NULL,17955,1425,1425,0,3750,2425,0,6175,10700,15530,11780,0
50210991,SP2021 ,12625,500,4050,2110,19285,1425,1425,0,3750,2425,0,6175,10700,16860,13110,0
50191489,SP2022 ,13005,515,4810,2220,20550,6350,6350,0,5250,7273,0,12523,6247,13277,8027,-200
50232363,FA2024 ,14750,600,4200,2450,22000,8500,8500,0,2750,14375,0,17125,975,7625,4875,-2476.96
50232363,SP2024 ,14750,600,4200,2450,22000,8500,8500,0,2750,10125,0,12875,5225,11875,9125,-2476.96
50218440,FA2021 ,12625,500,4050,1080,18255,3975,2750,1225,3250,12975,0,16225,150,5280,2030,0
50218440,SP2021 ,12625,500,4050,NULL,17175,4273,3048,1225,3250,11773,0,15023,1352,5402,2152,0
50225779,FA2022 ,13005,515,4810,2220,20550,5500,5500,0,2750,7250,0,10000,6270,13300,10550,6931.58
50225779,FA2023 ,13500,550,4560,2325,20935,5500,500,5000,3250,5500,0,8750,8550,15435,12185,6931.58
50225779,FA2024 ,14750,600,5410,2450,23210,5500,5500,0,3250,5500,0,8750,9850,17710,14460,6931.58
50225779,SP2022 ,13005,515,4810,2220,20550,5500,5500,0,2750,5500,0,8250,8020,15050,12300,6931.58
50225779,SP2023 ,13500,550,4560,2325,20935,5500,500,5000,3250,5500,0,8750,8550,15435,12185,6931.58
50225779,SP2024 ,14750,600,5410,2450,23210,5500,5500,0,3250,5500,0,8750,9850,17710,14460,6931.58
50225897,FA2022 ,13005,515,3855,2220,19595,6500,6500,0,2750,6500,0,9250,7020,13095,10345,0
50225897,FA2023 ,4050,165,815,697,5727,1950,1950,0,3250,1950,0,5200,2265,3777,527,0
50225897,SP2022 ,13005,515,3855,2220,19595,6500,6500,0,2750,6500,0,9250,7020,13095,10345,0
50225897,SP2023 ,13500,550,5150,2325,21525,6500,6500,0,3250,6500,0,9750,7550,15025,11775,0
50209727,SP2021 ,12625,500,3740,2550,19415,6000,6000,0,18750,6000,0,24750,7125,13415,-5335,0
50229924,FA2023 ,13500,550,4000,2325,20375,6000,6000,0,NULL,6000,0,6000,8050,14375,14375,170
50229924,FA2024 ,14750,600,5410,2450,23210,6000,6000,0,NULL,6000,0,6000,9350,17210,17210,170
50229924,SP2023 ,13500,550,NULL,NULL,14050,4140,4140,0,NULL,4140,0,4140,9910,9910,9910,170
50229924,SP2024 ,14750,600,0,0,15350,4140,4140,0,NULL,4140,0,4140,11210,11210,11210,170
50229081,FA2023 ,13500,550,5150,2325,21525,5500,5500,0,17230,5500,0,22730,8550,16025,-1205,115
50229081,FA2024 ,14750,600,5410,2450,23210,5500,5500,0,17723,5500,0,23223,9850,17710,-13,115
50229081,SP2023 ,13500,550,5150,2325,21525,5500,5500,0,16464,5500,0,21964,8550,16025,-439,115
50229081,SP2024 ,14750,600,5410,2450,23210,5500,5500,0,17873,5500,0,23373,9850,17710,-163,115
50227844,FA2023 ,13500,550,4000,2325,20375,9350,6800,2550,0,9850,0,9850,4200,10525,10525,-164.14
50227844,FA2024 ,14750,600,5720,1270,22340,9350,6000,3350,6250,9720,0,15970,5630,12620,6370,-164.14
50227844,SP2023 ,13500,550,4000,2325,20375,9350,6800,2550,0,9850,0,9850,4200,10525,10525,-164.14
50227844,SP2024 ,14750,600,5720,2450,23520,9350,6000,3350,6250,9720,0,15970,5630,13800,7550,-164.14
50229598,FA2023 ,13500,550,5150,2325,21525,10000,8000,2000,8488,15998,0,24486,-1948,5527,-2961,334.73
50229598,FA2024 ,14750,600,5410,2450,23210,9000,9000,0,3250,19608,0,22858,-4258,3602,352,334.73
50229598,SP2023 ,13500,550,5150,2325,21525,9000,9000,0,6926,14197,0,21123,-147,7328,402,334.73
50229598,SP2024 ,14750,600,5410,2450,23210,9000,9000,0,3250,19607,0,22857,-4257,3603,353,334.73
50228810,FA2023 ,13500,550,4000,2325,20375,7000,7000,0,2750,7000,0,9750,7050,13375,10625,0
50228810,SP2023 ,13500,550,4000,2325,20375,7000,7000,0,2750,7000,0,9750,7050,13375,10625,0
50235010,FA2024 ,14750,600,4200,2680,22230,5528,5528,0,13750,5528,0,19278,9822,16702,2952,0
50235010,SP2024 ,14750,600,4200,2680,22230,5528,5528,0,13750,5528,0,19278,9822,16702,2952,0
50220976,FA2021 ,12625,500,4050,2550,19725,5750,5750,0,2750,5750,0,8500,7375,13975,11225,24
50220976,FA2022 ,13005,515,4260,2220,20000,5250,5250,0,NULL,5250,0,5250,8270,14750,14750,24
50220976,FA2023 ,13500,550,4560,1200,19810,5250,5250,0,NULL,5250,0,5250,8800,14560,14560,24
50220976,FA2024 ,14750,600,4790,1270,21410,5250,5250,0,NULL,5250,0,5250,10100,16160,16160,24
50220976,SP2021 ,12625,500,4050,2110,19285,5750,5750,0,2750,5750,0,8500,7375,13535,10785,24
50220976,SP2022 ,13005,515,4260,2220,20000,5250,5250,0,NULL,5250,0,5250,8270,14750,14750,24
50220976,SP2023 ,13500,550,4560,1200,19810,5250,5250,0,NULL,5250,0,5250,8800,14560,14560,24
50220976,SP2024 ,4070,NULL,NULL,NULL,4070,0,0,0,NULL,0,0,0,4070,4070,4070,24
50215720,FA2021 ,12625,500,4050,2550,19725,5175,5175,0,NULL,5175,0,5175,7950,14550,14550,0
50215720,FA2022 ,13005,515,4610,1140,19270,5575,5175,400,NULL,5575,0,5575,7945,13695,13695,0
50215720,SP2021 ,12625,500,4050,2550,19725,5175,5175,0,NULL,5175,0,5175,7950,14550,14550,0
50215720,SP2022 ,13005,515,4610,1140,19270,5575,5175,400,NULL,5575,0,5575,7945,13695,13695,0
50217001,FA2021 ,12625,500,3740,2110,18975,5425,2925,2500,11250,10665,0,21915,2460,8310,-2940,0
50217001,FA2022 ,13005,515,3855,2220,19595,4425,2925,1500,11750,8280,0,20030,5240,11315,-435,0
50217001,FA2023 ,13500,550,4000,1200,19250,6925,0,6925,11750,10025,0,21775,4025,9225,-2525,0
50217001,SP2021 ,12625,500,3740,2110,18975,4425,2925,1500,11250,8165,0,19415,4960,10810,-440,0
50217001,SP2022 ,13005,515,3855,2220,19595,4425,2925,1500,11750,8280,0,20030,5240,11315,-435,0
50217001,SP2023 ,13500,550,4000,1200,19250,6925,0,6925,11750,10025,0,21775,4025,9225,-2525,0
50221603,FA2021 ,12625,500,4050,2550,19725,6500,6500,0,2750,7500,0,10250,5625,12225,9475,300
50221603,FA2022 ,13005,515,4260,2220,20000,6000,6000,0,NULL,6000,0,6000,7520,14000,14000,300
50221603,FA2023 ,13500,550,5440,1200,20690,6000,6000,0,NULL,6000,0,6000,8050,14690,14690,300
50221603,FA2024 ,14750,600,5720,1270,22340,6500,6000,500,NULL,6500,0,6500,8850,15840,15840,300
50221603,SP2021 ,12625,500,4050,2550,19725,6500,6500,0,2750,6500,0,9250,6625,13225,10475,300
50221603,SP2022 ,13005,515,4260,2220,20000,6000,6000,0,NULL,6000,0,6000,7520,14000,14000,300
50221603,SP2023 ,13500,550,5440,1200,20690,6000,6000,0,NULL,6000,0,6000,8050,14690,14690,300
50221603,SP2024 ,14750,600,5720,1270,22340,6500,6000,500,NULL,6500,0,6500,8850,15840,15840,300
50224787,FA2022 ,13005,515,4260,2220,20000,7500,7500,0,2750,7500,0,10250,6020,12500,9750,0
50224787,FA2023 ,13500,550,4560,2325,20935,7500,7500,0,0,7500,0,7500,6550,13435,13435,0
50224787,FA2024 ,14750,600,5720,2450,23520,7500,7500,0,0,7500,0,7500,7850,16020,16020,0
50224787,SP2022 ,13005,515,4260,2220,20000,7500,7500,0,2750,7500,0,10250,6020,12500,9750,0
50224787,SP2023 ,13500,550,4560,2325,20935,7500,7500,0,0,7500,0,7500,6550,13435,13435,0
50224787,SP2024 ,14750,600,5720,1270,22340,7500,7500,0,0,7500,0,7500,7850,14840,14840,0
50226253,FA2023 ,13500,550,5150,2325,21525,7000,6500,500,16129,7000,0,23129,7050,14525,-1604,-3994.31
50226253,FA2024 ,14750,600,5410,2450,23210,6500,6500,0,18475,6500,0,24975,8850,16710,-1765,-3994.31
50226253,SP2023 ,13500,550,5150,2325,21525,7000,6500,500,15750,7000,0,22750,7050,14525,-1225,-3994.31
50226253,SP2024 ,14750,600,5410,2450,23210,6500,6500,0,18370,6500,0,24870,8850,16710,-1660,-3994.31
50231661,FA2024 ,14750,600,4790,2450,22590,11800,8500,3300,1750,22748,0,24498,-7398,-158,-1908,169.93
50231661,SP2024 ,14750,600,4790,2450,22590,11000,8500,2500,1750,21947,0,23697,-6597,643,-1107,169.93
50211456,FA2021 ,12625,500,4830,1080,19035,4625,4625,0,3750,6125,0,9875,7000,12910,9160,0
50211456,FA2022 ,13005,515,5080,NULL,18600,4625,4625,0,11750,4625,0,16375,8895,13975,2225,0
50211456,SP2021 ,12625,500,4830,NULL,17955,4625,4625,0,8750,4625,0,13375,8500,13330,4580,0
50211456,SP2022 ,13005,515,5080,NULL,18600,4625,4625,0,11750,4625,0,16375,8895,13975,2225,0
50203937,FA2021 ,12625,500,4270,2110,19505,1425,1425,0,0,2425,0,2425,10700,17080,17080,0
50203937,SP2021 ,12625,500,4270,1080,18475,1425,1425,0,0,1425,0,1425,11700,17050,17050,0
50225912,FA2022 ,13005,515,3855,2220,19595,9000,9000,0,NULL,9000,0,9000,4520,10595,10595,460
50225912,FA2023 ,13500,550,4000,2325,20375,9000,9000,0,NULL,9000,0,9000,5050,11375,11375,460
50225912,FA2024 ,14750,600,5720,NULL,21070,9750,6500,3250,NULL,9750,0,9750,5600,11320,11320,460
50225912,SP2022 ,13005,515,3855,2220,19595,9000,9000,0,NULL,9000,0,9000,4520,10595,10595,460
50225912,SP2023 ,13500,550,4000,2325,20375,9000,9000,0,NULL,9000,0,9000,5050,11375,11375,460
50225912,SP2024 ,14750,600,5720,NULL,21070,9750,6500,3250,NULL,9750,0,9750,5600,11320,11320,460
50225913,FA2022 ,13005,515,3855,2220,19595,9000,6500,2500,NULL,9000,0,9000,4520,10595,10595,475
50225913,FA2023 ,13500,550,4000,2325,20375,9000,6500,2500,NULL,9000,0,9000,5050,11375,11375,475
50225913,FA2024 ,14750,600,5720,NULL,21070,9750,6500,3250,NULL,9750,0,9750,5600,11320,11320,475
50225913,SP2022 ,13005,515,4380,2220,20120,9000,6500,2500,NULL,9000,0,9000,4520,11120,11120,475
50225913,SP2023 ,13500,550,4000,2325,20375,9000,6500,2500,NULL,9000,0,9000,5050,11375,11375,475
50225913,SP2024 ,14750,600,5720,NULL,21070,9750,6500,3250,NULL,9750,0,9750,5600,11320,11320,475
50222238,FA2022 ,13005,515,3855,2220,19595,6000,6000,0,NULL,6000,0,6000,7520,13595,13595,0
50222238,FA2023 ,13500,6825,6825,NULL,20325,1500,1500,0,NULL,1500,0,1500,18825,18825,18825,0
50222238,FA2024 ,14750,600,5030,NULL,20380,6500,5500,1000,NULL,6500,0,6500,8850,13880,13880,0
50222238,SP2021 ,12625,500,4580,2110,19815,6000,6000,0,NULL,6000,0,6000,7125,13815,13815,0
50222238,SP2022 ,13005,515,3855,2220,19595,6000,6000,0,NULL,6000,0,6000,7520,13595,13595,0
50222238,SP2023 ,13500,550,4790,NULL,18840,6000,6000,0,NULL,6000,0,6000,8050,12840,12840,0
50222238,SP2024 ,8140,600,5030,NULL,13770,3811,3035,776,NULL,3811,0,3811,4929,9959,9959,0
50228166,FA2023 ,13500,550,4560,2325,20935,8500,6500,2000,NULL,8500,0,8500,5550,12435,12435,3725
50228166,FA2024 ,14750,600,NULL,NULL,15350,6485,4485,2000,NULL,6485,0,6485,8865,8865,8865,3725
50228166,SP2022 ,13005,515,4810,2220,20550,8500,6500,2000,0,8500,0,8500,5020,12050,12050,3725
50228166,SP2023 ,13500,550,4560,2325,20935,6500,6500,0,NULL,6500,0,6500,7550,14435,14435,3725
50228166,SP2024 ,14750,600,NULL,NULL,15350,4485,4485,0,NULL,4485,0,4485,10865,10865,10865,3725
50212314,FA2021 ,12625,500,4830,NULL,17955,10425,0,10425,NULL,13795,0,13795,-670,4160,4160,0
50212314,FA2022 ,13005,515,5080,NULL,18600,12644,719,11925,NULL,14571,0,14571,-1051,4029,4029,0
50212314,SP2021 ,12625,500,4830,NULL,17955,10425,0,10425,NULL,12295,0,12295,830,5660,5660,0
50212314,SP2022 ,13005,515,5080,NULL,18600,9930,5,9925,NULL,11858,0,11858,1662,6742,6742,0
50215469,FA2021 ,12625,500,4050,2110,19285,3925,3925,0,NULL,3925,0,3925,9200,15360,15360,0
50226608,FA2022 ,13005,515,3855,2690,20065,13250,9750,3500,NULL,13250,0,13250,270,6815,6815,-200
50226608,FA2023 ,13500,550,4000,2325,20375,13500,6500,7000,NULL,13500,0,13500,550,6875,6875,-200
50226608,SP2022 ,13005,515,3855,2220,19595,11000,9500,1500,NULL,11000,0,11000,2520,8595,8595,-200
50226608,SP2023 ,13500,550,4000,2325,20375,11500,6500,5000,NULL,11500,0,11500,2550,8875,8875,-200
50235773,SP2024 ,14750,600,5410,2450,23210,5000,5000,0,NULL,5000,0,5000,10350,18210,18210,0
50119993,FA2023 ,13500,550,4000,2325,20375,12000,9000,3000,2750,12000,0,14750,2050,8375,5625,0
50119993,SP2023 ,13500,550,4000,2325,20375,9000,9000,0,2750,9000,0,11750,5050,11375,8625,0
50203822,FA2021 ,5200,250,NULL,NULL,5450,1514,14,1500,7500,5138,0,12638,312,312,-7188,0
50207155,FA2022 ,13005,515,NULL,NULL,13520,4140,4140,0,6250,7588,0,13838,5932,5932,-318,0
50207155,SP2022 ,13005,515,NULL,NULL,13520,4140,4140,0,1383,7587,0,8970,5933,5933,4550,0
50226589,FA2023 ,13500,550,4000,2325,20375,6500,6500,0,NULL,6500,0,6500,7550,13875,13875,15
50226589,FA2024 ,14750,600,4200,2450,22000,6500,5500,1000,NULL,6500,0,6500,8850,15500,15500,15
50226589,SP2023 ,13500,550,4000,2325,20375,6500,6500,0,NULL,6500,0,6500,7550,13875,13875,15
50226589,SP2024 ,14750,600,4200,2450,22000,6500,5500,1000,NULL,6500,0,6500,8850,15500,15500,15
50230201,FA2023 ,13500,550,4000,2325,20375,7500,7500,0,NULL,7500,0,7500,6550,12875,12875,0
50230201,SP2023 ,13500,550,4000,2325,20375,7500,7500,0,NULL,7500,0,7500,6550,12875,12875,0
50220990,FA2021 ,12625,500,3740,2110,18975,8350,8350,0,2750,13098,0,15848,27,5877,3127,1359.66
50220990,FA2022 ,13005,515,3855,2220,19595,8400,8050,350,3250,15428,0,18678,-1908,4167,917,1359.66
50220990,FA2023 ,13500,550,5150,2325,21525,7600,7250,350,3750,16848,0,20598,-2798,4677,927,1359.66
50220990,FA2024 ,8140,600,4200,2450,15390,3918,3725,193,3750,7208,0,10958,1532,8182,4432,1359.66
50220990,SP2021 ,12625,500,3740,2110,18975,8350,8350,0,2750,12657,0,15407,468,6318,3568,1359.66
50220990,SP2022 ,13005,515,3855,2220,19595,8400,8050,350,3250,15427,0,18677,-1907,4168,918,1359.66
50220990,SP2023 ,13500,550,5150,2325,21525,7600,7250,350,3750,16847,0,20597,-2797,4678,928,1359.66
50224616,FA2022 ,13005,515,3855,2220,19595,9500,0,9500,NULL,9500,0,9500,4020,10095,10095,0
50224616,FA2023 ,13500,550,5150,2325,21525,11500,0,11500,NULL,16650,0,16650,-2600,4875,4875,0
50224616,FA2024 ,14750,600,5410,2450,23210,12050,500,11550,NULL,17460,0,17460,-2110,5750,5750,0
50224616,SP2022 ,13005,515,3855,2220,19595,11500,0,11500,NULL,11500,0,11500,2020,8095,8095,0
50224616,SP2023 ,13500,550,5150,2325,21525,9550,0,9550,NULL,14700,0,14700,-650,6825,6825,0
50224616,SP2024 ,14750,600,5410,1270,22030,10000,500,9500,NULL,15410,0,15410,-60,6620,6620,0
50209411,FA2021 ,19340,860,4600,1080,25020,8750,8750,0,NULL,8750,0,8750,11450,16270,16270,0
50209411,FA2022 ,19910,890,5700,2220,27830,8750,8750,0,NULL,8750,0,8750,12050,19080,19080,0
50209411,SP2021 ,19340,860,4600,1080,25020,8750,8750,0,NULL,8750,0,8750,11450,16270,16270,0
50209411,SP2022 ,19910,890,5700,2220,27830,8750,8750,0,NULL,8750,0,8750,12050,19080,19080,0
50226616,FA2022 ,13005,515,4810,2220,20550,9500,9500,0,NULL,9500,0,9500,4020,11050,11050,0
50226616,SP2022 ,13005,515,4810,2220,20550,9500,9500,0,NULL,9500,0,9500,4020,11050,11050,0
50221796,FA2021 ,12625,500,4580,2110,19815,8550,8550,0,2750,9550,0,12300,3575,10265,7515,0
50221796,SP2021 ,12625,500,4580,2110,19815,8550,8550,0,2750,8550,0,11300,4575,11265,8515,0
50209867,FA2021 ,12625,500,4050,1080,18255,5425,5425,0,NULL,6925,0,6925,6200,11330,11330,0
50209867,FA2022 ,13005,515,501,NULL,14021,3925,3925,0,NULL,3925,0,3925,9595,10096,10096,0
50209867,SP2021 ,12625,500,4050,1080,18255,5425,5425,0,NULL,5425,0,5425,7700,12830,12830,0
50209847,FA2021 ,12625,500,3740,2110,18975,6875,0,6875,3750,8375,0,12125,4750,10600,6850,0
50209847,FA2022 ,13005,6590,6590,NULL,19595,5500,5500,0,3750,5500,0,9250,14095,14095,10345,0
50209847,SP2021 ,12625,500,3740,2110,18975,6875,0,6875,3750,6875,0,10625,6250,12100,8350,0
50209847,SP2022 ,13005,515,4610,1140,19270,6875,1000,5875,3750,6875,0,10625,6645,12395,8645,0
50224403,FA2022 ,13005,515,4810,2220,20550,8500,8500,0,12250,8500,0,20750,5020,12050,-200,-19
50224403,FA2023 ,13500,550,4560,2325,20935,8500,8500,0,13000,8500,0,21500,5550,12435,-565,-19
50224403,FA2024 ,14750,600,4790,2450,22590,8500,8500,0,12500,10543,0,23043,4807,12047,-453,-19
50224403,SP2022 ,13005,515,4810,2220,20550,8500,8500,0,12250,8500,0,20750,5020,12050,-200,-19
50224403,SP2023 ,13500,550,4560,2325,20935,8500,8500,0,13000,8500,0,21500,5550,12435,-565,-19
50224403,SP2024 ,14750,600,5410,1270,22030,8500,8500,0,12500,10542,0,23042,4808,11488,-1012,-19
50228003,FA2023 ,13500,550,5150,2745,21945,8600,7000,1600,13128,11073,0,24201,2977,10872,-2256,0
50228003,FA2024 ,14750,600,5410,2900,23660,8600,7000,1600,12147,12293,0,24440,3057,11367,-780,0
50228003,SP2023 ,13500,550,5150,2745,21945,8600,7000,1600,11872,11072,0,22944,2978,10873,-999,0
50228003,SP2024 ,14750,600,5410,2900,23660,8600,7000,1600,12148,12292,0,24440,3058,11368,-780,0
50228346,FA2023 ,13500,550,5150,2745,21945,9000,9000,0,2750,9000,0,11750,5050,12945,10195,-450.63
50228346,FA2024 ,14750,600,5410,2450,23210,9000,9000,0,15150,9000,0,24150,6350,14210,-940,-450.63
50228346,SP2023 ,13500,550,5150,2745,21945,9000,9000,0,2750,9000,0,11750,5050,12945,10195,-450.63
50228346,SP2024 ,14750,600,5410,2450,23210,9000,9000,0,13779,9000,0,22779,6350,14210,431,-450.63
50213538,FA2021 ,12625,500,3740,2110,18975,9857,6457,3400,NULL,11357,0,11357,1768,7618,7618,330
50213538,FA2022 ,13005,515,4260,1140,18920,6675,6675,0,NULL,8602,0,8602,4918,10318,10318,330
50213538,SP2021 ,12625,500,3740,2110,18975,6775,6775,0,NULL,6775,0,6775,6350,12200,12200,330
50213538,SP2022 ,13005,515,4260,1140,18920,6724,6724,0,NULL,8652,0,8652,4868,10268,10268,330
50210677,FA2021 ,12625,500,5160,2110,20395,1425,1425,0,NULL,1425,0,1425,11700,18970,18970,0
50210677,SP2021 ,12625,500,5160,1080,19365,1425,1425,0,NULL,1425,0,1425,11700,17940,17940,0
50212102,FA2021 ,12625,500,4580,2110,19815,5275,3275,2000,10600,10548,0,21148,2577,9267,-1333,0
50212102,FA2022 ,13005,515,5080,1140,19740,5275,4500,775,11700,8248,0,19948,5272,11492,-208,0
50212102,FA2023 ,13500,550,NULL,NULL,14050,3775,3000,775,10000,3775,0,13775,10275,10275,275,0
50212102,SP2021 ,12625,500,4580,2110,19815,5275,3275,2000,10600,8547,0,19147,4578,11268,668,0
50212102,SP2022 ,13005,515,5080,1140,19740,5275,4500,775,11700,8247,0,19947,5273,11493,-207,0
50212102,SP2023 ,13500,550,5440,1200,20690,5275,4500,775,16200,5275,0,21475,8775,15415,-785,0
50230464,FA2023 ,13500,550,4000,2325,20375,8000,8000,0,NULL,8000,0,8000,6050,12375,12375,0
50230464,FA2024 ,14750,600,4200,2450,22000,10250,8250,2000,NULL,10250,0,10250,5100,11750,11750,0
50230464,SP2023 ,13500,550,4000,2325,20375,8000,8000,0,NULL,8000,0,8000,6050,12375,12375,0
50230464,SP2024 ,14750,600,4200,2450,22000,8000,8000,0,NULL,8000,0,8000,7350,14000,14000,0
50230457,FA2023 ,13500,550,4000,2325,20375,8000,8000,0,NULL,8000,0,8000,6050,12375,12375,0
50230457,FA2024 ,14750,600,4200,2450,22000,10000,6500,3500,NULL,10000,0,10000,5350,12000,12000,0
50230457,SP2023 ,13500,550,4000,2325,20375,8000,8000,0,NULL,8000,0,8000,6050,12375,12375,0
50230457,SP2024 ,14750,600,4200,2450,22000,8000,6500,1500,NULL,8000,0,8000,7350,14000,14000,0
50222729,FA2021 ,12625,500,3740,2110,18975,5000,5000,0,2750,5000,0,7750,8125,13975,11225,0
50222729,FA2022 ,13005,515,3855,2220,19595,4500,4500,0,3250,4500,0,7750,9020,15095,11845,0
50222729,SP2021 ,12625,500,3740,2110,18975,5000,5000,0,2750,5000,0,7750,8125,13975,11225,0
50222729,SP2022 ,13005,515,3855,2220,19595,4500,4500,0,3250,4500,0,7750,9020,15095,11845,0
50232364,FA2024 ,14750,600,NULL,NULL,15350,5000,5000,0,2750,10198,0,12948,5152,5152,2402,0
50232364,SP2024 ,14750,600,NULL,NULL,15350,5000,5000,0,2750,10197,0,12947,5153,5153,2403,0
50221089,FA2021 ,12625,500,4580,2110,19815,7500,7500,0,2750,7500,0,10250,5625,12315,9565,0
50221089,SP2021 ,12625,500,4580,2110,19815,7500,7500,0,2750,7500,0,10250,5625,12315,9565,0
50221089,SP2022 ,13005,515,4810,2220,20550,7000,7000,0,1608,7000,0,8608,6520,13550,11942,0
50224881,FA2022 ,13005,515,4810,2220,20550,9600,9600,0,2750,9600,0,12350,3920,10950,8200,1069.33
50224881,FA2023 ,13500,550,5150,2325,21525,11100,6750,4350,3250,11100,0,14350,2950,10425,7175,1069.33
50224881,FA2024 ,14750,600,5410,2450,23210,9600,6750,2850,3750,13298,0,17048,2052,9912,6162,1069.33
50224881,SP2022 ,13005,515,4810,2220,20550,9600,9600,0,2750,9600,0,12350,3920,10950,8200,1069.33
50224881,SP2023 ,13500,550,5150,2325,21525,11100,6750,4350,3250,11100,0,14350,2950,10425,7175,1069.33
50224881,SP2024 ,14750,600,5410,2450,23210,9600,6750,2850,3750,13297,0,17047,2053,9913,6163,1069.33
50231803,FA2024 ,14750,600,5410,2450,23210,9650,9650,0,11104,15650,0,26754,-300,7560,-3544,1419.99
50231803,SP2024 ,14750,600,5410,2450,23210,9650,9650,0,9015,9650,0,18665,5700,13560,4545,1419.99
50229368,FA2023 ,13500,550,4000,2325,20375,8500,8500,0,NULL,8500,0,8500,5550,11875,11875,-7008.6
50229368,SP2023 ,13500,550,4000,2325,20375,8500,8500,0,NULL,8500,0,8500,5550,11875,11875,-7008.6
50216854,FA2021 ,12625,500,4050,2110,19285,3425,3425,0,13750,4925,0,18675,8200,14360,610,1500
50216854,FA2022 ,13005,515,5080,NULL,18600,3425,3425,0,15250,3425,0,18675,10095,15175,-75,1500
50216854,FA2023 ,13500,550,5440,NULL,19490,3425,0,3425,3750,3425,0,7175,10625,16065,12315,1500
50216854,SP2021 ,12625,500,4050,2110,19285,3425,3425,0,13750,3425,0,17175,9700,15860,2110,1500
50216854,SP2022 ,13005,515,5080,NULL,18600,3425,3425,0,15250,3425,0,18675,10095,15175,-75,1500
50216854,SP2023 ,13500,550,5440,NULL,19490,3425,0,3425,3750,3425,0,7175,10625,16065,12315,1500
50226690,FA2022 ,14269,7231,7231,NULL,21500,0,0,0,NULL,0,0,0,21500,21500,21500,0
50222628,FA2021 ,12625,500,3740,2110,18975,6500,6500,0,NULL,7500,0,7500,5625,11475,11475,1525
50222628,FA2022 ,13005,515,3855,2220,19595,6500,6500,0,NULL,6500,0,6500,7020,13095,13095,1525
50222628,FA2023 ,13500,550,4000,NULL,18050,6500,6500,0,NULL,6500,0,6500,7550,11550,11550,1525
50222628,FA2024 ,14750,600,5240,NULL,20590,6500,5500,1000,NULL,6500,0,6500,8850,14090,14090,1525
50222628,SP2021 ,12625,500,3740,2110,18975,6500,6500,0,NULL,6500,0,6500,6625,12475,12475,1525
50222628,SP2022 ,13005,515,3855,2220,19595,6500,6500,0,NULL,6500,0,6500,7020,13095,13095,1525
50222628,SP2023 ,13500,550,4000,NULL,18050,6500,6500,0,NULL,6500,0,6500,7550,11550,11550,1525
50222628,SP2024 ,2120,NULL,NULL,NULL,2120,690,690,0,NULL,690,0,690,1430,1430,1430,1525
50225794,FA2022 ,13005,515,4810,2220,20550,9000,8000,1000,NULL,9000,0,9000,4520,11550,11550,2877.5
50225794,FA2023 ,13500,550,4000,2325,20375,9000,8000,1000,NULL,9000,0,9000,5050,11375,11375,2877.5
50225794,FA2024 ,14750,600,5030,NULL,20380,9000,6500,2500,NULL,9000,0,9000,6350,11380,11380,2877.5
50225794,SP2022 ,13005,515,4810,2220,20550,9000,8000,1000,NULL,9000,0,9000,4520,11550,11550,2877.5
50225794,SP2023 ,13500,550,4000,2325,20375,9000,8000,1000,NULL,9000,0,9000,5050,11375,11375,2877.5
50225794,SP2024 ,14750,600,5030,NULL,20380,9000,6500,2500,NULL,9000,0,9000,6350,11380,11380,2877.5
50227879,FA2023 ,13500,550,4000,2325,20375,7500,7500,0,NULL,7500,0,7500,6550,12875,12875,0
50227879,FA2024 ,14750,600,4200,2450,22000,7500,5500,2000,NULL,7500,0,7500,7850,14500,14500,0
50227879,SP2022 ,13005,515,3855,2220,19595,7500,7500,0,NULL,7500,0,7500,6020,12095,12095,0
50227879,SP2023 ,13500,550,4000,2325,20375,7500,7500,0,NULL,7500,0,7500,6550,12875,12875,0
50227879,SP2024 ,14750,600,4200,2450,22000,7500,5500,2000,NULL,7500,0,7500,7850,14500,14500,0
50228818,FA2023 ,13500,550,4000,2325,20375,9000,7000,2000,NULL,9000,0,9000,5050,11375,11375,4409.32
50228818,FA2024 ,14750,600,5410,2450,23210,9000,7000,2000,NULL,9000,0,9000,6350,14210,14210,4409.32
50228818,SP2023 ,13500,550,4000,2325,20375,9000,7000,2000,NULL,9000,0,9000,5050,11375,11375,4409.32
50228818,SP2024 ,14750,600,4200,2450,22000,9000,7000,2000,NULL,9000,0,9000,6350,13000,13000,4409.32
50230332,FA2024 ,14750,600,5410,2450,23210,10000,10000,0,2750,10000,0,12750,5350,13210,10460,0
50230332,SP2024 ,15720,600,5410,2450,24180,10000,10000,0,2750,10000,0,12750,6320,14180,11430,0
50232587,FA2024 ,14750,600,5410,2450,23210,9500,0,9500,NULL,9500,0,9500,5850,13710,13710,0
50232587,SP2024 ,14750,600,5410,2450,23210,9500,0,9500,NULL,9500,0,9500,5850,13710,13710,0
50197483,FA2021 ,6960,250,NULL,NULL,7210,0,0,0,NULL,1500,0,1500,5710,5710,5710,0
50197483,SP2021 ,6960,250,NULL,NULL,7210,0,0,0,NULL,0,0,0,7210,7210,7210,0
50232549,FA2024 ,14750,600,4200,1270,20820,7000,7000,0,NULL,7000,0,7000,8350,13820,13820,0
50232549,SP2024 ,14750,600,4200,NULL,19550,7000,7000,0,NULL,7000,0,7000,8350,12550,12550,0
50209561,FA2021 ,12625,500,4580,2110,19815,9675,8925,750,NULL,11175,0,11175,1950,8640,8640,0
50209561,FA2022 ,13850,515,NULL,NULL,14365,7480,55,7425,NULL,7480,0,7480,6885,6885,6885,0
50209561,SP2021 ,12625,500,4580,2110,19815,9675,8925,750,NULL,9675,0,9675,3450,10140,10140,0
50209790,FA2021 ,12625,500,NULL,NULL,13125,9425,4425,5000,NULL,10925,0,10925,2200,2200,2200,0
50209790,SP2021 ,12625,500,NULL,NULL,13125,4425,4425,0,NULL,4425,0,4425,8700,8700,8700,0
50224404,FA2021 ,12625,500,NULL,NULL,13125,4830,4830,0,NULL,4830,0,4830,8295,8295,8295,0
50224404,FA2022 ,13005,515,4810,2220,20550,4830,4830,0,NULL,4830,0,4830,8690,15720,15720,0
50224404,FA2023 ,13500,550,4790,1200,20040,4830,4830,0,NULL,4830,0,4830,9220,15210,15210,0
50224404,SP2021 ,12625,500,NULL,NULL,13125,4830,4830,0,NULL,4830,0,4830,8295,8295,8295,0
50224404,SP2022 ,13005,515,4810,2220,20550,4830,4830,0,NULL,4830,0,4830,8690,15720,15720,0
50224404,SP2023 ,13500,550,4790,1200,20040,4830,4830,0,NULL,4830,0,4830,9220,15210,15210,0
50232175,FA2024 ,14750,600,4200,2450,22000,13500,11500,2000,2750,14608,0,17358,742,7392,4642,2302
50232175,SP2024 ,14750,600,4200,2450,22000,11500,11500,0,2750,12607,0,15357,2743,9393,6643,2302
50221633,FA2021 ,12625,500,4580,2110,19815,6000,6000,0,21750,6000,0,27750,7125,13815,-7935,183
50221633,FA2022 ,13005,515,4810,2220,20550,5500,5500,0,11721,5500,0,17221,8020,15050,3329,183
50221633,FA2023 ,13500,550,5150,2325,21525,5500,5500,0,16050,5500,0,21550,8550,16025,-25,183
50221633,FA2024 ,14750,600,6090,1270,22710,5500,5500,0,17450,7245,0,24695,8105,15465,-1985,183
50221633,SP2021 ,12625,500,4580,2110,19815,6000,6000,0,9750,6000,0,15750,7125,13815,4065,183
50221633,SP2022 ,13005,515,4810,2220,20550,5500,5500,0,16341,5500,0,21841,8020,15050,-1291,183
50221633,SP2023 ,13500,550,5150,2325,21525,5500,5500,0,16150,5500,0,21650,8550,16025,-125,183
50221633,SP2024 ,14750,600,6090,NULL,21440,5500,5500,0,16550,5870,0,22420,9480,15570,-980,183
50228708,FA2023 ,13500,550,4560,2325,20935,7500,7500,0,13000,7500,0,20500,6550,13435,435,-140
50228708,FA2024 ,14750,600,4790,2450,22590,7500,7500,0,14300,7500,0,21800,7850,15090,790,-140
50228708,SP2023 ,13500,550,4560,2325,20935,7500,7500,0,13616,7500,0,21116,6550,13435,-181,-140
50228708,SP2024 ,14750,600,4790,2450,22590,7500,7500,0,15445,7500,0,22945,7850,15090,-355,-140
50226823,FA2023 ,13500,550,4000,2325,20375,8000,8000,0,NULL,8000,0,8000,6050,12375,12375,0
50226823,FA2024 ,14750,600,4200,2450,22000,7500,7500,0,NULL,7500,0,7500,7850,14500,14500,0
50226823,SP2023 ,13500,550,4000,2325,20375,8000,8000,0,NULL,8000,0,8000,6050,12375,12375,0
50226823,SP2024 ,14750,600,4200,2450,22000,7500,7500,0,NULL,7500,0,7500,7850,14500,14500,0
50215459,FA2021 ,12625,500,4050,2110,19285,10575,9200,1375,3950,21841,0,25791,-8716,-2556,-6506,0
50215459,FA2022 ,13005,515,4260,2220,20000,10575,9200,1375,2820,20375,0,23195,-6855,-375,-3195,0
50215459,FA2023 ,13500,550,5800,1200,21050,11075,9200,1875,4521,19875,0,24396,-5825,1175,-3346,0
50215459,SP2021 ,12625,500,4050,2110,19285,10575,9200,1375,0,10841,0,10841,2284,8444,8444,0
50215459,SP2022 ,13005,515,4260,2220,20000,10575,9200,1375,2020,11375,0,13395,2145,8625,6605,0
50215459,SP2023 ,13500,550,5800,1200,21050,11075,9200,1875,2750,12875,0,15625,1175,8175,5425,0
50214062,FA2021 ,12625,500,4580,2110,19815,12203,5925,6278,0,18283,0,18283,-5158,1532,1532,0
50214062,FA2022 ,13005,515,5420,1140,20080,24008,6055,17953,NULL,24008,0,24008,-10488,-3928,-3928,0
50214062,SP2021 ,12625,500,4580,2110,19815,12461,5925,6536,0,17041,0,17041,-3916,2774,2774,0
50214062,SP2022 ,13005,515,5420,1140,20080,20961,6169,14792,NULL,20961,0,20961,-7441,-881,-881,0
50221973,FA2021 ,12625,500,4580,2110,19815,9397,9397,0,2750,10397,0,13147,2728,9418,6668,0
50221973,FA2022 ,13005,515,4380,2220,20120,8700,8700,0,3250,10873,0,14123,2647,9247,5997,0
50221973,FA2023 ,13500,6825,6825,NULL,20325,4800,4800,0,3750,5723,0,9473,14602,14602,10852,0
50221973,SP2021 ,12625,500,4580,2110,19815,9315,9315,0,2750,9315,0,12065,3810,10500,7750,0
50221973,SP2022 ,13005,515,4380,2220,20120,8700,8700,0,3250,10872,0,14122,2648,9248,5998,0
50221973,SP2023 ,13500,550,4000,1200,19250,8700,8700,0,3750,10022,0,13772,4028,9228,5478,0
50233746,FA2024 ,14750,600,4200,2450,22000,7500,7500,0,2750,10000,0,12750,5350,12000,9250,0
50233746,SP2024 ,14750,600,4200,2450,22000,7500,7500,0,2750,7500,0,10250,7850,14500,11750,0
